SNP,s_giganteum_chr_name,LG,WRC_scaffold,map_position,WRC_scaffold_length,position,accurate_pos,distance_from_origin
29379313_4875,CM021100.1,1,29379313,39270555,141330,4875,39275430,4875
29379313_4880,CM021100.1,1,29379313,39270555,141330,4880,39275435,4880
29379313_4882,CM021100.1,1,29379313,39270555,141330,4882,39275437,4882
29378255_15117,CM021100.1,1,29378255,39270354,488276,15117,39285471,14916
29363841_126048,CM021100.1,1,29363841,126297422,152685,126048,126423470,87152915
29363841_126147,CM021100.1,1,29363841,126297422,152685,126147,126423569,87153014
29379106_294921,CM021100.1,1,29379106,126297421,349815,294921,126592342,87321787
29379106_294923,CM021100.1,1,29379106,126297421,349815,294923,126592344,87321789
29379106_294954,CM021100.1,1,29379106,126297421,349815,294954,126592375,87321820
29379106_294984,CM021100.1,1,29379106,126297421,349815,294984,126592405,87321850
29379106_294992,CM021100.1,1,29379106,126297421,349815,294992,126592413,87321858
29379106_295136,CM021100.1,1,29379106,126297421,349815,295136,126592557,87322002
29379106_295158,CM021100.1,1,29379106,126297421,349815,295158,126592579,87322024
29378095_56688,CM021100.1,1,29378095,126591479,800298,56688,126648167,87377612
29378095_56721,CM021100.1,1,29378095,126591479,800298,56721,126648200,87377645
29378095_56732,CM021100.1,1,29378095,126591479,800298,56732,126648211,87377656
29379720_181126,CM021100.1,1,29379720,126591474,824144,181126,126772600,87502045
29379720_181131,CM021100.1,1,29379720,126591474,824144,181131,126772605,87502050
29380894_388876,CM021100.1,1,29380894,126591480,2622210,388876,126980356,87709801
29380894_427167,CM021100.1,1,29380894,126591480,2622210,427167,127018647,87748092
29380894_427222,CM021100.1,1,29380894,126591480,2622210,427222,127018702,87748147
29382025_430746,CM021100.1,1,29382025,126591482,1188128,430746,127022228,87751673
29382025_431016,CM021100.1,1,29382025,126591482,1188128,431016,127022498,87751943
29382025_431710,CM021100.1,1,29382025,126591482,1188128,431710,127023192,87752637
29382025_431769,CM021100.1,1,29382025,126591482,1188128,431769,127023251,87752696
29382025_488354,CM021100.1,1,29382025,126591482,1188128,488354,127079836,87809281
29382025_488473,CM021100.1,1,29382025,126591482,1188128,488473,127079955,87809400
29377231_503306,CM021100.1,1,29377231,126594949,821680,503306,127098255,87827700
29381438_569237,CM021100.1,1,29381438,126591482,2067508,569237,127160719,87890164
29377172_572571,CM021100.1,1,29377172,126591480,2120019,572571,127164051,87893496
29377172_572611,CM021100.1,1,29377172,126591480,2120019,572611,127164091,87893536
29377172_572625,CM021100.1,1,29377172,126591480,2120019,572625,127164105,87893550
29378095_664732,CM021100.1,1,29378095,126591479,800298,664732,127256211,87985656
29378095_664784,CM021100.1,1,29378095,126591479,800298,664784,127256263,87985708
29378095_664862,CM021100.1,1,29378095,126591479,800298,664862,127256341,87985786
29378095_666530,CM021100.1,1,29378095,126591479,800298,666530,127258009,87987454
29380894_751851,CM021100.1,1,29380894,126591480,2622210,751851,127343331,88072776
29380894_751881,CM021100.1,1,29380894,126591480,2622210,751881,127343361,88072806
29380894_752173,CM021100.1,1,29380894,126591480,2622210,752173,127343653,88073098
29380894_752217,CM021100.1,1,29380894,126591480,2622210,752217,127343697,88073142
29380894_774620,CM021100.1,1,29380894,126591480,2622210,774620,127366100,88095545
29382485_844321,CM021100.1,1,29382485,126591482,2426567,844321,127435803,88165248
29382485_844333,CM021100.1,1,29382485,126591482,2426567,844333,127435815,88165260
29382485_844344,CM021100.1,1,29382485,126591482,2426567,844344,127435826,88165271
29382485_844354,CM021100.1,1,29382485,126591482,2426567,844354,127435836,88165281
29382485_844355,CM021100.1,1,29382485,126591482,2426567,844355,127435837,88165282
29382485_844411,CM021100.1,1,29382485,126591482,2426567,844411,127435893,88165338
29380894_989549,CM021100.1,1,29380894,126591480,2622210,989549,127581029,88310474
29381438_1052363,CM021100.1,1,29381438,126591482,2067508,1052363,127643845,88373290
29381438_1052478,CM021100.1,1,29381438,126591482,2067508,1052478,127643960,88373405
29381438_1052516,CM021100.1,1,29381438,126591482,2067508,1052516,127643998,88373443
29381438_1064714,CM021100.1,1,29381438,126591482,2067508,1064714,127656196,88385641
29381438_1065093,CM021100.1,1,29381438,126591482,2067508,1065093,127656575,88386020
29381438_1065102,CM021100.1,1,29381438,126591482,2067508,1065102,127656584,88386029
29381438_1074300,CM021100.1,1,29381438,126591482,2067508,1074300,127665782,88395227
29378074_1227167,CM021100.1,1,29378074,126591484,5074968,1227167,127818651,88548096
29378074_1227230,CM021100.1,1,29378074,126591484,5074968,1227230,127818714,88548159
29378074_1227239,CM021100.1,1,29378074,126591484,5074968,1227239,127818723,88548168
29381438_1251089,CM021100.1,1,29381438,126591482,2067508,1251089,127842571,88572016
29381438_1251151,CM021100.1,1,29381438,126591482,2067508,1251151,127842633,88572078
29377172_1263340,CM021100.1,1,29377172,126591480,2120019,1263340,127854820,88584265
29381438_1294308,CM021100.1,1,29381438,126591482,2067508,1294308,127885790,88615235
29381438_1294320,CM021100.1,1,29381438,126591482,2067508,1294320,127885802,88615247
29382485_1359491,CM021100.1,1,29382485,126591482,2426567,1359491,127950973,88680418
29382485_1359518,CM021100.1,1,29382485,126591482,2426567,1359518,127951000,88680445
29380894_1368472,CM021100.1,1,29380894,126591480,2622210,1368472,127959952,88689397
29380894_1372299,CM021100.1,1,29380894,126591480,2622210,1372299,127963779,88693224
29381438_1422727,CM021100.1,1,29381438,126591482,2067508,1422727,128014209,88743654
29381438_1422824,CM021100.1,1,29381438,126591482,2067508,1422824,128014306,88743751
29381438_1422836,CM021100.1,1,29381438,126591482,2067508,1422836,128014318,88743763
29381438_1422863,CM021100.1,1,29381438,126591482,2067508,1422863,128014345,88743790
29381438_1422900,CM021100.1,1,29381438,126591482,2067508,1422900,128014382,88743827
29381438_1422958,CM021100.1,1,29381438,126591482,2067508,1422958,128014440,88743885
29381438_1422973,CM021100.1,1,29381438,126591482,2067508,1422973,128014455,88743900
29381438_1422974,CM021100.1,1,29381438,126591482,2067508,1422974,128014456,88743901
29378074_1575074,CM021100.1,1,29378074,126591484,5074968,1575074,128166558,88896003
29377172_1590794,CM021100.1,1,29377172,126591480,2120019,1590794,128182274,88911719
29377172_1590869,CM021100.1,1,29377172,126591480,2120019,1590869,128182349,88911794
29377172_1611561,CM021100.1,1,29377172,126591480,2120019,1611561,128203041,88932486
29377172_1611597,CM021100.1,1,29377172,126591480,2120019,1611597,128203077,88932522
29377172_1620210,CM021100.1,1,29377172,126591480,2120019,1620210,128211690,88941135
29378074_1781661,CM021100.1,1,29378074,126591484,5074968,1781661,128373145,89102590
29378074_1793278,CM021100.1,1,29378074,126591484,5074968,1793278,128384762,89114207
29380894_1903395,CM021100.1,1,29380894,126591480,2622210,1903395,128494875,89224320
29380894_1903475,CM021100.1,1,29380894,126591480,2622210,1903475,128494955,89224400
29380894_1903478,CM021100.1,1,29380894,126591480,2622210,1903478,128494958,89224403
29377172_2064914,CM021100.1,1,29377172,126591480,2120019,2064914,128656394,89385839
29377172_2064976,CM021100.1,1,29377172,126591480,2120019,2064976,128656456,89385901
29377172_2065043,CM021100.1,1,29377172,126591480,2120019,2065043,128656523,89385968
29377172_2065107,CM021100.1,1,29377172,126591480,2120019,2065107,128656587,89386032
29377172_2065154,CM021100.1,1,29377172,126591480,2120019,2065154,128656634,89386079
29377172_2068093,CM021100.1,1,29377172,126591480,2120019,2068093,128659573,89389018
29380894_2113454,CM021100.1,1,29380894,126591480,2622210,2113454,128704934,89434379
29380894_2113461,CM021100.1,1,29380894,126591480,2622210,2113461,128704941,89434386
29380894_2113471,CM021100.1,1,29380894,126591480,2622210,2113471,128704951,89434396
29380894_2113485,CM021100.1,1,29380894,126591480,2622210,2113485,128704965,89434410
29380894_2113496,CM021100.1,1,29380894,126591480,2622210,2113496,128704976,89434421
29380894_2116111,CM021100.1,1,29380894,126591480,2622210,2116111,128707591,89437036
29380894_2116156,CM021100.1,1,29380894,126591480,2622210,2116156,128707636,89437081
29380894_2116165,CM021100.1,1,29380894,126591480,2622210,2116165,128707645,89437090
29380894_2116804,CM021100.1,1,29380894,126591480,2622210,2116804,128708284,89437729
29380894_2116810,CM021100.1,1,29380894,126591480,2622210,2116810,128708290,89437735
29378074_2163387,CM021100.1,1,29378074,126591484,5074968,2163387,128754871,89484316
29378074_2167301,CM021100.1,1,29378074,126591484,5074968,2167301,128758785,89488230
29378074_2194220,CM021100.1,1,29378074,126591484,5074968,2194220,128785704,89515149
29378074_2260396,CM021100.1,1,29378074,126591484,5074968,2260396,128851880,89581325
29378074_2260419,CM021100.1,1,29378074,126591484,5074968,2260419,128851903,89581348
29378074_2260424,CM021100.1,1,29378074,126591484,5074968,2260424,128851908,89581353
29378074_2260429,CM021100.1,1,29378074,126591484,5074968,2260429,128851913,89581358
29378074_2260441,CM021100.1,1,29378074,126591484,5074968,2260441,128851925,89581370
29378074_2260488,CM021100.1,1,29378074,126591484,5074968,2260488,128851972,89581417
29378074_2260522,CM021100.1,1,29378074,126591484,5074968,2260522,128852006,89581451
29378541_2361764,CM021100.1,1,29378541,126591817,5002257,2361764,128953581,89683026
29378541_2361773,CM021100.1,1,29378541,126591817,5002257,2361773,128953590,89683035
29378541_2361835,CM021100.1,1,29378541,126591817,5002257,2361835,128953652,89683097
29378074_2699990,CM021100.1,1,29378074,126591484,5074968,2699990,129291474,90020919
29378074_2700004,CM021100.1,1,29378074,126591484,5074968,2700004,129291488,90020933
29378074_2700013,CM021100.1,1,29378074,126591484,5074968,2700013,129291497,90020942
29378074_2700018,CM021100.1,1,29378074,126591484,5074968,2700018,129291502,90020947
29378541_2821943,CM021100.1,1,29378541,126591817,5002257,2821943,129413760,90143205
29378541_2821995,CM021100.1,1,29378541,126591817,5002257,2821995,129413812,90143257
29378541_2822015,CM021100.1,1,29378541,126591817,5002257,2822015,129413832,90143277
29378541_2822106,CM021100.1,1,29378541,126591817,5002257,2822106,129413923,90143368
29378074_2925812,CM021100.1,1,29378074,126591484,5074968,2925812,129517296,90246741
29378074_2925862,CM021100.1,1,29378074,126591484,5074968,2925862,129517346,90246791
29378074_2936792,CM021100.1,1,29378074,126591484,5074968,2936792,129528276,90257721
29378541_3568435,CM021100.1,1,29378541,126591817,5002257,3568435,130160252,90889697
29381588_3787392,CM021100.1,1,29381588,126591481,4930301,3787392,130378873,91108318
29380473_7586,CM021100.1,1,29380473,146737412,1004061,7586,146744998,107474443
29380473_7624,CM021100.1,1,29380473,146737412,1004061,7624,146745036,107474481
29378599_204650,CM021100.1,1,29378599,146738236,361934,204650,146942886,107672331
29378599_204681,CM021100.1,1,29378599,146738236,361934,204681,146942917,107672362
29378599_204701,CM021100.1,1,29378599,146738236,361934,204701,146942937,107672382
29378599_204709,CM021100.1,1,29378599,146738236,361934,204709,146942945,107672390
29378599_204710,CM021100.1,1,29378599,146738236,361934,204710,146942946,107672391
29378599_204724,CM021100.1,1,29378599,146738236,361934,204724,146942960,107672405
29378599_204746,CM021100.1,1,29378599,146738236,361934,204746,146942982,107672427
29378599_204747,CM021100.1,1,29378599,146738236,361934,204747,146942983,107672428
29378451_358579,CM021100.1,1,29378451,146737418,648371,358579,147095997,107825442
29378451_477906,CM021100.1,1,29378451,146737418,648371,477906,147215324,107944769
29378451_477928,CM021100.1,1,29378451,146737418,648371,477928,147215346,107944791
29378451_477929,CM021100.1,1,29378451,146737418,648371,477929,147215347,107944792
29380473_509828,CM021100.1,1,29380473,146737412,1004061,509828,147247240,107976685
29380473_509920,CM021100.1,1,29380473,146737412,1004061,509920,147247332,107976777
29378451_517725,CM021100.1,1,29378451,146737418,648371,517725,147255143,107984588
29378451_517765,CM021100.1,1,29378451,146737418,648371,517765,147255183,107984628
29378451_517974,CM021100.1,1,29378451,146737418,648371,517974,147255392,107984837
29378451_609752,CM021100.1,1,29378451,146737418,648371,609752,147347170,108076615
29316132_3453,CM021100.1,1,29316132,148380966,7888,3453,148384419,109113864
29378454_67168,CM021100.1,1,29378454,156194340,3958378,67168,156261508,116990953
29380750_127536,CM021100.1,1,29380750,156194342,1838031,127536,156321878,117051323
29380750_127573,CM021100.1,1,29380750,156194342,1838031,127573,156321915,117051360
29378454_164755,CM021100.1,1,29378454,156194340,3958378,164755,156359095,117088540
29380750_174388,CM021100.1,1,29380750,156194342,1838031,174388,156368730,117098175
29380750_174430,CM021100.1,1,29380750,156194342,1838031,174430,156368772,117098217
29378454_174592,CM021100.1,1,29378454,156194340,3958378,174592,156368932,117098377
29380750_174592,CM021100.1,1,29380750,156194342,1838031,174592,156368934,117098379
29380750_174648,CM021100.1,1,29380750,156194342,1838031,174648,156368990,117098435
29380750_174676,CM021100.1,1,29380750,156194342,1838031,174676,156369018,117098463
29377226_270905,CM021100.1,1,29377226,156203849,4431392,270905,156474754,117204199
29380707_397175,CM021100.1,1,29380707,156194343,857690,397175,156591518,117320963
29380707_397187,CM021100.1,1,29380707,156194343,857690,397187,156591530,117320975
29380707_397279,CM021100.1,1,29380707,156194343,857690,397279,156591622,117321067
29377226_584850,CM021100.1,1,29377226,156203849,4431392,584850,156788699,117518144
29377226_584918,CM021100.1,1,29377226,156203849,4431392,584918,156788767,117518212
29377226_584938,CM021100.1,1,29377226,156203849,4431392,584938,156788787,117518232
29377226_588393,CM021100.1,1,29377226,156203849,4431392,588393,156792242,117521687
29380117_680260,CM021100.1,1,29380117,156194343,1930566,680260,156874603,117604048
29380117_680309,CM021100.1,1,29380117,156194343,1930566,680309,156874652,117604097
29380117_680311,CM021100.1,1,29380117,156194343,1930566,680311,156874654,117604099
29381308_856810,CM021100.1,1,29381308,156194342,1552230,856810,157051152,117780597
29379684_910886,CM021100.1,1,29379684,156194343,1073558,910886,157105229,117834674
29379684_910953,CM021100.1,1,29379684,156194343,1073558,910953,157105296,117834741
29379684_910992,CM021100.1,1,29379684,156194343,1073558,910992,157105335,117834780
29378649_1027256,CM021100.1,1,29378649,156194342,3767450,1027256,157221598,117951043
29378649_1046004,CM021100.1,1,29378649,156194342,3767450,1046004,157240346,117969791
29377226_1277144,CM021100.1,1,29377226,156203849,4431392,1277144,157480993,118210438
29377226_1409289,CM021100.1,1,29377226,156203849,4431392,1409289,157613138,118342583
29377226_1409299,CM021100.1,1,29377226,156203849,4431392,1409299,157613148,118342593
29377226_1409367,CM021100.1,1,29377226,156203849,4431392,1409367,157613216,118342661
29377226_1410164,CM021100.1,1,29377226,156203849,4431392,1410164,157614013,118343458
29377226_1410168,CM021100.1,1,29377226,156203849,4431392,1410168,157614017,118343462
29377226_1410222,CM021100.1,1,29377226,156203849,4431392,1410222,157614071,118343516
29377226_1411602,CM021100.1,1,29377226,156203849,4431392,1411602,157615451,118344896
29377226_1413484,CM021100.1,1,29377226,156203849,4431392,1413484,157617333,118346778
29377226_1413530,CM021100.1,1,29377226,156203849,4431392,1413530,157617379,118346824
29377226_1413589,CM021100.1,1,29377226,156203849,4431392,1413589,157617438,118346883
29380232_15667,CM021100.1,1,29380232,157777478,129213,15667,157793145,118522590
29382137_48769,CM021100.1,1,29382137,157776692,103665,48769,157825461,118554906
29382137_48789,CM021100.1,1,29382137,157776692,103665,48789,157825481,118554926
29380117_1643162,CM021100.1,1,29380117,156194343,1930566,1643162,157837505,118566950
29380117_1643182,CM021100.1,1,29380117,156194343,1930566,1643182,157837525,118566970
29380117_1643191,CM021100.1,1,29380117,156194343,1930566,1643191,157837534,118566979
29380117_1643197,CM021100.1,1,29380117,156194343,1930566,1643197,157837540,118566985
29380117_1643219,CM021100.1,1,29380117,156194343,1930566,1643219,157837562,118567007
29380001_2069066,CM021100.1,1,29380001,156194343,3012506,2069066,158263409,118992854
29378454_2168427,CM021100.1,1,29378454,156194340,3958378,2168427,158362767,119092212
29378454_2168460,CM021100.1,1,29378454,156194340,3958378,2168460,158362800,119092245
29378454_2168505,CM021100.1,1,29378454,156194340,3958378,2168505,158362845,119092290
29378454_2853605,CM021100.1,1,29378454,156194340,3958378,2853605,159047945,119777390
29378454_2853612,CM021100.1,1,29378454,156194340,3958378,2853612,159047952,119777397
29378454_2853671,CM021100.1,1,29378454,156194340,3958378,2853671,159048011,119777456
29378454_2855043,CM021100.1,1,29378454,156194340,3958378,2855043,159049383,119778828
29335290_105834,CM021100.1,1,29335290,166324273,508149,105834,166430107,127159552
29379982_213989,CM021100.1,1,29379982,166324273,237256,213989,166538262,127267707
29379384_3687,CM021100.1,1,29379384,185258805,1914540,3687,185262492,145991937
29379384_3694,CM021100.1,1,29379384,185258805,1914540,3694,185262499,145991944
29377174_191620,CM021100.1,1,29377174,185258803,339668,191620,185450423,146179868
29377197_191560,CM021100.1,1,29377197,185261465,210907,191560,185453025,146182470
29381206_285434,CM021100.1,1,29381206,185258804,957888,285434,185544238,146273683
29377174_325431,CM021100.1,1,29377174,185258803,339668,325431,185584234,146313679
29377174_325455,CM021100.1,1,29377174,185258803,339668,325455,185584258,146313703
29377174_325464,CM021100.1,1,29377174,185258803,339668,325464,185584267,146313712
29377174_325505,CM021100.1,1,29377174,185258803,339668,325505,185584308,146313753
29377174_325529,CM021100.1,1,29377174,185258803,339668,325529,185584332,146313777
29377174_325530,CM021100.1,1,29377174,185258803,339668,325530,185584333,146313778
29377174_325531,CM021100.1,1,29377174,185258803,339668,325531,185584334,146313779
29377174_325536,CM021100.1,1,29377174,185258803,339668,325536,185584339,146313784
29377174_325555,CM021100.1,1,29377174,185258803,339668,325555,185584358,146313803
29377174_325556,CM021100.1,1,29377174,185258803,339668,325556,185584359,146313804
29377174_325557,CM021100.1,1,29377174,185258803,339668,325557,185584360,146313805
29377174_325568,CM021100.1,1,29377174,185258803,339668,325568,185584371,146313816
29377174_325616,CM021100.1,1,29377174,185258803,339668,325616,185584419,146313864
29379661_399263,CM021100.1,1,29379661,185258805,1886762,399263,185658068,146387513
29379661_399279,CM021100.1,1,29379661,185258805,1886762,399279,185658084,146387529
29379661_399307,CM021100.1,1,29379661,185258805,1886762,399307,185658112,146387557
29379661_399337,CM021100.1,1,29379661,185258805,1886762,399337,185658142,146387587
29378406_577057,CM021100.1,1,29378406,185259459,2411145,577057,185836516,146565961
29378406_614249,CM021100.1,1,29378406,185259459,2411145,614249,185873708,146603153
29378406_614295,CM021100.1,1,29378406,185259459,2411145,614295,185873754,146603199
29377037_668375,CM021100.1,1,29377037,185259316,2242937,668375,185927691,146657136
29378406_672571,CM021100.1,1,29378406,185259459,2411145,672571,185932030,146661475
29377037_714757,CM021100.1,1,29377037,185259316,2242937,714757,185974073,146703518
29377035_730898,CM021100.1,1,29377035,185258804,3041048,730898,185989702,146719147
29380284_1182490,CM021100.1,1,29380284,185260779,1248142,1182490,186443269,147172714
29380284_1183154,CM021100.1,1,29380284,185260779,1248142,1183154,186443933,147173378
29378609_1195641,CM021100.1,1,29378609,185258805,2418187,1195641,186454446,147183891
29378609_1195647,CM021100.1,1,29378609,185258805,2418187,1195647,186454452,147183897
29378406_1366274,CM021100.1,1,29378406,185259459,2411145,1366274,186625733,147355178
29378406_1366342,CM021100.1,1,29378406,185259459,2411145,1366342,186625801,147355246
29379661_1396066,CM021100.1,1,29379661,185258805,1886762,1396066,186654871,147384316
29379661_1396111,CM021100.1,1,29379661,185258805,1886762,1396111,186654916,147384361
29378406_1417114,CM021100.1,1,29378406,185259459,2411145,1417114,186676573,147406018
29378406_1417138,CM021100.1,1,29378406,185259459,2411145,1417138,186676597,147406042
29378406_1417190,CM021100.1,1,29378406,185259459,2411145,1417190,186676649,147406094
29378406_1417201,CM021100.1,1,29378406,185259459,2411145,1417201,186676660,147406105
29378406_1417223,CM021100.1,1,29378406,185259459,2411145,1417223,186676682,147406127
29378406_1417253,CM021100.1,1,29378406,185259459,2411145,1417253,186676712,147406157
29379661_1530387,CM021100.1,1,29379661,185258805,1886762,1530387,186789192,147518637
29379661_1530406,CM021100.1,1,29379661,185258805,1886762,1530406,186789211,147518656
29379661_1543676,CM021100.1,1,29379661,185258805,1886762,1543676,186802481,147531926
29378406_1546520,CM021100.1,1,29378406,185259459,2411145,1546520,186805979,147535424
29379661_1567650,CM021100.1,1,29379661,185258805,1886762,1567650,186826455,147555900
29378406_1596303,CM021100.1,1,29378406,185259459,2411145,1596303,186855762,147585207
29378406_1596411,CM021100.1,1,29378406,185259459,2411145,1596411,186855870,147585315
29377037_1794183,CM021100.1,1,29377037,185259316,2242937,1794183,187053499,147782944
29377037_1794277,CM021100.1,1,29377037,185259316,2242937,1794277,187053593,147783038
29377037_1794307,CM021100.1,1,29377037,185259316,2242937,1794307,187053623,147783068
29377037_1794367,CM021100.1,1,29377037,185259316,2242937,1794367,187053683,147783128
29378609_1840319,CM021100.1,1,29378609,185258805,2418187,1840319,187099124,147828569
29378609_1840323,CM021100.1,1,29378609,185258805,2418187,1840323,187099128,147828573
29378609_1889122,CM021100.1,1,29378609,185258805,2418187,1889122,187147927,147877372
29378609_1889136,CM021100.1,1,29378609,185258805,2418187,1889136,187147941,147877386
29378609_1889231,CM021100.1,1,29378609,185258805,2418187,1889231,187148036,147877481
29364840_1342,CM021100.1,1,29364840,211983901,9561,1342,211985243,172714688
29360815_10002,CM021100.1,1,29360815,218043406,11178,10002,218053408,178782853
29360815_10058,CM021100.1,1,29360815,218043406,11178,10058,218053464,178782909
29360815_10061,CM021100.1,1,29360815,218043406,11178,10061,218053467,178782912
29360815_10064,CM021100.1,1,29360815,218043406,11178,10064,218053470,178782915
29360815_10095,CM021100.1,1,29360815,218043406,11178,10095,218053501,178782946
29360815_10100,CM021100.1,1,29360815,218043406,11178,10100,218053506,178782951
29360815_10155,CM021100.1,1,29360815,218043406,11178,10155,218053561,178783006
29360815_10162,CM021100.1,1,29360815,218043406,11178,10162,218053568,178783013
29370871_442343,CM021100.1,1,29370871,218040039,565056,442343,218482382,179211827
29361940_12770,CM021100.1,1,29361940,226995802,15048,12770,227008572,187738017
29378890_211503,CM021100.1,1,29378890,246853282,5875511,211503,247064785,207794230
29378890_211509,CM021100.1,1,29378890,246853282,5875511,211509,247064791,207794236
29378890_211536,CM021100.1,1,29378890,246853282,5875511,211536,247064818,207794263
29378890_211548,CM021100.1,1,29378890,246853282,5875511,211548,247064830,207794275
29378890_211564,CM021100.1,1,29378890,246853282,5875511,211564,247064846,207794291
29378890_211685,CM021100.1,1,29378890,246853282,5875511,211685,247064967,207794412
29381482_357430,CM021100.1,1,29381482,246853282,2795624,357430,247210712,207940157
29381482_357448,CM021100.1,1,29381482,246853282,2795624,357448,247210730,207940175
29381482_362681,CM021100.1,1,29381482,246853282,2795624,362681,247215963,207945408
29379874_609819,CM021100.1,1,29379874,246853282,4310334,609819,247463101,208192546
29378890_896247,CM021100.1,1,29378890,246853282,5875511,896247,247749529,208478974
29378890_896250,CM021100.1,1,29378890,246853282,5875511,896250,247749532,208478977
29378890_896269,CM021100.1,1,29378890,246853282,5875511,896269,247749551,208478996
29378890_896283,CM021100.1,1,29378890,246853282,5875511,896283,247749565,208479010
29378890_896398,CM021100.1,1,29378890,246853282,5875511,896398,247749680,208479125
29378890_896465,CM021100.1,1,29378890,246853282,5875511,896465,247749747,208479192
29378890_896480,CM021100.1,1,29378890,246853282,5875511,896480,247749762,208479207
29378890_986583,CM021100.1,1,29378890,246853282,5875511,986583,247839865,208569310
29378890_986618,CM021100.1,1,29378890,246853282,5875511,986618,247839900,208569345
29378890_986662,CM021100.1,1,29378890,246853282,5875511,986662,247839944,208569389
29378890_986690,CM021100.1,1,29378890,246853282,5875511,986690,247839972,208569417
29378890_986693,CM021100.1,1,29378890,246853282,5875511,986693,247839975,208569420
29378890_986715,CM021100.1,1,29378890,246853282,5875511,986715,247839997,208569442
29378701_1042323,CM021100.1,1,29378701,246853278,1691844,1042323,247895601,208625046
29378701_1042328,CM021100.1,1,29378701,246853278,1691844,1042328,247895606,208625051
29378701_1042344,CM021100.1,1,29378701,246853278,1691844,1042344,247895622,208625067
29378701_1042371,CM021100.1,1,29378701,246853278,1691844,1042371,247895649,208625094
29378701_1042426,CM021100.1,1,29378701,246853278,1691844,1042426,247895704,208625149
29378701_1042472,CM021100.1,1,29378701,246853278,1691844,1042472,247895750,208625195
29381482_1393773,CM021100.1,1,29381482,246853282,2795624,1393773,248247055,208976500
29379874_2012473,CM021100.1,1,29379874,246853282,4310334,2012473,248865755,209595200
29379666_2108509,CM021100.1,1,29379666,246853282,2380801,2108509,248961791,209691236
29381482_2340665,CM021100.1,1,29381482,246853282,2795624,2340665,249193947,209923392
29381482_2340751,CM021100.1,1,29381482,246853282,2795624,2340751,249194033,209923478
29378890_2373830,CM021100.1,1,29378890,246853282,5875511,2373830,249227112,209956557
29378890_3202824,CM021100.1,1,29378890,246853282,5875511,3202824,250056106,210785551
29378890_3487837,CM021100.1,1,29378890,246853282,5875511,3487837,250341119,211070564
29378890_3487872,CM021100.1,1,29378890,246853282,5875511,3487872,250341154,211070599
29378890_3487905,CM021100.1,1,29378890,246853282,5875511,3487905,250341187,211070632
29378890_3487953,CM021100.1,1,29378890,246853282,5875511,3487953,250341235,211070680
29378890_3487985,CM021100.1,1,29378890,246853282,5875511,3487985,250341267,211070712
29378890_3488022,CM021100.1,1,29378890,246853282,5875511,3488022,250341304,211070749
29378890_3488101,CM021100.1,1,29378890,246853282,5875511,3488101,250341383,211070828
29378890_3488105,CM021100.1,1,29378890,246853282,5875511,3488105,250341387,211070832
29378890_3494757,CM021100.1,1,29378890,246853282,5875511,3494757,250348039,211077484
29378890_3494762,CM021100.1,1,29378890,246853282,5875511,3494762,250348044,211077489
29378890_3496250,CM021100.1,1,29378890,246853282,5875511,3496250,250349532,211078977
29378890_3496256,CM021100.1,1,29378890,246853282,5875511,3496256,250349538,211078983
29379874_3530603,CM021100.1,1,29379874,246853282,4310334,3530603,250383885,211113330
29379874_3530738,CM021100.1,1,29379874,246853282,4310334,3530738,250384020,211113465
29344875_39261,CM021100.1,1,29344875,250491261,53325,39261,250530522,211259967
29379874_3829220,CM021100.1,1,29379874,246853282,4310334,3829220,250682502,211411947
29379874_3829268,CM021100.1,1,29379874,246853282,4310334,3829268,250682550,211411995
29378890_3931132,CM021100.1,1,29378890,246853282,5875511,3931132,250784414,211513859
29378890_3931149,CM021100.1,1,29378890,246853282,5875511,3931149,250784431,211513876
29378890_3931199,CM021100.1,1,29378890,246853282,5875511,3931199,250784481,211513926
29378890_4096908,CM021100.1,1,29378890,246853282,5875511,4096908,250950190,211679635
29378890_4171499,CM021100.1,1,29378890,246853282,5875511,4171499,251024781,211754226
29378890_5471017,CM021100.1,1,29378890,246853282,5875511,5471017,252324299,213053744
29378890_5471026,CM021100.1,1,29378890,246853282,5875511,5471026,252324308,213053753
29378890_5502902,CM021100.1,1,29378890,246853282,5875511,5502902,252356184,213085629
29378890_5502908,CM021100.1,1,29378890,246853282,5875511,5502908,252356190,213085635
29378890_5502942,CM021100.1,1,29378890,246853282,5875511,5502942,252356224,213085669
29378890_5502952,CM021100.1,1,29378890,246853282,5875511,5502952,252356234,213085679
29378890_5503051,CM021100.1,1,29378890,246853282,5875511,5503051,252356333,213085778
29378890_5503072,CM021100.1,1,29378890,246853282,5875511,5503072,252356354,213085799
29378890_5507848,CM021100.1,1,29378890,246853282,5875511,5507848,252361130,213090575
29343946_6283,CM021100.1,1,29343946,267529556,20674,6283,267535839,228265284
29356580_176290,CM021100.1,1,29356580,267527281,278026,176290,267703571,228433016
29379486_57933,CM021100.1,1,29379486,276778027,602240,57933,276835960,237565405
29379486_57946,CM021100.1,1,29379486,276778027,602240,57946,276835973,237565418
29336622_142690,CM021100.1,1,29336622,276778261,323370,142690,276920951,237650396
29336622_142908,CM021100.1,1,29336622,276778261,323370,142908,276921169,237650614
29336622_142924,CM021100.1,1,29336622,276778261,323370,142924,276921185,237650630
29336622_142938,CM021100.1,1,29336622,276778261,323370,142938,276921199,237650644
29336622_142949,CM021100.1,1,29336622,276778261,323370,142949,276921210,237650655
29336622_142979,CM021100.1,1,29336622,276778261,323370,142979,276921240,237650685
29336622_143035,CM021100.1,1,29336622,276778261,323370,143035,276921296,237650741
29336622_143163,CM021100.1,1,29336622,276778261,323370,143163,276921424,237650869
29336622_151895,CM021100.1,1,29336622,276778261,323370,151895,276930156,237659601
29379915_171725,CM021100.1,1,29379915,276781605,1471147,171725,276953330,237682775
29379915_171772,CM021100.1,1,29379915,276781605,1471147,171772,276953377,237682822
29379915_171774,CM021100.1,1,29379915,276781605,1471147,171774,276953379,237682824
29379915_180371,CM021100.1,1,29379915,276781605,1471147,180371,276961976,237691421
29378838_202850,CM021100.1,1,29378838,276780763,530158,202850,276983613,237713058
29336622_261097,CM021100.1,1,29336622,276778261,323370,261097,277039358,237768803
29336622_261098,CM021100.1,1,29336622,276778261,323370,261098,277039359,237768804
29336622_261123,CM021100.1,1,29336622,276778261,323370,261123,277039384,237768829
29336622_261147,CM021100.1,1,29336622,276778261,323370,261147,277039408,237768853
29379888_324759,CM021100.1,1,29379888,276778025,336330,324759,277102784,237832229
29379888_324783,CM021100.1,1,29379888,276778025,336330,324783,277102808,237832253
29379888_324848,CM021100.1,1,29379888,276778025,336330,324848,277102873,237832318
29379888_324906,CM021100.1,1,29379888,276778025,336330,324906,277102931,237832376
29379888_324983,CM021100.1,1,29379888,276778025,336330,324983,277103008,237832453
29379052_367299,CM021100.1,1,29379052,276778027,1776487,367299,277145326,237874771
29378491_409287,CM021100.1,1,29378491,276778026,2642172,409287,277187313,237916758
29378491_409352,CM021100.1,1,29378491,276778026,2642172,409352,277187378,237916823
29378491_409435,CM021100.1,1,29378491,276778026,2642172,409435,277187461,237916906
29378491_410994,CM021100.1,1,29378491,276778026,2642172,410994,277189020,237918465
29378491_411129,CM021100.1,1,29378491,276778026,2642172,411129,277189155,237918600
29378491_411163,CM021100.1,1,29378491,276778026,2642172,411163,277189189,237918634
29378491_411250,CM021100.1,1,29378491,276778026,2642172,411250,277189276,237918721
29378491_463044,CM021100.1,1,29378491,276778026,2642172,463044,277241070,237970515
29381445_556903,CM021100.1,1,29381445,276778027,2271468,556903,277334930,238064375
29378491_600656,CM021100.1,1,29378491,276778026,2642172,600656,277378682,238108127
29378491_600690,CM021100.1,1,29378491,276778026,2642172,600690,277378716,238108161
29378491_607341,CM021100.1,1,29378491,276778026,2642172,607341,277385367,238114812
29378955_694980,CM021100.1,1,29378955,276778027,2524568,694980,277473007,238202452
29378955_694999,CM021100.1,1,29378955,276778027,2524568,694999,277473026,238202471
29378955_734639,CM021100.1,1,29378955,276778027,2524568,734639,277512666,238242111
29379052_799242,CM021100.1,1,29379052,276778027,1776487,799242,277577269,238306714
29377027_799354,CM021100.1,1,29377027,276778026,3829491,799354,277577380,238306825
29377027_799360,CM021100.1,1,29377027,276778026,3829491,799360,277577386,238306831
29379052_799361,CM021100.1,1,29379052,276778027,1776487,799361,277577388,238306833
29377027_799479,CM021100.1,1,29377027,276778026,3829491,799479,277577505,238306950
29377027_800105,CM021100.1,1,29377027,276778026,3829491,800105,277578131,238307576
29381445_813689,CM021100.1,1,29381445,276778027,2271468,813689,277591716,238321161
29381445_813690,CM021100.1,1,29381445,276778027,2271468,813690,277591717,238321162
29381445_813710,CM021100.1,1,29381445,276778027,2271468,813710,277591737,238321182
29377027_945642,CM021100.1,1,29377027,276778026,3829491,945642,277723668,238453113
29377027_945695,CM021100.1,1,29377027,276778026,3829491,945695,277723721,238453166
29377027_945741,CM021100.1,1,29377027,276778026,3829491,945741,277723767,238453212
29379915_1173216,CM021100.1,1,29379915,276781605,1471147,1173216,277954821,238684266
29379052_1205635,CM021100.1,1,29379052,276778027,1776487,1205635,277983662,238713107
29379052_1205835,CM021100.1,1,29379052,276778027,1776487,1205835,277983862,238713307
29379052_1205867,CM021100.1,1,29379052,276778027,1776487,1205867,277983894,238713339
29379052_1205892,CM021100.1,1,29379052,276778027,1776487,1205892,277983919,238713364
29378491_1330940,CM021100.1,1,29378491,276778026,2642172,1330940,278108966,238838411
29378491_1330962,CM021100.1,1,29378491,276778026,2642172,1330962,278108988,238838433
29378491_1334108,CM021100.1,1,29378491,276778026,2642172,1334108,278112134,238841579
29378491_1334118,CM021100.1,1,29378491,276778026,2642172,1334118,278112144,238841589
29378491_1334132,CM021100.1,1,29378491,276778026,2642172,1334132,278112158,238841603
29379915_1425555,CM021100.1,1,29379915,276781605,1471147,1425555,278207160,238936605
29381265_1558139,CM021100.1,1,29381265,276778027,1615509,1558139,278336166,239065611
29381265_1558234,CM021100.1,1,29381265,276778027,1615509,1558234,278336261,239065706
29378491_1588942,CM021100.1,1,29378491,276778026,2642172,1588942,278366968,239096413
29378491_1589002,CM021100.1,1,29378491,276778026,2642172,1589002,278367028,239096473
29377027_2159162,CM021100.1,1,29377027,276778026,3829491,2159162,278937188,239666633
29378955_2347146,CM021100.1,1,29378955,276778027,2524568,2347146,279125173,239854618
29377027_2918349,CM021100.1,1,29377027,276778026,3829491,2918349,279696375,240425820
29377027_2918396,CM021100.1,1,29377027,276778026,3829491,2918396,279696422,240425867
29377027_2918703,CM021100.1,1,29377027,276778026,3829491,2918703,279696729,240426174
29377027_2918721,CM021100.1,1,29377027,276778026,3829491,2918721,279696747,240426192
29377027_2919932,CM021100.1,1,29377027,276778026,3829491,2919932,279697958,240427403
29381182_207830,CM021100.1,1,29381182,282399276,706960,207830,282607106,243336551
29381182_207845,CM021100.1,1,29381182,282399276,706960,207845,282607121,243336566
29381182_207849,CM021100.1,1,29381182,282399276,706960,207849,282607125,243336570
29379422_540086,CM021100.1,1,29379422,282399272,2879589,540086,282939358,243668803
29379422_1357447,CM021100.1,1,29379422,282399272,2879589,1357447,283756719,244486164
29379422_1357460,CM021100.1,1,29379422,282399272,2879589,1357460,283756732,244486177
29379422_1357485,CM021100.1,1,29379422,282399272,2879589,1357485,283756757,244486202
29379422_1357493,CM021100.1,1,29379422,282399272,2879589,1357493,283756765,244486210
29379422_1357511,CM021100.1,1,29379422,282399272,2879589,1357511,283756783,244486228
29379422_1357523,CM021100.1,1,29379422,282399272,2879589,1357523,283756795,244486240
29379422_1357530,CM021100.1,1,29379422,282399272,2879589,1357530,283756802,244486247
29379422_1357553,CM021100.1,1,29379422,282399272,2879589,1357553,283756825,244486270
29379422_1357609,CM021100.1,1,29379422,282399272,2879589,1357609,283756881,244486326
29379422_1357617,CM021100.1,1,29379422,282399272,2879589,1357617,283756889,244486334
29379422_1714807,CM021100.1,1,29379422,282399272,2879589,1714807,284114079,244843524
29379422_2651961,CM021100.1,1,29379422,282399272,2879589,2651961,285051233,245780678
29379422_2651965,CM021100.1,1,29379422,282399272,2879589,2651965,285051237,245780682
29379422_2651969,CM021100.1,1,29379422,282399272,2879589,2651969,285051241,245780686
29379422_2651976,CM021100.1,1,29379422,282399272,2879589,2651976,285051248,245780693
29381211_3096,CM021100.1,1,29381211,294126462,1814517,3096,294129558,254859003
29381211_3510,CM021100.1,1,29381211,294126462,1814517,3510,294129972,254859417
29381211_13993,CM021100.1,1,29381211,294126462,1814517,13993,294140455,254869900
29381316_31652,CM021100.1,1,29381316,294128146,2394788,31652,294159798,254889243
29377036_73908,CM021100.1,1,29377036,294125656,1126323,73908,294199564,254929009
29377449_85582,CM021100.1,1,29377449,294130829,419828,85582,294216411,254945856
29377036_120322,CM021100.1,1,29377036,294125656,1126323,120322,294245978,254975423
29377036_120428,CM021100.1,1,29377036,294125656,1126323,120428,294246084,254975529
29377036_122199,CM021100.1,1,29377036,294125656,1126323,122199,294247855,254977300
29378414_207512,CM021100.1,1,29378414,294105695,4873643,207512,294313207,255042652
29378414_207527,CM021100.1,1,29378414,294105695,4873643,207527,294313222,255042667
29381568_199305,CM021100.1,1,29381568,294126241,495717,199305,294325546,255054991
29381568_199376,CM021100.1,1,29381568,294126241,495717,199376,294325617,255055062
29381568_249023,CM021100.1,1,29381568,294126241,495717,249023,294375264,255104709
29381568_249049,CM021100.1,1,29381568,294126241,495717,249049,294375290,255104735
29381568_249091,CM021100.1,1,29381568,294126241,495717,249091,294375332,255104777
29382326_249424,CM021100.1,1,29382326,294127533,644567,249424,294376957,255106402
29382326_251805,CM021100.1,1,29382326,294127533,644567,251805,294379338,255108783
29381568_258248,CM021100.1,1,29381568,294126241,495717,258248,294384489,255113934
29381568_258263,CM021100.1,1,29381568,294126241,495717,258263,294384504,255113949
29381568_258270,CM021100.1,1,29381568,294126241,495717,258270,294384511,255113956
29381568_258284,CM021100.1,1,29381568,294126241,495717,258284,294384525,255113970
29381568_258285,CM021100.1,1,29381568,294126241,495717,258285,294384526,255113971
29380452_287113,CM021100.1,1,29380452,294105695,1310940,287113,294392808,255122253
29380452_313589,CM021100.1,1,29380452,294105695,1310940,313589,294419284,255148729
29382010_304094,CM021100.1,1,29382010,294127734,583877,304094,294431828,255161273
29382010_304118,CM021100.1,1,29382010,294127734,583877,304118,294431852,255161297
29379781_337598,CM021100.1,1,29379781,294105695,1065847,337598,294443293,255172738
29379086_350706,CM021100.1,1,29379086,294105695,1401016,350706,294456401,255185846
29379086_352692,CM021100.1,1,29379086,294105695,1401016,352692,294458387,255187832
29379162_381106,CM021100.1,1,29379162,294105696,4222843,381106,294486802,255216247
29379162_381152,CM021100.1,1,29379162,294105696,4222843,381152,294486848,255216293
29379162_381157,CM021100.1,1,29379162,294105696,4222843,381157,294486853,255216298
29379162_381162,CM021100.1,1,29379162,294105696,4222843,381162,294486858,255216303
29379162_381163,CM021100.1,1,29379162,294105696,4222843,381163,294486859,255216304
29379162_381187,CM021100.1,1,29379162,294105696,4222843,381187,294486883,255216328
29379162_381200,CM021100.1,1,29379162,294105696,4222843,381200,294486896,255216341
29379162_381215,CM021100.1,1,29379162,294105696,4222843,381215,294486911,255216356
29378878_383711,CM021100.1,1,29378878,294118684,9517285,383711,294502395,255231840
29377449_390172,CM021100.1,1,29377449,294130829,419828,390172,294521001,255250446
29377449_390270,CM021100.1,1,29377449,294130829,419828,390270,294521099,255250544
29377449_390322,CM021100.1,1,29377449,294130829,419828,390322,294521151,255250596
29377802_423813,CM021100.1,1,29377802,294105691,1150533,423813,294529504,255258949
29377802_423899,CM021100.1,1,29377802,294105691,1150533,423899,294529590,255259035
29378878_459215,CM021100.1,1,29378878,294118684,9517285,459215,294577899,255307344
29381150_468898,CM021100.1,1,29381150,294127043,4254960,468898,294595941,255325386
29381316_508179,CM021100.1,1,29381316,294128146,2394788,508179,294636325,255365770
29382326_523552,CM021100.1,1,29382326,294127533,644567,523552,294651085,255380530
29382326_523611,CM021100.1,1,29382326,294127533,644567,523611,294651144,255380589
29382326_557659,CM021100.1,1,29382326,294127533,644567,557659,294685192,255414637
29382326_557684,CM021100.1,1,29382326,294127533,644567,557684,294685217,255414662
29377802_673363,CM021100.1,1,29377802,294105691,1150533,673363,294779054,255508499
29377802_673506,CM021100.1,1,29377802,294105691,1150533,673506,294779197,255508642
29377802_673557,CM021100.1,1,29377802,294105691,1150533,673557,294779248,255508693
29377802_673578,CM021100.1,1,29377802,294105691,1150533,673578,294779269,255508714
29380405_686707,CM021100.1,1,29380405,294125632,1581957,686707,294812339,255541784
29380405_686725,CM021100.1,1,29380405,294125632,1581957,686725,294812357,255541802
29380405_686769,CM021100.1,1,29380405,294125632,1581957,686769,294812401,255541846
29380171_709639,CM021100.1,1,29380171,294105695,1954934,709639,294815334,255544779
29380171_724399,CM021100.1,1,29380171,294105695,1954934,724399,294830094,255559539
29380171_724410,CM021100.1,1,29380171,294105695,1954934,724410,294830105,255559550
29380171_724420,CM021100.1,1,29380171,294105695,1954934,724420,294830115,255559560
29380171_724458,CM021100.1,1,29380171,294105695,1954934,724458,294830153,255559598
29377442_735919,CM021100.1,1,29377442,294106834,2389868,735919,294842753,255572198
29377442_735972,CM021100.1,1,29377442,294106834,2389868,735972,294842806,255572251
29377442_736105,CM021100.1,1,29377442,294106834,2389868,736105,294842939,255572384
29377442_736144,CM021100.1,1,29377442,294106834,2389868,736144,294842978,255572423
29377442_736224,CM021100.1,1,29377442,294106834,2389868,736224,294843058,255572503
29377442_736349,CM021100.1,1,29377442,294106834,2389868,736349,294843183,255572628
29377442_736385,CM021100.1,1,29377442,294106834,2389868,736385,294843219,255572664
29380171_773486,CM021100.1,1,29380171,294105695,1954934,773486,294879181,255608626
29381906_756058,CM021100.1,1,29381906,294128182,1469055,756058,294884240,255613685
29381906_756104,CM021100.1,1,29381906,294128182,1469055,756104,294884286,255613731
29381906_756122,CM021100.1,1,29381906,294128182,1469055,756122,294884304,255613749
29377802_780248,CM021100.1,1,29377802,294105691,1150533,780248,294885939,255615384
29381906_827694,CM021100.1,1,29381906,294128182,1469055,827694,294955876,255685321
29381906_827753,CM021100.1,1,29381906,294128182,1469055,827753,294955935,255685380
29381906_827799,CM021100.1,1,29381906,294128182,1469055,827799,294955981,255685426
29378878_846980,CM021100.1,1,29378878,294118684,9517285,846980,294965664,255695109
29378878_847138,CM021100.1,1,29378878,294118684,9517285,847138,294965822,255695267
29381906_842149,CM021100.1,1,29381906,294128182,1469055,842149,294970331,255699776
29379994_901177,CM021100.1,1,29379994,294105696,3124861,901177,295006873,255736318
29379994_901187,CM021100.1,1,29379994,294105696,3124861,901187,295006883,255736328
29381316_942953,CM021100.1,1,29381316,294128146,2394788,942953,295071099,255800544
29381316_943434,CM021100.1,1,29381316,294128146,2394788,943434,295071580,255801025
29379539_1003587,CM021100.1,1,29379539,294105696,1357784,1003587,295109283,255838728
29379539_1003625,CM021100.1,1,29379539,294105696,1357784,1003625,295109321,255838766
29379539_1003641,CM021100.1,1,29379539,294105696,1357784,1003641,295109337,255838782
29382416_1004072,CM021100.1,1,29382416,294105695,8650246,1004072,295109767,255839212
29382416_1004083,CM021100.1,1,29382416,294105695,8650246,1004083,295109778,255839223
29382416_1004220,CM021100.1,1,29382416,294105695,8650246,1004220,295109915,255839360
29379162_1048338,CM021100.1,1,29379162,294105696,4222843,1048338,295154034,255883479
29379162_1048340,CM021100.1,1,29379162,294105696,4222843,1048340,295154036,255883481
29379162_1048388,CM021100.1,1,29379162,294105696,4222843,1048388,295154084,255883529
29379162_1048443,CM021100.1,1,29379162,294105696,4222843,1048443,295154139,255883584
29379162_1052632,CM021100.1,1,29379162,294105696,4222843,1052632,295158328,255887773
29379162_1053249,CM021100.1,1,29379162,294105696,4222843,1053249,295158945,255888390
29380434_1062896,CM021100.1,1,29380434,294105694,2914788,1062896,295168590,255898035
29380434_1063016,CM021100.1,1,29380434,294105694,2914788,1063016,295168710,255898155
29380434_1063990,CM021100.1,1,29380434,294105694,2914788,1063990,295169684,255899129
29380434_1064022,CM021100.1,1,29380434,294105694,2914788,1064022,295169716,255899161
29377802_1095460,CM021100.1,1,29377802,294105691,1150533,1095460,295201151,255930596
29378878_1165736,CM021100.1,1,29378878,294118684,9517285,1165736,295284420,256013865
29378878_1165758,CM021100.1,1,29378878,294118684,9517285,1165758,295284442,256013887
29378878_1168553,CM021100.1,1,29378878,294118684,9517285,1168553,295287237,256016682
29378878_1178760,CM021100.1,1,29378878,294118684,9517285,1178760,295297444,256026889
29378878_1178787,CM021100.1,1,29378878,294118684,9517285,1178787,295297471,256026916
29378878_1178862,CM021100.1,1,29378878,294118684,9517285,1178862,295297546,256026991
29381150_1183091,CM021100.1,1,29381150,294127043,4254960,1183091,295310134,256039579
29381150_1185337,CM021100.1,1,29381150,294127043,4254960,1185337,295312380,256041825
29381150_1185343,CM021100.1,1,29381150,294127043,4254960,1185343,295312386,256041831
29381150_1187386,CM021100.1,1,29381150,294127043,4254960,1187386,295314429,256043874
29381150_1187429,CM021100.1,1,29381150,294127043,4254960,1187429,295314472,256043917
29381150_1187450,CM021100.1,1,29381150,294127043,4254960,1187450,295314493,256043938
29381150_1187451,CM021100.1,1,29381150,294127043,4254960,1187451,295314494,256043939
29378393_1214527,CM021100.1,1,29378393,294105695,2139931,1214527,295320222,256049667
29378393_1214571,CM021100.1,1,29378393,294105695,2139931,1214571,295320266,256049711
29378393_1214588,CM021100.1,1,29378393,294105695,2139931,1214588,295320283,256049728
29378393_1214887,CM021100.1,1,29378393,294105695,2139931,1214887,295320582,256050027
29380434_1261631,CM021100.1,1,29380434,294105694,2914788,1261631,295367325,256096770
29380434_1261662,CM021100.1,1,29380434,294105694,2914788,1261662,295367356,256096801
29380434_1276761,CM021100.1,1,29380434,294105694,2914788,1276761,295382455,256111900
29380434_1276800,CM021100.1,1,29380434,294105694,2914788,1276800,295382494,256111939
29380434_1276819,CM021100.1,1,29380434,294105694,2914788,1276819,295382513,256111958
29382416_1306254,CM021100.1,1,29382416,294105695,8650246,1306254,295411949,256141394
29380434_1308903,CM021100.1,1,29380434,294105694,2914788,1308903,295414597,256144042
29380434_1317650,CM021100.1,1,29380434,294105694,2914788,1317650,295423344,256152789
29380434_1317693,CM021100.1,1,29380434,294105694,2914788,1317693,295423387,256152832
29380434_1317702,CM021100.1,1,29380434,294105694,2914788,1317702,295423396,256152841
29378878_1341471,CM021100.1,1,29378878,294118684,9517285,1341471,295460155,256189600
29378878_1344707,CM021100.1,1,29378878,294118684,9517285,1344707,295463391,256192836
29378878_1374486,CM021100.1,1,29378878,294118684,9517285,1374486,295493170,256222615
29382440_1509462,CM021100.1,1,29382440,294126068,4383832,1509462,295635530,256364975
29381150_1540642,CM021100.1,1,29381150,294127043,4254960,1540642,295667685,256397130
29378393_1651651,CM021100.1,1,29378393,294105695,2139931,1651651,295757346,256486791
29378393_1672502,CM021100.1,1,29378393,294105695,2139931,1672502,295778197,256507642
29382416_1697792,CM021100.1,1,29382416,294105695,8650246,1697792,295803487,256532932
29379973_1680602,CM021100.1,1,29379973,294127335,6312542,1680602,295807937,256537382
29378393_1739604,CM021100.1,1,29378393,294105695,2139931,1739604,295845299,256574744
29378393_1745773,CM021100.1,1,29378393,294105695,2139931,1745773,295851468,256580913
29378393_1745804,CM021100.1,1,29378393,294105695,2139931,1745804,295851499,256580944
29378393_1777639,CM021100.1,1,29378393,294105695,2139931,1777639,295883334,256612779
29378393_1777698,CM021100.1,1,29378393,294105695,2139931,1777698,295883393,256612838
29378054_1799062,CM021100.1,1,29378054,294126927,1944618,1799062,295925989,256655434
29378054_1799130,CM021100.1,1,29378054,294126927,1944618,1799130,295926057,256655502
29378054_1903595,CM021100.1,1,29378054,294126927,1944618,1903595,296030522,256759967
29378054_1903649,CM021100.1,1,29378054,294126927,1944618,1903649,296030576,256760021
29378054_1903657,CM021100.1,1,29378054,294126927,1944618,1903657,296030584,256760029
29379973_1919697,CM021100.1,1,29379973,294127335,6312542,1919697,296047032,256776477
29379973_1919744,CM021100.1,1,29379973,294127335,6312542,1919744,296047079,256776524
29379973_1919813,CM021100.1,1,29379973,294127335,6312542,1919813,296047148,256776593
29377442_2037041,CM021100.1,1,29377442,294106834,2389868,2037041,296143875,256873320
29381316_2034063,CM021100.1,1,29381316,294128146,2394788,2034063,296162209,256891654
29381316_2034125,CM021100.1,1,29381316,294128146,2394788,2034125,296162271,256891716
29378972_2058062,CM021100.1,1,29378972,294105696,2364877,2058062,296163758,256893203
29378015_2112706,CM021100.1,1,29378015,294105697,5895538,2112706,296218403,256947848
29378015_2114192,CM021100.1,1,29378015,294105697,5895538,2114192,296219889,256949334
29378015_2114319,CM021100.1,1,29378015,294105697,5895538,2114319,296220016,256949461
29380206_2119045,CM021100.1,1,29380206,294126520,4345636,2119045,296245565,256975010
29380206_2119126,CM021100.1,1,29380206,294126520,4345636,2119126,296245646,256975091
29378015_2176697,CM021100.1,1,29378015,294105697,5895538,2176697,296282394,257011839
29379817_2226642,CM021100.1,1,29379817,294126474,4153867,2226642,296353116,257082561
29379817_2228606,CM021100.1,1,29379817,294126474,4153867,2228606,296355080,257084525
29379817_2228646,CM021100.1,1,29379817,294126474,4153867,2228646,296355120,257084565
29378015_2259849,CM021100.1,1,29378015,294105697,5895538,2259849,296365546,257094991
29378015_2260097,CM021100.1,1,29378015,294105697,5895538,2260097,296365794,257095239
29378015_2260191,CM021100.1,1,29378015,294105697,5895538,2260191,296365888,257095333
29379162_2297472,CM021100.1,1,29379162,294105696,4222843,2297472,296403168,257132613
29378015_2321687,CM021100.1,1,29378015,294105697,5895538,2321687,296427384,257156829
29378015_2321695,CM021100.1,1,29378015,294105697,5895538,2321695,296427392,257156837
29379162_2382185,CM021100.1,1,29379162,294105696,4222843,2382185,296487881,257217326
29382416_2426569,CM021100.1,1,29382416,294105695,8650246,2426569,296532264,257261709
29382416_2426617,CM021100.1,1,29382416,294105695,8650246,2426617,296532312,257261757
29382416_2426632,CM021100.1,1,29382416,294105695,8650246,2426632,296532327,257261772
29378015_2452605,CM021100.1,1,29378015,294105697,5895538,2452605,296558302,257287747
29378015_2452669,CM021100.1,1,29378015,294105697,5895538,2452669,296558366,257287811
29378015_2452763,CM021100.1,1,29378015,294105697,5895538,2452763,296558460,257287905
29380206_2448275,CM021100.1,1,29380206,294126520,4345636,2448275,296574795,257304240
29380206_2448389,CM021100.1,1,29380206,294126520,4345636,2448389,296574909,257304354
29379817_2675047,CM021100.1,1,29379817,294126474,4153867,2675047,296801521,257530966
29382440_2758944,CM021100.1,1,29382440,294126068,4383832,2758944,296885012,257614457
29382440_2758956,CM021100.1,1,29382440,294126068,4383832,2758956,296885024,257614469
29382440_2772117,CM021100.1,1,29382440,294126068,4383832,2772117,296898185,257627630
29382440_2772148,CM021100.1,1,29382440,294126068,4383832,2772148,296898216,257627661
29380434_2844823,CM021100.1,1,29380434,294105694,2914788,2844823,296950517,257679962
29380434_2844861,CM021100.1,1,29380434,294105694,2914788,2844861,296950555,257680000
29380434_2844955,CM021100.1,1,29380434,294105694,2914788,2844955,296950649,257680094
29381150_2888785,CM021100.1,1,29381150,294127043,4254960,2888785,297015828,257745273
29382416_3056386,CM021100.1,1,29382416,294105695,8650246,3056386,297162081,257891526
29380206_3257593,CM021100.1,1,29380206,294126520,4345636,3257593,297384113,258113558
29380206_3257624,CM021100.1,1,29380206,294126520,4345636,3257624,297384144,258113589
29380206_3257632,CM021100.1,1,29380206,294126520,4345636,3257632,297384152,258113597
29378015_3526975,CM021100.1,1,29378015,294105697,5895538,3526975,297632672,258362117
29378015_3526987,CM021100.1,1,29378015,294105697,5895538,3526987,297632684,258362129
29378414_3642610,CM021100.1,1,29378414,294105695,4873643,3642610,297748305,258477750
29378414_3642690,CM021100.1,1,29378414,294105695,4873643,3642690,297748385,258477830
29378414_3642699,CM021100.1,1,29378414,294105695,4873643,3642699,297748394,258477839
29378015_3650507,CM021100.1,1,29378015,294105697,5895538,3650507,297756204,258485649
29378015_3650964,CM021100.1,1,29378015,294105697,5895538,3650964,297756661,258486106
29378015_3651059,CM021100.1,1,29378015,294105697,5895538,3651059,297756756,258486201
29378414_3652516,CM021100.1,1,29378414,294105695,4873643,3652516,297758211,258487656
29378414_3652540,CM021100.1,1,29378414,294105695,4873643,3652540,297758235,258487680
29378414_3680370,CM021100.1,1,29378414,294105695,4873643,3680370,297786065,258515510
29379817_3663391,CM021100.1,1,29379817,294126474,4153867,3663391,297789865,258519310
29379817_3663446,CM021100.1,1,29379817,294126474,4153867,3663446,297789920,258519365
29379817_3663487,CM021100.1,1,29379817,294126474,4153867,3663487,297789961,258519406
29379817_3663601,CM021100.1,1,29379817,294126474,4153867,3663601,297790075,258519520
29379973_3668238,CM021100.1,1,29379973,294127335,6312542,3668238,297795573,258525018
29379973_3668266,CM021100.1,1,29379973,294127335,6312542,3668266,297795601,258525046
29378414_3752797,CM021100.1,1,29378414,294105695,4873643,3752797,297858492,258587937
29382416_3761110,CM021100.1,1,29382416,294105695,8650246,3761110,297866805,258596250
29381150_3822916,CM021100.1,1,29381150,294127043,4254960,3822916,297949959,258679404
29381150_3825725,CM021100.1,1,29381150,294127043,4254960,3825725,297952768,258682213
29379973_3825689,CM021100.1,1,29379973,294127335,6312542,3825689,297953024,258682469
29382416_3855700,CM021100.1,1,29382416,294105695,8650246,3855700,297961395,258690840
29382416_3892631,CM021100.1,1,29382416,294105695,8650246,3892631,297998326,258727771
29379162_3896740,CM021100.1,1,29379162,294105696,4222843,3896740,298002436,258731881
29379162_3896917,CM021100.1,1,29379162,294105696,4222843,3896917,298002613,258732058
29379162_3908245,CM021100.1,1,29379162,294105696,4222843,3908245,298013941,258743386
29378015_4096550,CM021100.1,1,29378015,294105697,5895538,4096550,298202247,258931692
29378015_4216712,CM021100.1,1,29378015,294105697,5895538,4216712,298322409,259051854
29378015_4216745,CM021100.1,1,29378015,294105697,5895538,4216745,298322442,259051887
29382416_4283782,CM021100.1,1,29382416,294105695,8650246,4283782,298389477,259118922
29382416_4287025,CM021100.1,1,29382416,294105695,8650246,4287025,298392720,259122165
29378414_4330694,CM021100.1,1,29378414,294105695,4873643,4330694,298436389,259165834
29378414_4330710,CM021100.1,1,29378414,294105695,4873643,4330710,298436405,259165850
29378414_4411331,CM021100.1,1,29378414,294105695,4873643,4411331,298517026,259246471
29378414_4733634,CM021100.1,1,29378414,294105695,4873643,4733634,298839329,259568774
29378414_4733649,CM021100.1,1,29378414,294105695,4873643,4733649,298839344,259568789
29378414_4735206,CM021100.1,1,29378414,294105695,4873643,4735206,298840901,259570346
29378414_4735532,CM021100.1,1,29378414,294105695,4873643,4735532,298841227,259570672
29379512_4916460,CM021100.1,1,29379512,294126770,5058073,4916460,299043230,259772675
29379512_4916484,CM021100.1,1,29379512,294126770,5058073,4916484,299043254,259772699
29379512_4916517,CM021100.1,1,29379512,294126770,5058073,4916517,299043287,259772732
29379512_4916535,CM021100.1,1,29379512,294126770,5058073,4916535,299043305,259772750
29379512_4916604,CM021100.1,1,29379512,294126770,5058073,4916604,299043374,259772819
29378015_5028339,CM021100.1,1,29378015,294105697,5895538,5028339,299134036,259863481
29378015_5028407,CM021100.1,1,29378015,294105697,5895538,5028407,299134104,259863549
29378878_5141092,CM021100.1,1,29378878,294118684,9517285,5141092,299259776,259989221
29378015_5450456,CM021100.1,1,29378015,294105697,5895538,5450456,299556153,260285598
29378015_5480242,CM021100.1,1,29378015,294105697,5895538,5480242,299585939,260315384
29378015_5480347,CM021100.1,1,29378015,294105697,5895538,5480347,299586044,260315489
29378367_5686869,CM021100.1,1,29378367,294126645,9139559,5686869,299813514,260542959
29378015_5798567,CM021100.1,1,29378015,294105697,5895538,5798567,299904264,260633709
29378015_5808618,CM021100.1,1,29378015,294105697,5895538,5808618,299914315,260643760
29378878_6002167,CM021100.1,1,29378878,294118684,9517285,6002167,300120851,260850296
29382416_6537439,CM021100.1,1,29382416,294105695,8650246,6537439,300643134,261372579
29382416_6582239,CM021100.1,1,29382416,294105695,8650246,6582239,300687934,261417379
29382416_6582351,CM021100.1,1,29382416,294105695,8650246,6582351,300688046,261417491
29382416_6768819,CM021100.1,1,29382416,294105695,8650246,6768819,300874514,261603959
29382416_6768835,CM021100.1,1,29382416,294105695,8650246,6768835,300874530,261603975
29382416_6768864,CM021100.1,1,29382416,294105695,8650246,6768864,300874559,261604004
29382416_6768885,CM021100.1,1,29382416,294105695,8650246,6768885,300874580,261604025
29382416_6801562,CM021100.1,1,29382416,294105695,8650246,6801562,300907257,261636702
29382416_6801638,CM021100.1,1,29382416,294105695,8650246,6801638,300907333,261636778
29382416_6801742,CM021100.1,1,29382416,294105695,8650246,6801742,300907437,261636882
29382416_6827524,CM021100.1,1,29382416,294105695,8650246,6827524,300933219,261662664
29382416_6827540,CM021100.1,1,29382416,294105695,8650246,6827540,300933235,261662680
29382416_6827944,CM021100.1,1,29382416,294105695,8650246,6827944,300933639,261663084
29382416_6830343,CM021100.1,1,29382416,294105695,8650246,6830343,300936038,261665483
29382416_6830345,CM021100.1,1,29382416,294105695,8650246,6830345,300936040,261665485
29382416_7341012,CM021100.1,1,29382416,294105695,8650246,7341012,301446707,262176152
29382416_7341932,CM021100.1,1,29382416,294105695,8650246,7341932,301447627,262177072
29382416_7341990,CM021100.1,1,29382416,294105695,8650246,7341990,301447685,262177130
29382416_7342366,CM021100.1,1,29382416,294105695,8650246,7342366,301448061,262177506
29382416_7342387,CM021100.1,1,29382416,294105695,8650246,7342387,301448082,262177527
29382416_7356253,CM021100.1,1,29382416,294105695,8650246,7356253,301461948,262191393
29382416_7356451,CM021100.1,1,29382416,294105695,8650246,7356451,301462146,262191591
29382416_7358227,CM021100.1,1,29382416,294105695,8650246,7358227,301463922,262193367
29382416_7433108,CM021100.1,1,29382416,294105695,8650246,7433108,301538803,262268248
29382416_7433118,CM021100.1,1,29382416,294105695,8650246,7433118,301538813,262268258
29382416_7433183,CM021100.1,1,29382416,294105695,8650246,7433183,301538878,262268323
29382416_7433237,CM021100.1,1,29382416,294105695,8650246,7433237,301538932,262268377
29382416_7433270,CM021100.1,1,29382416,294105695,8650246,7433270,301538965,262268410
29382416_7433274,CM021100.1,1,29382416,294105695,8650246,7433274,301538969,262268414
29382416_7433295,CM021100.1,1,29382416,294105695,8650246,7433295,301538990,262268435
29378367_7863594,CM021100.1,1,29378367,294126645,9139559,7863594,301990239,262719684
29378367_7894508,CM021100.1,1,29378367,294126645,9139559,7894508,302021153,262750598
29378878_8197201,CM021100.1,1,29378878,294118684,9517285,8197201,302315885,263045330
29378878_8204330,CM021100.1,1,29378878,294118684,9517285,8204330,302323014,263052459
29378878_8204419,CM021100.1,1,29378878,294118684,9517285,8204419,302323103,263052548
29378367_8456330,CM021100.1,1,29378367,294126645,9139559,8456330,302582975,263312420
29378367_8456331,CM021100.1,1,29378367,294126645,9139559,8456331,302582976,263312421
29378367_8456394,CM021100.1,1,29378367,294126645,9139559,8456394,302583039,263312484
29378367_8456404,CM021100.1,1,29378367,294126645,9139559,8456404,302583049,263312494
29378878_8522640,CM021100.1,1,29378878,294118684,9517285,8522640,302641324,263370769
29378878_8522851,CM021100.1,1,29378878,294118684,9517285,8522851,302641535,263370980
29378878_8612001,CM021100.1,1,29378878,294118684,9517285,8612001,302730685,263460130
29378878_8613353,CM021100.1,1,29378878,294118684,9517285,8613353,302732037,263461482
29378878_8613592,CM021100.1,1,29378878,294118684,9517285,8613592,302732276,263461721
29378878_8620192,CM021100.1,1,29378878,294118684,9517285,8620192,302738876,263468321
29378367_8694494,CM021100.1,1,29378367,294126645,9139559,8694494,302821139,263550584
29378367_8873336,CM021100.1,1,29378367,294126645,9139559,8873336,302999981,263729426
29378878_9399725,CM021100.1,1,29378878,294118684,9517285,9399725,303518409,264247854
29378878_9399737,CM021100.1,1,29378878,294118684,9517285,9399737,303518421,264247866
29378878_9399811,CM021100.1,1,29378878,294118684,9517285,9399811,303518495,264247940
29378878_9399829,CM021100.1,1,29378878,294118684,9517285,9399829,303518513,264247958
29378878_9399840,CM021100.1,1,29378878,294118684,9517285,9399840,303518524,264247969
29378878_9399855,CM021100.1,1,29378878,294118684,9517285,9399855,303518539,264247984
29378878_9399928,CM021100.1,1,29378878,294118684,9517285,9399928,303518612,264248057
29378878_9399941,CM021100.1,1,29378878,294118684,9517285,9399941,303518625,264248070
29378878_9400798,CM021100.1,1,29378878,294118684,9517285,9400798,303519482,264248927
29378878_9400801,CM021100.1,1,29378878,294118684,9517285,9400801,303519485,264248930
29378878_9400847,CM021100.1,1,29378878,294118684,9517285,9400847,303519531,264248976
29378878_9400926,CM021100.1,1,29378878,294118684,9517285,9400926,303519610,264249055
29378878_9400929,CM021100.1,1,29378878,294118684,9517285,9400929,303519613,264249058
29378878_9422009,CM021100.1,1,29378878,294118684,9517285,9422009,303540693,264270138
293504861_12358,CM021100.1,1,293504861,317779701,18889,12358,317792059,278521504
293504861_12429,CM021100.1,1,293504861,317779701,18889,12429,317792130,278521575
293504861_12461,CM021100.1,1,293504861,317779701,18889,12461,317792162,278521607
29379902_445337,CM021100.1,1,29379902,327653819,530100,445337,328099156,288828601
29379902_495015,CM021100.1,1,29379902,327653819,530100,495015,328148834,288878279
29349059_140174,CM021100.1,1,29349059,337046018,486210,140174,337186192,297915637
29349059_140364,CM021100.1,1,29349059,337046018,486210,140364,337186382,297915827
29379077_50064,CM021100.1,1,29379077,340188939,3411761,50064,340239003,300968448
29379077_50072,CM021100.1,1,29379077,340188939,3411761,50072,340239011,300968456
29379077_50130,CM021100.1,1,29379077,340188939,3411761,50130,340239069,300968514
29377264_63044,CM021100.1,1,29377264,340183824,457241,63044,340246868,300976313
29377264_63052,CM021100.1,1,29377264,340183824,457241,63052,340246876,300976321
29377264_63102,CM021100.1,1,29377264,340183824,457241,63102,340246926,300976371
29377264_63122,CM021100.1,1,29377264,340183824,457241,63122,340246946,300976391
29377264_63484,CM021100.1,1,29377264,340183824,457241,63484,340247308,300976753
29377264_63542,CM021100.1,1,29377264,340183824,457241,63542,340247366,300976811
29382140_71317,CM021100.1,1,29382140,340183825,974089,71317,340255142,300984587
29378830_83122,CM021100.1,1,29378830,340183825,1126957,83122,340266947,300996392
29378830_83175,CM021100.1,1,29378830,340183825,1126957,83175,340267000,300996445
29378830_83197,CM021100.1,1,29378830,340183825,1126957,83197,340267022,300996467
29378830_83227,CM021100.1,1,29378830,340183825,1126957,83227,340267052,300996497
29381915_98470,CM021100.1,1,29381915,340183825,754017,98470,340282295,301011740
29381915_98474,CM021100.1,1,29381915,340183825,754017,98474,340282299,301011744
29381915_98492,CM021100.1,1,29381915,340183825,754017,98492,340282317,301011762
29347148_99503,CM021100.1,1,29347148,340183825,131342,99503,340283328,301012773
29381079_145800,CM021100.1,1,29381079,340187817,4912329,145800,340333617,301063062
29381079_145821,CM021100.1,1,29381079,340187817,4912329,145821,340333638,301063083
29381079_145843,CM021100.1,1,29381079,340187817,4912329,145843,340333660,301063105
29381079_145876,CM021100.1,1,29381079,340187817,4912329,145876,340333693,301063138
29381079_145892,CM021100.1,1,29381079,340187817,4912329,145892,340333709,301063154
29381120_266881,CM021100.1,1,29381120,340183827,2533515,266881,340450708,301180153
29381120_267057,CM021100.1,1,29381120,340183827,2533515,267057,340450884,301180329
29381120_267062,CM021100.1,1,29381120,340183827,2533515,267062,340450889,301180334
29381120_289697,CM021100.1,1,29381120,340183827,2533515,289697,340473524,301202969
29381120_289767,CM021100.1,1,29381120,340183827,2533515,289767,340473594,301203039
29381120_289869,CM021100.1,1,29381120,340183827,2533515,289869,340473696,301203141
29381079_309567,CM021100.1,1,29381079,340187817,4912329,309567,340497384,301226829
29381079_309677,CM021100.1,1,29381079,340187817,4912329,309677,340497494,301226939
29381079_309678,CM021100.1,1,29381079,340187817,4912329,309678,340497495,301226940
29381079_309709,CM021100.1,1,29381079,340187817,4912329,309709,340497526,301226971
29381079_309811,CM021100.1,1,29381079,340187817,4912329,309811,340497628,301227073
29381079_309867,CM021100.1,1,29381079,340187817,4912329,309867,340497684,301227129
29381079_309881,CM021100.1,1,29381079,340187817,4912329,309881,340497698,301227143
29381079_309935,CM021100.1,1,29381079,340187817,4912329,309935,340497752,301227197
29381079_311913,CM021100.1,1,29381079,340187817,4912329,311913,340499730,301229175
29381079_311980,CM021100.1,1,29381079,340187817,4912329,311980,340499797,301229242
29381079_314390,CM021100.1,1,29381079,340187817,4912329,314390,340502207,301231652
29381079_314420,CM021100.1,1,29381079,340187817,4912329,314420,340502237,301231682
29381079_314454,CM021100.1,1,29381079,340187817,4912329,314454,340502271,301231716
29381079_314531,CM021100.1,1,29381079,340187817,4912329,314531,340502348,301231793
29380048_401025,CM021100.1,1,29380048,340183818,2079665,401025,340584843,301314288
29379760_413515,CM021100.1,1,29379760,340183825,2368044,413515,340597340,301326785
29379760_413601,CM021100.1,1,29379760,340183825,2368044,413601,340597426,301326871
29379760_413657,CM021100.1,1,29379760,340183825,2368044,413657,340597482,301326927
29378060_411655,CM021100.1,1,29378060,340187756,957621,411655,340599411,301328856
29378556_415925,CM021100.1,1,29378556,340183823,3047852,415925,340599748,301329193
29379760_427153,CM021100.1,1,29379760,340183825,2368044,427153,340610978,301340423
29379760_427260,CM021100.1,1,29379760,340183825,2368044,427260,340611085,301340530
29379760_435669,CM021100.1,1,29379760,340183825,2368044,435669,340619494,301348939
29379760_435677,CM021100.1,1,29379760,340183825,2368044,435677,340619502,301348947
29379760_435682,CM021100.1,1,29379760,340183825,2368044,435682,340619507,301348952
29379760_437674,CM021100.1,1,29379760,340183825,2368044,437674,340621499,301350944
29379760_437676,CM021100.1,1,29379760,340183825,2368044,437676,340621501,301350946
29379760_438573,CM021100.1,1,29379760,340183825,2368044,438573,340622398,301351843
29379760_438616,CM021100.1,1,29379760,340183825,2368044,438616,340622441,301351886
29379760_438629,CM021100.1,1,29379760,340183825,2368044,438629,340622454,301351899
29377698_461683,CM021100.1,1,29377698,340187565,3925138,461683,340649248,301378693
29378042_463362,CM021100.1,1,29378042,340186782,3291229,463362,340650144,301379589
29381559_474890,CM021100.1,1,29381559,340186527,2273695,474890,340661417,301390862
29381120_491750,CM021100.1,1,29381120,340183827,2533515,491750,340675577,301405022
29381120_491754,CM021100.1,1,29381120,340183827,2533515,491754,340675581,301405026
29381120_491790,CM021100.1,1,29381120,340183827,2533515,491790,340675617,301405062
29380468_525457,CM021100.1,1,29380468,340183820,3567115,525457,340709277,301438722
29380468_525601,CM021100.1,1,29380468,340183820,3567115,525601,340709421,301438866
29380468_525614,CM021100.1,1,29380468,340183820,3567115,525614,340709434,301438879
29381079_543260,CM021100.1,1,29381079,340187817,4912329,543260,340731077,301460522
29380468_562610,CM021100.1,1,29380468,340183820,3567115,562610,340746430,301475875
29380468_562614,CM021100.1,1,29380468,340183820,3567115,562614,340746434,301475879
29380468_562671,CM021100.1,1,29380468,340183820,3567115,562671,340746491,301475936
29380468_562675,CM021100.1,1,29380468,340183820,3567115,562675,340746495,301475940
29377698_655727,CM021100.1,1,29377698,340187565,3925138,655727,340843292,301572737
29380414_713111,CM021100.1,1,29380414,340183826,1787180,713111,340896937,301626382
29380414_713262,CM021100.1,1,29380414,340183826,1787180,713262,340897088,301626533
29378556_768884,CM021100.1,1,29378556,340183823,3047852,768884,340952707,301682152
29378556_768961,CM021100.1,1,29378556,340183823,3047852,768961,340952784,301682229
29379760_833481,CM021100.1,1,29379760,340183825,2368044,833481,341017306,301746751
29379760_833562,CM021100.1,1,29379760,340183825,2368044,833562,341017387,301746832
29379760_833645,CM021100.1,1,29379760,340183825,2368044,833645,341017470,301746915
29379760_889103,CM021100.1,1,29379760,340183825,2368044,889103,341072928,301802373
29379760_889155,CM021100.1,1,29379760,340183825,2368044,889155,341072980,301802425
29379760_889165,CM021100.1,1,29379760,340183825,2368044,889165,341072990,301802435
29379760_889192,CM021100.1,1,29379760,340183825,2368044,889192,341073017,301802462
29379760_889194,CM021100.1,1,29379760,340183825,2368044,889194,341073019,301802464
29379760_889195,CM021100.1,1,29379760,340183825,2368044,889195,341073020,301802465
29379760_889211,CM021100.1,1,29379760,340183825,2368044,889211,341073036,301802481
29379760_889239,CM021100.1,1,29379760,340183825,2368044,889239,341073064,301802509
29379760_889257,CM021100.1,1,29379760,340183825,2368044,889257,341073082,301802527
29379760_889278,CM021100.1,1,29379760,340183825,2368044,889278,341073103,301802548
29379760_889287,CM021100.1,1,29379760,340183825,2368044,889287,341073112,301802557
29379760_889292,CM021100.1,1,29379760,340183825,2368044,889292,341073117,301802562
29379760_889302,CM021100.1,1,29379760,340183825,2368044,889302,341073127,301802572
29379760_889332,CM021100.1,1,29379760,340183825,2368044,889332,341073157,301802602
29382140_945288,CM021100.1,1,29382140,340183825,974089,945288,341129113,301858558
29382140_945342,CM021100.1,1,29382140,340183825,974089,945342,341129167,301858612
29382140_945374,CM021100.1,1,29382140,340183825,974089,945374,341129199,301858644
29381760_954527,CM021100.1,1,29381760,340183823,971913,954527,341138350,301867795
29381760_954630,CM021100.1,1,29381760,340183823,971913,954630,341138453,301867898
29381760_954705,CM021100.1,1,29381760,340183823,971913,954705,341138528,301867973
29381559_974192,CM021100.1,1,29381559,340186527,2273695,974192,341160719,301890164
29381559_974193,CM021100.1,1,29381559,340186527,2273695,974193,341160720,301890165
29377698_1030378,CM021100.1,1,29377698,340187565,3925138,1030378,341217943,301947388
29378830_1071657,CM021100.1,1,29378830,340183825,1126957,1071657,341255482,301984927
29378830_1071710,CM021100.1,1,29378830,340183825,1126957,1071710,341255535,301984980
29377698_1120515,CM021100.1,1,29377698,340187565,3925138,1120515,341308080,302037525
29377698_1120547,CM021100.1,1,29377698,340187565,3925138,1120547,341308112,302037557
29377698_1120680,CM021100.1,1,29377698,340187565,3925138,1120680,341308245,302037690
29381120_1179414,CM021100.1,1,29381120,340183827,2533515,1179414,341363241,302092686
29381079_1264912,CM021100.1,1,29381079,340187817,4912329,1264912,341452729,302182174
29382073_1284738,CM021100.1,1,29382073,340186737,2884627,1284738,341471475,302200920
29379665_1290929,CM021100.1,1,29379665,340183825,9345703,1290929,341474754,302204199
29379665_1294454,CM021100.1,1,29379665,340183825,9345703,1294454,341478279,302207724
29379665_1294503,CM021100.1,1,29379665,340183825,9345703,1294503,341478328,302207773
29379665_1294863,CM021100.1,1,29379665,340183825,9345703,1294863,341478688,302208133
29379665_1294870,CM021100.1,1,29379665,340183825,9345703,1294870,341478695,302208140
29379665_1294924,CM021100.1,1,29379665,340183825,9345703,1294924,341478749,302208194
29379665_1294954,CM021100.1,1,29379665,340183825,9345703,1294954,341478779,302208224
29380048_1302257,CM021100.1,1,29380048,340183818,2079665,1302257,341486075,302215520
29380048_1302299,CM021100.1,1,29380048,340183818,2079665,1302299,341486117,302215562
29380048_1302339,CM021100.1,1,29380048,340183818,2079665,1302339,341486157,302215602
29381890_1396940,CM021100.1,1,29381890,340183827,3248810,1396940,341580767,302310212
29381890_1397005,CM021100.1,1,29381890,340183827,3248810,1397005,341580832,302310277
29381890_1397006,CM021100.1,1,29381890,340183827,3248810,1397006,341580833,302310278
29381120_1426675,CM021100.1,1,29381120,340183827,2533515,1426675,341610502,302339947
29381120_1426753,CM021100.1,1,29381120,340183827,2533515,1426753,341610580,302340025
29377698_1451040,CM021100.1,1,29377698,340187565,3925138,1451040,341638605,302368050
29377698_1451735,CM021100.1,1,29377698,340187565,3925138,1451735,341639300,302368745
29377698_1451765,CM021100.1,1,29377698,340187565,3925138,1451765,341639330,302368775
29381120_1485679,CM021100.1,1,29381120,340183827,2533515,1485679,341669506,302398951
29378042_1599585,CM021100.1,1,29378042,340186782,3291229,1599585,341786367,302515812
29381559_1637917,CM021100.1,1,29381559,340186527,2273695,1637917,341824444,302553889
29379665_1673357,CM021100.1,1,29379665,340183825,9345703,1673357,341857182,302586627
29382073_1689988,CM021100.1,1,29382073,340186737,2884627,1689988,341876725,302606170
29379665_1765271,CM021100.1,1,29379665,340183825,9345703,1765271,341949096,302678541
29379665_1765321,CM021100.1,1,29379665,340183825,9345703,1765321,341949146,302678591
29380468_1768995,CM021100.1,1,29380468,340183820,3567115,1768995,341952815,302682260
29380468_1769063,CM021100.1,1,29380468,340183820,3567115,1769063,341952883,302682328
29380468_1769119,CM021100.1,1,29380468,340183820,3567115,1769119,341952939,302682384
29380468_1776870,CM021100.1,1,29380468,340183820,3567115,1776870,341960690,302690135
29380468_1776940,CM021100.1,1,29380468,340183820,3567115,1776940,341960760,302690205
29380048_1799803,CM021100.1,1,29380048,340183818,2079665,1799803,341983621,302713066
29379665_1852511,CM021100.1,1,29379665,340183825,9345703,1852511,342036336,302765781
29381079_1859830,CM021100.1,1,29381079,340187817,4912329,1859830,342047647,302777092
29380468_1886765,CM021100.1,1,29380468,340183820,3567115,1886765,342070585,302800030
29380468_1886810,CM021100.1,1,29380468,340183820,3567115,1886810,342070630,302800075
29380468_1888377,CM021100.1,1,29380468,340183820,3567115,1888377,342072197,302801642
29380468_1891748,CM021100.1,1,29380468,340183820,3567115,1891748,342075568,302805013
29380468_1980126,CM021100.1,1,29380468,340183820,3567115,1980126,342163946,302893391
29380468_1980266,CM021100.1,1,29380468,340183820,3567115,1980266,342164086,302893531
29380468_1980702,CM021100.1,1,29380468,340183820,3567115,1980702,342164522,302893967
29381120_2214947,CM021100.1,1,29381120,340183827,2533515,2214947,342398774,303128219
29381120_2214995,CM021100.1,1,29381120,340183827,2533515,2214995,342398822,303128267
29378556_2232972,CM021100.1,1,29378556,340183823,3047852,2232972,342416795,303146240
29378556_2233081,CM021100.1,1,29378556,340183823,3047852,2233081,342416904,303146349
29378556_2233155,CM021100.1,1,29378556,340183823,3047852,2233155,342416978,303146423
29379665_2573884,CM021100.1,1,29379665,340183825,9345703,2573884,342757709,303487154
29381890_2613740,CM021100.1,1,29381890,340183827,3248810,2613740,342797567,303527012
29381890_2613775,CM021100.1,1,29381890,340183827,3248810,2613775,342797602,303527047
29381890_2613898,CM021100.1,1,29381890,340183827,3248810,2613898,342797725,303527170
29381890_2613907,CM021100.1,1,29381890,340183827,3248810,2613907,342797734,303527179
29381890_2613925,CM021100.1,1,29381890,340183827,3248810,2613925,342797752,303527197
29381890_2613945,CM021100.1,1,29381890,340183827,3248810,2613945,342797772,303527217
29381079_2719691,CM021100.1,1,29381079,340187817,4912329,2719691,342907508,303636953
29381079_2733073,CM021100.1,1,29381079,340187817,4912329,2733073,342920890,303650335
29377698_2982713,CM021100.1,1,29377698,340187565,3925138,2982713,343170278,303899723
29377698_2982807,CM021100.1,1,29377698,340187565,3925138,2982807,343170372,303899817
29377698_2982881,CM021100.1,1,29377698,340187565,3925138,2982881,343170446,303899891
29377698_2982882,CM021100.1,1,29377698,340187565,3925138,2982882,343170447,303899892
29377698_2982904,CM021100.1,1,29377698,340187565,3925138,2982904,343170469,303899914
29379665_2997611,CM021100.1,1,29379665,340183825,9345703,2997611,343181436,303910881
29381079_3086553,CM021100.1,1,29381079,340187817,4912329,3086553,343274370,304003815
29379665_3176867,CM021100.1,1,29379665,340183825,9345703,3176867,343360692,304090137
29381079_3275062,CM021100.1,1,29381079,340187817,4912329,3275062,343462879,304192324
29381079_3275134,CM021100.1,1,29381079,340187817,4912329,3275134,343462951,304192396
29380468_3330043,CM021100.1,1,29380468,340183820,3567115,3330043,343513863,304243308
29380468_3330058,CM021100.1,1,29380468,340183820,3567115,3330058,343513878,304243323
29380468_3330063,CM021100.1,1,29380468,340183820,3567115,3330063,343513883,304243328
29380468_3330119,CM021100.1,1,29380468,340183820,3567115,3330119,343513939,304243384
29380468_3410072,CM021100.1,1,29380468,340183820,3567115,3410072,343593892,304323337
29381079_3427426,CM021100.1,1,29381079,340187817,4912329,3427426,343615243,304344688
29379665_4020252,CM021100.1,1,29379665,340183825,9345703,4020252,344204077,304933522
29379665_4024370,CM021100.1,1,29379665,340183825,9345703,4024370,344208195,304937640
29379665_4063738,CM021100.1,1,29379665,340183825,9345703,4063738,344247563,304977008
29381079_4073224,CM021100.1,1,29381079,340187817,4912329,4073224,344261041,304990486
29381079_4073334,CM021100.1,1,29381079,340187817,4912329,4073334,344261151,304990596
29381079_4073652,CM021100.1,1,29381079,340187817,4912329,4073652,344261469,304990914
29379665_4113964,CM021100.1,1,29379665,340183825,9345703,4113964,344297789,305027234
29379665_4114380,CM021100.1,1,29379665,340183825,9345703,4114380,344298205,305027650
29379665_4114404,CM021100.1,1,29379665,340183825,9345703,4114404,344298229,305027674
29379665_4164240,CM021100.1,1,29379665,340183825,9345703,4164240,344348065,305077510
29379665_4164271,CM021100.1,1,29379665,340183825,9345703,4164271,344348096,305077541
29379665_4164348,CM021100.1,1,29379665,340183825,9345703,4164348,344348173,305077618
29379665_4636586,CM021100.1,1,29379665,340183825,9345703,4636586,344820411,305549856
29379665_4636624,CM021100.1,1,29379665,340183825,9345703,4636624,344820449,305549894
29379665_4637951,CM021100.1,1,29379665,340183825,9345703,4637951,344821776,305551221
29379665_4639676,CM021100.1,1,29379665,340183825,9345703,4639676,344823501,305552946
29379665_4639744,CM021100.1,1,29379665,340183825,9345703,4639744,344823569,305553014
29379665_4639933,CM021100.1,1,29379665,340183825,9345703,4639933,344823758,305553203
29381079_4770799,CM021100.1,1,29381079,340187817,4912329,4770799,344958616,305688061
29381079_4770805,CM021100.1,1,29381079,340187817,4912329,4770805,344958622,305688067
29381079_4770863,CM021100.1,1,29381079,340187817,4912329,4770863,344958680,305688125
29379665_4931724,CM021100.1,1,29379665,340183825,9345703,4931724,345115549,305844994
29379665_4931843,CM021100.1,1,29379665,340183825,9345703,4931843,345115668,305845113
29379665_4931969,CM021100.1,1,29379665,340183825,9345703,4931969,345115794,305845239
29379665_5543908,CM021100.1,1,29379665,340183825,9345703,5543908,345727733,306457178
29379665_6306240,CM021100.1,1,29379665,340183825,9345703,6306240,346490065,307219510
29379665_6328246,CM021100.1,1,29379665,340183825,9345703,6328246,346512071,307241516
29379665_6507074,CM021100.1,1,29379665,340183825,9345703,6507074,346690899,307420344
29379665_6748459,CM021100.1,1,29379665,340183825,9345703,6748459,346932284,307661729
29379665_6885268,CM021100.1,1,29379665,340183825,9345703,6885268,347069093,307798538
29379665_8867042,CM021100.1,1,29379665,340183825,9345703,8867042,349050867,309780312
29377331_20561,CM021100.1,1,29377331,356149198,229043,20561,356169759,316899204
29366518_51161,CM021100.1,1,29366518,356149469,111619,51161,356200630,316930075
29366518_51163,CM021100.1,1,29366518,356149469,111619,51163,356200632,316930077
29366518_51189,CM021100.1,1,29366518,356149469,111619,51189,356200658,316930103
29366518_51198,CM021100.1,1,29366518,356149469,111619,51198,356200667,316930112
29379296_56266,CM021100.1,1,29379296,356149197,673210,56266,356205463,316934908
29379296_56459,CM021100.1,1,29379296,356149197,673210,56459,356205656,316935101
29379296_56474,CM021100.1,1,29379296,356149197,673210,56474,356205671,316935116
29379296_56505,CM021100.1,1,29379296,356149197,673210,56505,356205702,316935147
29380116_137875,CM021100.1,1,29380116,356149624,2979582,137875,356287499,317016944
29380116_137905,CM021100.1,1,29380116,356149624,2979582,137905,356287529,317016974
29377430_155253,CM021100.1,1,29377430,356149202,1461542,155253,356304455,317033900
29377430_155453,CM021100.1,1,29377430,356149202,1461542,155453,356304655,317034100
29377430_155458,CM021100.1,1,29377430,356149202,1461542,155458,356304660,317034105
29377286_178422,CM021100.1,1,29377286,356149202,696153,178422,356327624,317057069
29377286_178465,CM021100.1,1,29377286,356149202,696153,178465,356327667,317057112
29377286_178471,CM021100.1,1,29377286,356149202,696153,178471,356327673,317057118
29377286_197496,CM021100.1,1,29377286,356149202,696153,197496,356346698,317076143
29377286_197832,CM021100.1,1,29377286,356149202,696153,197832,356347034,317076479
29342805_224857,CM021100.1,1,29342805,356149215,368000,224857,356374072,317103517
29342805_224877,CM021100.1,1,29342805,356149215,368000,224877,356374092,317103537
29342805_224880,CM021100.1,1,29342805,356149215,368000,224880,356374095,317103540
29378330_242718,CM021100.1,1,29378330,356149409,947237,242718,356392127,317121572
29378330_242719,CM021100.1,1,29378330,356149409,947237,242719,356392128,317121573
29378330_242726,CM021100.1,1,29378330,356149409,947237,242726,356392135,317121580
29378330_242778,CM021100.1,1,29378330,356149409,947237,242778,356392187,317121632
29378330_242897,CM021100.1,1,29378330,356149409,947237,242897,356392306,317121751
29378330_242915,CM021100.1,1,29378330,356149409,947237,242915,356392324,317121769
29378330_242926,CM021100.1,1,29378330,356149409,947237,242926,356392335,317121780
29378330_243868,CM021100.1,1,29378330,356149409,947237,243868,356393277,317122722
29378330_243883,CM021100.1,1,29378330,356149409,947237,243883,356393292,317122737
29378330_244080,CM021100.1,1,29378330,356149409,947237,244080,356393489,317122934
29379296_299647,CM021100.1,1,29379296,356149197,673210,299647,356448844,317178289
29379296_299666,CM021100.1,1,29379296,356149197,673210,299666,356448863,317178308
29379296_299693,CM021100.1,1,29379296,356149197,673210,299693,356448890,317178335
29379296_300386,CM021100.1,1,29379296,356149197,673210,300386,356449583,317179028
29380116_569157,CM021100.1,1,29380116,356149624,2979582,569157,356718781,317448226
29380116_569176,CM021100.1,1,29380116,356149624,2979582,569176,356718800,317448245
29380116_569296,CM021100.1,1,29380116,356149624,2979582,569296,356718920,317448365
29380116_579325,CM021100.1,1,29380116,356149624,2979582,579325,356728949,317458394
29379296_626330,CM021100.1,1,29379296,356149197,673210,626330,356775527,317504972
29379296_626361,CM021100.1,1,29379296,356149197,673210,626361,356775558,317505003
29379296_626365,CM021100.1,1,29379296,356149197,673210,626365,356775562,317505007
29379296_626408,CM021100.1,1,29379296,356149197,673210,626408,356775605,317505050
29379296_626465,CM021100.1,1,29379296,356149197,673210,626465,356775662,317505107
29379296_626469,CM021100.1,1,29379296,356149197,673210,626469,356775666,317505111
29381722_1115990,CM021100.1,1,29381722,356149202,2955368,1115990,357265192,317994637
29381722_1559075,CM021100.1,1,29381722,356149202,2955368,1559075,357708277,318437722
29381722_1634658,CM021100.1,1,29381722,356149202,2955368,1634658,357783860,318513305
29381722_1634821,CM021100.1,1,29381722,356149202,2955368,1634821,357784023,318513468
29381722_1634874,CM021100.1,1,29381722,356149202,2955368,1634874,357784076,318513521
29381722_1665275,CM021100.1,1,29381722,356149202,2955368,1665275,357814477,318543922
29381722_1665499,CM021100.1,1,29381722,356149202,2955368,1665499,357814701,318544146
29381722_1665581,CM021100.1,1,29381722,356149202,2955368,1665581,357814783,318544228
29381722_1665601,CM021100.1,1,29381722,356149202,2955368,1665601,357814803,318544248
29381722_1690545,CM021100.1,1,29381722,356149202,2955368,1690545,357839747,318569192
29381722_1756452,CM021100.1,1,29381722,356149202,2955368,1756452,357905654,318635099
29381722_1756493,CM021100.1,1,29381722,356149202,2955368,1756493,357905695,318635140
29381722_1756570,CM021100.1,1,29381722,356149202,2955368,1756570,357905772,318635217
29381722_1919782,CM021100.1,1,29381722,356149202,2955368,1919782,358068984,318798429
29381722_1919783,CM021100.1,1,29381722,356149202,2955368,1919783,358068985,318798430
29381722_2033870,CM021100.1,1,29381722,356149202,2955368,2033870,358183072,318912517
29381722_2033998,CM021100.1,1,29381722,356149202,2955368,2033998,358183200,318912645
29381722_2284711,CM021100.1,1,29381722,356149202,2955368,2284711,358433913,319163358
29381722_2368184,CM021100.1,1,29381722,356149202,2955368,2368184,358517386,319246831
29381722_2439376,CM021100.1,1,29381722,356149202,2955368,2439376,358588578,319318023
29381722_2439442,CM021100.1,1,29381722,356149202,2955368,2439442,358588644,319318089
29381722_2439515,CM021100.1,1,29381722,356149202,2955368,2439515,358588717,319318162
29381722_2669933,CM021100.1,1,29381722,356149202,2955368,2669933,358819135,319548580
29381722_2670029,CM021100.1,1,29381722,356149202,2955368,2670029,358819231,319548676
29381722_2751354,CM021100.1,1,29381722,356149202,2955368,2751354,358900556,319630001
29381722_2751417,CM021100.1,1,29381722,356149202,2955368,2751417,358900619,319630064
29381722_2809898,CM021100.1,1,29381722,356149202,2955368,2809898,358959100,319688545
29381722_2809911,CM021100.1,1,29381722,356149202,2955368,2809911,358959113,319688558
29381722_2929226,CM021100.1,1,29381722,356149202,2955368,2929226,359078428,319807873
29381722_2929318,CM021100.1,1,29381722,356149202,2955368,2929318,359078520,319807965
29381722_2929330,CM021100.1,1,29381722,356149202,2955368,2929330,359078532,319807977
29382384_260679,CM021100.1,1,29382384,361010323,812781,260679,361271002,322000447
29382384_260693,CM021100.1,1,29382384,361010323,812781,260693,361271016,322000461
29382384_260760,CM021100.1,1,29382384,361010323,812781,260760,361271083,322000528
29382384_609149,CM021100.1,1,29382384,361010323,812781,609149,361619472,322348917
29381447_356858,CM021100.1,1,29381447,362095652,984302,356858,362452510,323181955
29381447_899744,CM021100.1,1,29381447,362095652,984302,899744,362995396,323724841
29382344_2440,CM021100.1,1,29382344,391369844,1339885,2440,391372284,352101729
29382344_2509,CM021100.1,1,29382344,391369844,1339885,2509,391372353,352101798
29382344_2524,CM021100.1,1,29382344,391369844,1339885,2524,391372368,352101813
29378984_11371,CM021100.1,1,29378984,391372097,527109,11371,391383468,352112913
29378984_11375,CM021100.1,1,29378984,391372097,527109,11375,391383472,352112917
29380441_45324,CM021100.1,1,29380441,391368641,1021982,45324,391413965,352143410
29381283_74581,CM021100.1,1,29381283,391368638,282953,74581,391443219,352172664
29379740_109509,CM021100.1,1,29379740,391369828,2576580,109509,391479337,352208782
29379740_109553,CM021100.1,1,29379740,391369828,2576580,109553,391479381,352208826
29381360_157174,CM021100.1,1,29381360,391368638,557398,157174,391525812,352255257
29381360_157296,CM021100.1,1,29381360,391368638,557398,157296,391525934,352255379
29379596_192495,CM021100.1,1,29379596,391369291,315330,192495,391561786,352291231
29379596_192515,CM021100.1,1,29379596,391369291,315330,192515,391561806,352291251
29379740_382885,CM021100.1,1,29379740,391369828,2576580,382885,391752713,352482158
29378984_397485,CM021100.1,1,29378984,391372097,527109,397485,391769582,352499027
29378984_397506,CM021100.1,1,29378984,391372097,527109,397506,391769603,352499048
29378984_397638,CM021100.1,1,29378984,391372097,527109,397638,391769735,352499180
29379495_453456,CM021100.1,1,29379495,391368638,4102953,453456,391822094,352551539
29379016_584353,CM021100.1,1,29379016,391369333,1117227,584353,391953686,352683131
29379016_584366,CM021100.1,1,29379016,391369333,1117227,584366,391953699,352683144
29379016_584368,CM021100.1,1,29379016,391369333,1117227,584368,391953701,352683146
29378528_589453,CM021100.1,1,29378528,391368641,931559,589453,391958094,352687539
29377975_685660,CM021100.1,1,29377975,391368638,1102910,685660,392054298,352783743
29378410_700257,CM021100.1,1,29378410,391368641,3771656,700257,392068898,352798343
29382344_706403,CM021100.1,1,29382344,391369844,1339885,706403,392076247,352805692
29380441_739056,CM021100.1,1,29380441,391368641,1021982,739056,392107697,352837142
29377975_779978,CM021100.1,1,29377975,391368638,1102910,779978,392148616,352878061
29377975_780007,CM021100.1,1,29377975,391368638,1102910,780007,392148645,352878090
29377975_780020,CM021100.1,1,29377975,391368638,1102910,780020,392148658,352878103
29379495_796842,CM021100.1,1,29379495,391368638,4102953,796842,392165480,352894925
29379495_796989,CM021100.1,1,29379495,391368638,4102953,796989,392165627,352895072
29379495_797065,CM021100.1,1,29379495,391368638,4102953,797065,392165703,352895148
29382344_798559,CM021100.1,1,29382344,391369844,1339885,798559,392168403,352897848
29382344_802665,CM021100.1,1,29382344,391369844,1339885,802665,392172509,352901954
29382344_803562,CM021100.1,1,29382344,391369844,1339885,803562,392173406,352902851
29380441_819614,CM021100.1,1,29380441,391368641,1021982,819614,392188255,352917700
29380441_819644,CM021100.1,1,29380441,391368641,1021982,819644,392188285,352917730
29380441_819645,CM021100.1,1,29380441,391368641,1021982,819645,392188286,352917731
29380441_819686,CM021100.1,1,29380441,391368641,1021982,819686,392188327,352917772
29380441_820544,CM021100.1,1,29380441,391368641,1021982,820544,392189185,352918630
29380441_821116,CM021100.1,1,29380441,391368641,1021982,821116,392189757,352919202
29380441_821138,CM021100.1,1,29380441,391368641,1021982,821138,392189779,352919224
29380441_821139,CM021100.1,1,29380441,391368641,1021982,821139,392189780,352919225
29380441_821195,CM021100.1,1,29380441,391368641,1021982,821195,392189836,352919281
29377975_867688,CM021100.1,1,29377975,391368638,1102910,867688,392236326,352965771
29378946_867691,CM021100.1,1,29378946,391368641,3380405,867691,392236332,352965777
29379752_870336,CM021100.1,1,29379752,391368637,2150970,870336,392238973,352968418
29379495_936382,CM021100.1,1,29379495,391368638,4102953,936382,392305020,353034465
29378946_1035543,CM021100.1,1,29378946,391368641,3380405,1035543,392404184,353133629
29378946_1035593,CM021100.1,1,29378946,391368641,3380405,1035593,392404234,353133679
29378946_1035597,CM021100.1,1,29378946,391368641,3380405,1035597,392404238,353133683
29378946_1035650,CM021100.1,1,29378946,391368641,3380405,1035650,392404291,353133736
29377975_1061379,CM021100.1,1,29377975,391368638,1102910,1061379,392430017,353159462
29377975_1061443,CM021100.1,1,29377975,391368638,1102910,1061443,392430081,353159526
29377975_1061531,CM021100.1,1,29377975,391368638,1102910,1061531,392430169,353159614
29377975_1081452,CM021100.1,1,29377975,391368638,1102910,1081452,392450090,353179535
29377975_1081467,CM021100.1,1,29377975,391368638,1102910,1081467,392450105,353179550
29382344_1108686,CM021100.1,1,29382344,391369844,1339885,1108686,392478530,353207975
29382344_1108891,CM021100.1,1,29382344,391369844,1339885,1108891,392478735,353208180
29379495_1116909,CM021100.1,1,29379495,391368638,4102953,1116909,392485547,353214992
29379920_1120317,CM021100.1,1,29379920,391369326,2522892,1120317,392489643,353219088
29379920_1120818,CM021100.1,1,29379920,391369326,2522892,1120818,392490144,353219589
29379920_1120820,CM021100.1,1,29379920,391369326,2522892,1120820,392490146,353219591
29382344_1123462,CM021100.1,1,29382344,391369844,1339885,1123462,392493306,353222751
29382344_1123557,CM021100.1,1,29382344,391369844,1339885,1123557,392493401,353222846
29382344_1211236,CM021100.1,1,29382344,391369844,1339885,1211236,392581080,353310525
29382344_1211283,CM021100.1,1,29382344,391369844,1339885,1211283,392581127,353310572
29382191_1224843,CM021100.1,1,29382191,391368639,4071273,1224843,392593482,353322927
29378946_1232743,CM021100.1,1,29378946,391368641,3380405,1232743,392601384,353330829
29378946_1232772,CM021100.1,1,29378946,391368641,3380405,1232772,392601413,353330858
29379752_1361034,CM021100.1,1,29379752,391368637,2150970,1361034,392729671,353459116
29379752_1361232,CM021100.1,1,29379752,391368637,2150970,1361232,392729869,353459314
29382191_1393916,CM021100.1,1,29382191,391368639,4071273,1393916,392762555,353492000
29382191_1394020,CM021100.1,1,29382191,391368639,4071273,1394020,392762659,353492104
29378358_1441462,CM021100.1,1,29378358,391368639,5057157,1441462,392810101,353539546
29379752_1576063,CM021100.1,1,29379752,391368637,2150970,1576063,392944700,353674145
29379752_1576078,CM021100.1,1,29379752,391368637,2150970,1576078,392944715,353674160
29379752_1576171,CM021100.1,1,29379752,391368637,2150970,1576171,392944808,353674253
29379495_1765459,CM021100.1,1,29379495,391368638,4102953,1765459,393134097,353863542
29378358_1790543,CM021100.1,1,29378358,391368639,5057157,1790543,393159182,353888627
29378358_1790566,CM021100.1,1,29378358,391368639,5057157,1790566,393159205,353888650
29378358_1790577,CM021100.1,1,29378358,391368639,5057157,1790577,393159216,353888661
29378358_1790579,CM021100.1,1,29378358,391368639,5057157,1790579,393159218,353888663
29378358_1790664,CM021100.1,1,29378358,391368639,5057157,1790664,393159303,353888748
29378358_1790697,CM021100.1,1,29378358,391368639,5057157,1790697,393159336,353888781
29378358_1790707,CM021100.1,1,29378358,391368639,5057157,1790707,393159346,353888791
29378358_1790719,CM021100.1,1,29378358,391368639,5057157,1790719,393159358,353888803
29378358_1790724,CM021100.1,1,29378358,391368639,5057157,1790724,393159363,353888808
29378358_1790732,CM021100.1,1,29378358,391368639,5057157,1790732,393159371,353888816
29379752_1878037,CM021100.1,1,29379752,391368637,2150970,1878037,393246674,353976119
29381885_2006828,CM021100.1,1,29381885,391368637,7406020,2006828,393375465,354104910
29381885_2017254,CM021100.1,1,29381885,391368637,7406020,2017254,393385891,354115336
29378946_2077001,CM021100.1,1,29378946,391368641,3380405,2077001,393445642,354175087
29378946_2077015,CM021100.1,1,29378946,391368641,3380405,2077015,393445656,354175101
29378946_2077038,CM021100.1,1,29378946,391368641,3380405,2077038,393445679,354175124
29382191_2088325,CM021100.1,1,29382191,391368639,4071273,2088325,393456964,354186409
29382191_2088328,CM021100.1,1,29382191,391368639,4071273,2088328,393456967,354186412
29382191_2210622,CM021100.1,1,29382191,391368639,4071273,2210622,393579261,354308706
29378946_2268825,CM021100.1,1,29378946,391368641,3380405,2268825,393637466,354366911
29378946_2269189,CM021100.1,1,29378946,391368641,3380405,2269189,393637830,354367275
29378946_2269259,CM021100.1,1,29378946,391368641,3380405,2269259,393637900,354367345
29378946_2269298,CM021100.1,1,29378946,391368641,3380405,2269298,393637939,354367384
29378946_2269321,CM021100.1,1,29378946,391368641,3380405,2269321,393637962,354367407
29378946_2269331,CM021100.1,1,29378946,391368641,3380405,2269331,393637972,354367417
29378946_2269354,CM021100.1,1,29378946,391368641,3380405,2269354,393637995,354367440
29378946_2391688,CM021100.1,1,29378946,391368641,3380405,2391688,393760329,354489774
29378946_2391760,CM021100.1,1,29378946,391368641,3380405,2391760,393760401,354489846
29381885_2494190,CM021100.1,1,29381885,391368637,7406020,2494190,393862827,354592272
29379495_2554106,CM021100.1,1,29379495,391368638,4102953,2554106,393922744,354652189
29379495_2554120,CM021100.1,1,29379495,391368638,4102953,2554120,393922758,354652203
29378946_2559660,CM021100.1,1,29378946,391368641,3380405,2559660,393928301,354657746
29378946_2559733,CM021100.1,1,29378946,391368641,3380405,2559733,393928374,354657819
29378946_2565017,CM021100.1,1,29378946,391368641,3380405,2565017,393933658,354663103
29378946_2565023,CM021100.1,1,29378946,391368641,3380405,2565023,393933664,354663109
29378410_2875234,CM021100.1,1,29378410,391368641,3771656,2875234,394243875,354973320
29378410_2875288,CM021100.1,1,29378410,391368641,3771656,2875288,394243929,354973374
29378410_2875298,CM021100.1,1,29378410,391368641,3771656,2875298,394243939,354973384
29378410_2875356,CM021100.1,1,29378410,391368641,3771656,2875356,394243997,354973442
29378410_2875364,CM021100.1,1,29378410,391368641,3771656,2875364,394244005,354973450
29378410_2875370,CM021100.1,1,29378410,391368641,3771656,2875370,394244011,354973456
29378410_2875409,CM021100.1,1,29378410,391368641,3771656,2875409,394244050,354973495
29378410_2875537,CM021100.1,1,29378410,391368641,3771656,2875537,394244178,354973623
29382191_2946427,CM021100.1,1,29382191,391368639,4071273,2946427,394315066,355044511
29382191_2946469,CM021100.1,1,29382191,391368639,4071273,2946469,394315108,355044553
29379495_3011803,CM021100.1,1,29379495,391368638,4102953,3011803,394380441,355109886
29379495_3011863,CM021100.1,1,29379495,391368638,4102953,3011863,394380501,355109946
29379495_3011864,CM021100.1,1,29379495,391368638,4102953,3011864,394380502,355109947
29379495_3011917,CM021100.1,1,29379495,391368638,4102953,3011917,394380555,355110000
29378410_3042930,CM021100.1,1,29378410,391368641,3771656,3042930,394411571,355141016
29378410_3042957,CM021100.1,1,29378410,391368641,3771656,3042957,394411598,355141043
29378410_3042959,CM021100.1,1,29378410,391368641,3771656,3042959,394411600,355141045
29378410_3042962,CM021100.1,1,29378410,391368641,3771656,3042962,394411603,355141048
29378410_3043896,CM021100.1,1,29378410,391368641,3771656,3043896,394412537,355141982
29378410_3043899,CM021100.1,1,29378410,391368641,3771656,3043899,394412540,355141985
29378410_3043913,CM021100.1,1,29378410,391368641,3771656,3043913,394412554,355141999
29378410_3043929,CM021100.1,1,29378410,391368641,3771656,3043929,394412570,355142015
29378410_3043937,CM021100.1,1,29378410,391368641,3771656,3043937,394412578,355142023
29378410_3043967,CM021100.1,1,29378410,391368641,3771656,3043967,394412608,355142053
29378410_3044001,CM021100.1,1,29378410,391368641,3771656,3044001,394412642,355142087
29378410_3044032,CM021100.1,1,29378410,391368641,3771656,3044032,394412673,355142118
29378410_3044055,CM021100.1,1,29378410,391368641,3771656,3044055,394412696,355142141
29382191_3197785,CM021100.1,1,29382191,391368639,4071273,3197785,394566424,355295869
29382191_3197798,CM021100.1,1,29382191,391368639,4071273,3197798,394566437,355295882
29379495_3444851,CM021100.1,1,29379495,391368638,4102953,3444851,394813489,355542934
29381885_3720443,CM021100.1,1,29381885,391368637,7406020,3720443,395089080,355818525
29378410_3722836,CM021100.1,1,29378410,391368641,3771656,3722836,395091477,355820922
29378410_3722878,CM021100.1,1,29378410,391368641,3771656,3722878,395091519,355820964
29381885_3725504,CM021100.1,1,29381885,391368637,7406020,3725504,395094141,355823586
29381885_3725525,CM021100.1,1,29381885,391368637,7406020,3725525,395094162,355823607
29381885_3725528,CM021100.1,1,29381885,391368637,7406020,3725528,395094165,355823610
29381885_3725544,CM021100.1,1,29381885,391368637,7406020,3725544,395094181,355823626
29381885_3725591,CM021100.1,1,29381885,391368637,7406020,3725591,395094228,355823673
29381885_3725606,CM021100.1,1,29381885,391368637,7406020,3725606,395094243,355823688
29381885_3725620,CM021100.1,1,29381885,391368637,7406020,3725620,395094257,355823702
29381885_3725626,CM021100.1,1,29381885,391368637,7406020,3725626,395094263,355823708
29380381_3913458,CM021100.1,1,29380381,391368639,6339997,3913458,395282097,356011542
29381885_4250273,CM021100.1,1,29381885,391368637,7406020,4250273,395618910,356348355
29381885_4344582,CM021100.1,1,29381885,391368637,7406020,4344582,395713219,356442664
29381885_4383895,CM021100.1,1,29381885,391368637,7406020,4383895,395752532,356481977
29381885_4383928,CM021100.1,1,29381885,391368637,7406020,4383928,395752565,356482010
29380381_4865403,CM021100.1,1,29380381,391368639,6339997,4865403,396234042,356963487
29380381_4865405,CM021100.1,1,29380381,391368639,6339997,4865405,396234044,356963489
29381885_6496130,CM021100.1,1,29381885,391368637,7406020,6496130,397864767,358594212
29381885_6496211,CM021100.1,1,29381885,391368637,7406020,6496211,397864848,358594293
29381885_6496230,CM021100.1,1,29381885,391368637,7406020,6496230,397864867,358594312
29381885_6989844,CM021100.1,1,29381885,391368637,7406020,6989844,398358481,359087926
29381885_6989856,CM021100.1,1,29381885,391368637,7406020,6989856,398358493,359087938
29380582_438406,CM021100.1,1,29380582,399775660,719072,438406,400214066,360943511
29378117_749615,CM021100.1,1,29378117,399777088,1063808,749615,400526703,361256148
29378117_749619,CM021100.1,1,29378117,399777088,1063808,749619,400526707,361256152
29378117_749701,CM021100.1,1,29378117,399777088,1063808,749701,400526789,361256234
29378117_749739,CM021100.1,1,29378117,399777088,1063808,749739,400526827,361256272
29378117_964928,CM021100.1,1,29378117,399777088,1063808,964928,400742016,361471461
29378117_964974,CM021100.1,1,29378117,399777088,1063808,964974,400742062,361471507
29381911_152711,CM021100.1,1,29381911,428586055,5914395,152711,428738766,389468211
29381911_152765,CM021100.1,1,29381911,428586055,5914395,152765,428738820,389468265
29381911_152772,CM021100.1,1,29381911,428586055,5914395,152772,428738827,389468272
29381806_178652,CM021100.1,1,29381806,428586354,2082210,178652,428765006,389494451
29380778_246999,CM021100.1,1,29380778,428581821,553632,246999,428828820,389558265
29380778_247006,CM021100.1,1,29380778,428581821,553632,247006,428828827,389558272
29380778_247017,CM021100.1,1,29380778,428581821,553632,247017,428828838,389558283
29378975_397493,CM021100.1,1,29378975,428585529,3557884,397493,428983022,389712467
29378975_397494,CM021100.1,1,29378975,428585529,3557884,397494,428983023,389712468
29380710_421141,CM021100.1,1,29380710,428581826,5147649,421141,429002967,389732412
29380710_421720,CM021100.1,1,29380710,428581826,5147649,421720,429003546,389732991
29380320_528808,CM021100.1,1,29380320,428587075,1014856,528808,429115883,389845328
29378975_766560,CM021100.1,1,29378975,428585529,3557884,766560,429352089,390081534
29380320_817438,CM021100.1,1,29380320,428587075,1014856,817438,429404513,390133958
29380320_978837,CM021100.1,1,29380320,428587075,1014856,978837,429565912,390295357
29380320_1009643,CM021100.1,1,29380320,428587075,1014856,1009643,429596718,390326163
29380710_1061162,CM021100.1,1,29380710,428581826,5147649,1061162,429642988,390372433
29380710_1061213,CM021100.1,1,29380710,428581826,5147649,1061213,429643039,390372484
29381911_1080744,CM021100.1,1,29381911,428586055,5914395,1080744,429666799,390396244
29381911_1081138,CM021100.1,1,29381911,428586055,5914395,1081138,429667193,390396638
29381911_1081331,CM021100.1,1,29381911,428586055,5914395,1081331,429667386,390396831
29380710_1172849,CM021100.1,1,29380710,428581826,5147649,1172849,429754675,390484120
29380710_1182437,CM021100.1,1,29380710,428581826,5147649,1182437,429764263,390493708
29381324_1253459,CM021100.1,1,29381324,428581824,3967464,1253459,429835283,390564728
29380710_1409652,CM021100.1,1,29380710,428581826,5147649,1409652,429991478,390720923
29380710_1409707,CM021100.1,1,29380710,428581826,5147649,1409707,429991533,390720978
29380710_1567765,CM021100.1,1,29380710,428581826,5147649,1567765,430149591,390879036
29380710_1575397,CM021100.1,1,29380710,428581826,5147649,1575397,430157223,390886668
29380710_1575504,CM021100.1,1,29380710,428581826,5147649,1575504,430157330,390886775
29380710_1813097,CM021100.1,1,29380710,428581826,5147649,1813097,430394923,391124368
29380710_1902489,CM021100.1,1,29380710,428581826,5147649,1902489,430484315,391213760
29380710_1995551,CM021100.1,1,29380710,428581826,5147649,1995551,430577377,391306822
29380710_1995603,CM021100.1,1,29380710,428581826,5147649,1995603,430577429,391306874
29380710_1995625,CM021100.1,1,29380710,428581826,5147649,1995625,430577451,391306896
29381911_2139576,CM021100.1,1,29381911,428586055,5914395,2139576,430725631,391455076
29381911_2139577,CM021100.1,1,29381911,428586055,5914395,2139577,430725632,391455077
29381911_3578943,CM021100.1,1,29381911,428586055,5914395,3578943,432164998,392894443
29381911_3578998,CM021100.1,1,29381911,428586055,5914395,3578998,432165053,392894498
29381911_3579011,CM021100.1,1,29381911,428586055,5914395,3579011,432165066,392894511
29381911_3579012,CM021100.1,1,29381911,428586055,5914395,3579012,432165067,392894512
29381911_3579064,CM021100.1,1,29381911,428586055,5914395,3579064,432165119,392894564
29380710_3823490,CM021100.1,1,29380710,428581826,5147649,3823490,432405316,393134761
29380710_3823504,CM021100.1,1,29380710,428581826,5147649,3823504,432405330,393134775
29380710_3823540,CM021100.1,1,29380710,428581826,5147649,3823540,432405366,393134811
29380710_3823589,CM021100.1,1,29380710,428581826,5147649,3823589,432405415,393134860
29380710_3823592,CM021100.1,1,29380710,428581826,5147649,3823592,432405418,393134863
29381911_4259713,CM021100.1,1,29381911,428586055,5914395,4259713,432845768,393575213
29381911_4259715,CM021100.1,1,29381911,428586055,5914395,4259715,432845770,393575215
29381911_4259752,CM021100.1,1,29381911,428586055,5914395,4259752,432845807,393575252
29380710_4562721,CM021100.1,1,29380710,428581826,5147649,4562721,433144547,393873992
29380710_4698828,CM021100.1,1,29380710,428581826,5147649,4698828,433280654,394010099
29377049_4590,CM021100.1,1,29377049,457303262,4260312,4590,457307852,418037297
29379744_50816,CM021100.1,1,29379744,457303266,2603354,50816,457354082,418083527
29379754_144195,CM021100.1,1,29379754,457312235,1527467,144195,457456430,418185875
29381766_173214,CM021100.1,1,29381766,457303264,3146523,173214,457476478,418205923
29381766_173241,CM021100.1,1,29381766,457303264,3146523,173241,457476505,418205950
29381766_173257,CM021100.1,1,29381766,457303264,3146523,173257,457476521,418205966
29379754_172662,CM021100.1,1,29379754,457312235,1527467,172662,457484897,418214342
29379754_172663,CM021100.1,1,29379754,457312235,1527467,172663,457484898,418214343
29379754_172750,CM021100.1,1,29379754,457312235,1527467,172750,457484985,418214430
29377049_195725,CM021100.1,1,29377049,457303262,4260312,195725,457498987,418228432
29377049_195782,CM021100.1,1,29377049,457303262,4260312,195782,457499044,418228489
29377049_195875,CM021100.1,1,29377049,457303262,4260312,195875,457499137,418228582
29378698_235080,CM021100.1,1,29378698,457303260,668372,235080,457538340,418267785
29381766_271157,CM021100.1,1,29381766,457303264,3146523,271157,457574421,418303866
29377049_275870,CM021100.1,1,29377049,457303262,4260312,275870,457579132,418308577
29381072_318372,CM021100.1,1,29381072,457303262,1203928,318372,457621634,418351079
29381072_318398,CM021100.1,1,29381072,457303262,1203928,318398,457621660,418351105
29377549_357354,CM021100.1,1,29377549,457304817,1980877,357354,457662171,418391616
29377549_357366,CM021100.1,1,29377549,457304817,1980877,357366,457662183,418391628
29377049_423210,CM021100.1,1,29377049,457303262,4260312,423210,457726472,418455917
29377049_425353,CM021100.1,1,29377049,457303262,4260312,425353,457728615,418458060
29379754_573915,CM021100.1,1,29379754,457312235,1527467,573915,457886150,418615595
29379754_620148,CM021100.1,1,29379754,457312235,1527467,620148,457932383,418661828
29379754_620216,CM021100.1,1,29379754,457312235,1527467,620216,457932451,418661896
29379754_620300,CM021100.1,1,29379754,457312235,1527467,620300,457932535,418661980
29379754_620383,CM021100.1,1,29379754,457312235,1527467,620383,457932618,418662063
29378433_657990,CM021100.1,1,29378433,457303262,1482524,657990,457961252,418690697
29381072_695911,CM021100.1,1,29381072,457303262,1203928,695911,457999173,418728618
29379754_717850,CM021100.1,1,29379754,457312235,1527467,717850,458030085,418759530
29379754_717999,CM021100.1,1,29379754,457312235,1527467,717999,458030234,418759679
29379754_718004,CM021100.1,1,29379754,457312235,1527467,718004,458030239,418759684
29379754_718070,CM021100.1,1,29379754,457312235,1527467,718070,458030305,418759750
29379754_718146,CM021100.1,1,29379754,457312235,1527467,718146,458030381,418759826
29379754_718223,CM021100.1,1,29379754,457312235,1527467,718223,458030458,418759903
29377549_758889,CM021100.1,1,29377549,457304817,1980877,758889,458063706,418793151
29379799_817013,CM021100.1,1,29379799,457303261,4787914,817013,458120274,418849719
29381302_916291,CM021100.1,1,29381302,457303262,1847741,916291,458219553,418948998
29381302_916300,CM021100.1,1,29381302,457303262,1847741,916300,458219562,418949007
29381302_916303,CM021100.1,1,29381302,457303262,1847741,916303,458219565,418949010
29381302_916307,CM021100.1,1,29381302,457303262,1847741,916307,458219569,418949014
29381302_918027,CM021100.1,1,29381302,457303262,1847741,918027,458221289,418950734
29379744_1059751,CM021100.1,1,29379744,457303266,2603354,1059751,458363017,419092462
29379744_1065007,CM021100.1,1,29379744,457303266,2603354,1065007,458368273,419097718
29378433_1080854,CM021100.1,1,29378433,457303262,1482524,1080854,458384116,419113561
29381302_1156768,CM021100.1,1,29381302,457303262,1847741,1156768,458460030,419189475
29381302_1156865,CM021100.1,1,29381302,457303262,1847741,1156865,458460127,419189572
29381302_1156904,CM021100.1,1,29381302,457303262,1847741,1156904,458460166,419189611
29381302_1156937,CM021100.1,1,29381302,457303262,1847741,1156937,458460199,419189644
29381302_1156945,CM021100.1,1,29381302,457303262,1847741,1156945,458460207,419189652
29381766_1160847,CM021100.1,1,29381766,457303264,3146523,1160847,458464111,419193556
29381766_1161076,CM021100.1,1,29381766,457303264,3146523,1161076,458464340,419193785
29381766_1179453,CM021100.1,1,29381766,457303264,3146523,1179453,458482717,419212162
29381766_1185266,CM021100.1,1,29381766,457303264,3146523,1185266,458488530,419217975
29381766_1193606,CM021100.1,1,29381766,457303264,3146523,1193606,458496870,419226315
29381766_1193670,CM021100.1,1,29381766,457303264,3146523,1193670,458496934,419226379
29381766_1193671,CM021100.1,1,29381766,457303264,3146523,1193671,458496935,419226380
29378924_1200675,CM021100.1,1,29378924,457303264,4885929,1200675,458503939,419233384
29378924_1200753,CM021100.1,1,29378924,457303264,4885929,1200753,458504017,419233462
29378924_1200800,CM021100.1,1,29378924,457303264,4885929,1200800,458504064,419233509
29381766_1223080,CM021100.1,1,29381766,457303264,3146523,1223080,458526344,419255789
29381766_1223109,CM021100.1,1,29381766,457303264,3146523,1223109,458526373,419255818
29381766_1223146,CM021100.1,1,29381766,457303264,3146523,1223146,458526410,419255855
29381766_1223167,CM021100.1,1,29381766,457303264,3146523,1223167,458526431,419255876
29381766_1223173,CM021100.1,1,29381766,457303264,3146523,1223173,458526437,419255882
29381766_1223188,CM021100.1,1,29381766,457303264,3146523,1223188,458526452,419255897
29381766_1223196,CM021100.1,1,29381766,457303264,3146523,1223196,458526460,419255905
29378433_1251511,CM021100.1,1,29378433,457303262,1482524,1251511,458554773,419284218
29380744_1246744,CM021100.1,1,29380744,457310971,7043141,1246744,458557715,419287160
29381302_1257466,CM021100.1,1,29381302,457303262,1847741,1257466,458560728,419290173
29381302_1257552,CM021100.1,1,29381302,457303262,1847741,1257552,458560814,419290259
29381302_1258387,CM021100.1,1,29381302,457303262,1847741,1258387,458561649,419291094
29381302_1273919,CM021100.1,1,29381302,457303262,1847741,1273919,458577181,419306626
29381302_1283376,CM021100.1,1,29381302,457303262,1847741,1283376,458586638,419316083
29381302_1283816,CM021100.1,1,29381302,457303262,1847741,1283816,458587078,419316523
29377049_1333204,CM021100.1,1,29377049,457303262,4260312,1333204,458636466,419365911
29381766_1440231,CM021100.1,1,29381766,457303264,3146523,1440231,458743495,419472940
29381766_1440255,CM021100.1,1,29381766,457303264,3146523,1440255,458743519,419472964
29381766_1440277,CM021100.1,1,29381766,457303264,3146523,1440277,458743541,419472986
29381766_1440310,CM021100.1,1,29381766,457303264,3146523,1440310,458743574,419473019
29377784_1652458,CM021100.1,1,29377784,457303263,6301745,1652458,458955721,419685166
29377784_1652476,CM021100.1,1,29377784,457303263,6301745,1652476,458955739,419685184
29377784_1652478,CM021100.1,1,29377784,457303263,6301745,1652478,458955741,419685186
29377784_1652999,CM021100.1,1,29377784,457303263,6301745,1652999,458956262,419685707
29379799_2047567,CM021100.1,1,29379799,457303261,4787914,2047567,459350828,420080273
29379799_2047643,CM021100.1,1,29379799,457303261,4787914,2047643,459350904,420080349
29379799_2048487,CM021100.1,1,29379799,457303261,4787914,2048487,459351748,420081193
29379799_2048500,CM021100.1,1,29379799,457303261,4787914,2048500,459351761,420081206
29379799_2048523,CM021100.1,1,29379799,457303261,4787914,2048523,459351784,420081229
29379799_2048544,CM021100.1,1,29379799,457303261,4787914,2048544,459351805,420081250
29379799_2048613,CM021100.1,1,29379799,457303261,4787914,2048613,459351874,420081319
29379799_2048683,CM021100.1,1,29379799,457303261,4787914,2048683,459351944,420081389
29380744_2066831,CM021100.1,1,29380744,457310971,7043141,2066831,459377802,420107247
29380744_2066855,CM021100.1,1,29380744,457310971,7043141,2066855,459377826,420107271
29382071_2198830,CM021100.1,1,29382071,457303266,2371427,2198830,459502096,420231541
29381766_2258187,CM021100.1,1,29381766,457303264,3146523,2258187,459561451,420290896
29381766_2292752,CM021100.1,1,29381766,457303264,3146523,2292752,459596016,420325461
29381766_2292790,CM021100.1,1,29381766,457303264,3146523,2292790,459596054,420325499
29381766_2293161,CM021100.1,1,29381766,457303264,3146523,2293161,459596425,420325870
29381766_2343743,CM021100.1,1,29381766,457303264,3146523,2343743,459647007,420376452
29381766_2427803,CM021100.1,1,29381766,457303264,3146523,2427803,459731067,420460512
29378143_2437966,CM021100.1,1,29378143,457303266,3379378,2437966,459741232,420470677
29378143_2438050,CM021100.1,1,29378143,457303266,3379378,2438050,459741316,420470761
29379799_2791610,CM021100.1,1,29379799,457303261,4787914,2791610,460094871,420824316
29379799_2791721,CM021100.1,1,29379799,457303261,4787914,2791721,460094982,420824427
29379799_2791730,CM021100.1,1,29379799,457303261,4787914,2791730,460094991,420824436
29379799_2791758,CM021100.1,1,29379799,457303261,4787914,2791758,460095019,420824464
29379799_2796417,CM021100.1,1,29379799,457303261,4787914,2796417,460099678,420829123
29379799_2796980,CM021100.1,1,29379799,457303261,4787914,2796980,460100241,420829686
29379799_2798996,CM021100.1,1,29379799,457303261,4787914,2798996,460102257,420831702
29379799_2799013,CM021100.1,1,29379799,457303261,4787914,2799013,460102274,420831719
29379799_2801030,CM021100.1,1,29379799,457303261,4787914,2801030,460104291,420833736
29378924_2821922,CM021100.1,1,29378924,457303264,4885929,2821922,460125186,420854631
29378924_2822087,CM021100.1,1,29378924,457303264,4885929,2822087,460125351,420854796
29379799_2890979,CM021100.1,1,29379799,457303261,4787914,2890979,460194240,420923685
29377784_2969105,CM021100.1,1,29377784,457303263,6301745,2969105,460272368,421001813
29377784_2969119,CM021100.1,1,29377784,457303263,6301745,2969119,460272382,421001827
29377784_2969163,CM021100.1,1,29377784,457303263,6301745,2969163,460272426,421001871
29377784_2977316,CM021100.1,1,29377784,457303263,6301745,2977316,460280579,421010024
29377784_2999019,CM021100.1,1,29377784,457303263,6301745,2999019,460302282,421031727
29379799_3010760,CM021100.1,1,29379799,457303261,4787914,3010760,460314021,421043466
29379799_3010926,CM021100.1,1,29379799,457303261,4787914,3010926,460314187,421043632
29379799_3010932,CM021100.1,1,29379799,457303261,4787914,3010932,460314193,421043638
29379799_3011005,CM021100.1,1,29379799,457303261,4787914,3011005,460314266,421043711
29379799_3039724,CM021100.1,1,29379799,457303261,4787914,3039724,460342985,421072430
29377784_3072807,CM021100.1,1,29377784,457303263,6301745,3072807,460376070,421105515
29379799_3073151,CM021100.1,1,29379799,457303261,4787914,3073151,460376412,421105857
29378143_3146279,CM021100.1,1,29378143,457303266,3379378,3146279,460449545,421178990
29377955_3304165,CM021100.1,1,29377955,457305858,3609897,3304165,460610023,421339468
29377955_3304604,CM021100.1,1,29377955,457305858,3609897,3304604,460610462,421339907
29377955_3305059,CM021100.1,1,29377955,457305858,3609897,3305059,460610917,421340362
29377955_3305089,CM021100.1,1,29377955,457305858,3609897,3305089,460610947,421340392
29377955_3305104,CM021100.1,1,29377955,457305858,3609897,3305104,460610962,421340407
29379799_3329248,CM021100.1,1,29379799,457303261,4787914,3329248,460632509,421361954
29377784_3399104,CM021100.1,1,29377784,457303263,6301745,3399104,460702367,421431812
29377784_3399789,CM021100.1,1,29377784,457303263,6301745,3399789,460703052,421432497
29377784_3399844,CM021100.1,1,29377784,457303263,6301745,3399844,460703107,421432552
29377784_3406209,CM021100.1,1,29377784,457303263,6301745,3406209,460709472,421438917
29377784_3415880,CM021100.1,1,29377784,457303263,6301745,3415880,460719143,421448588
29377955_3438639,CM021100.1,1,29377955,457305858,3609897,3438639,460744497,421473942
29377955_3438656,CM021100.1,1,29377955,457305858,3609897,3438656,460744514,421473959
29380744_3705286,CM021100.1,1,29380744,457310971,7043141,3705286,461016257,421745702
29380744_3705358,CM021100.1,1,29380744,457310971,7043141,3705358,461016329,421745774
29380744_3705365,CM021100.1,1,29380744,457310971,7043141,3705365,461016336,421745781
29377784_3787400,CM021100.1,1,29377784,457303263,6301745,3787400,461090663,421820108
29377784_3787403,CM021100.1,1,29377784,457303263,6301745,3787403,461090666,421820111
29377784_3811106,CM021100.1,1,29377784,457303263,6301745,3811106,461114369,421843814
29377784_3811420,CM021100.1,1,29377784,457303263,6301745,3811420,461114683,421844128
29377784_3811423,CM021100.1,1,29377784,457303263,6301745,3811423,461114686,421844131
29377784_3815672,CM021100.1,1,29377784,457303263,6301745,3815672,461118935,421848380
29377784_3815716,CM021100.1,1,29377784,457303263,6301745,3815716,461118979,421848424
29377784_3957444,CM021100.1,1,29377784,457303263,6301745,3957444,461260707,421990152
29378924_3990464,CM021100.1,1,29378924,457303264,4885929,3990464,461293728,422023173
29378924_3990486,CM021100.1,1,29378924,457303264,4885929,3990486,461293750,422023195
29378924_3990510,CM021100.1,1,29378924,457303264,4885929,3990510,461293774,422023219
29378924_3990592,CM021100.1,1,29378924,457303264,4885929,3990592,461293856,422023301
29378924_3990727,CM021100.1,1,29378924,457303264,4885929,3990727,461293991,422023436
29378924_3990751,CM021100.1,1,29378924,457303264,4885929,3990751,461294015,422023460
29377784_3994632,CM021100.1,1,29377784,457303263,6301745,3994632,461297895,422027340
29379799_3995736,CM021100.1,1,29379799,457303261,4787914,3995736,461298997,422028442
29379799_4014086,CM021100.1,1,29379799,457303261,4787914,4014086,461317347,422046792
29379799_4015604,CM021100.1,1,29379799,457303261,4787914,4015604,461318865,422048310
29379799_4016090,CM021100.1,1,29379799,457303261,4787914,4016090,461319351,422048796
29379799_4016139,CM021100.1,1,29379799,457303261,4787914,4016139,461319400,422048845
29379799_4016173,CM021100.1,1,29379799,457303261,4787914,4016173,461319434,422048879
29379799_4016181,CM021100.1,1,29379799,457303261,4787914,4016181,461319442,422048887
29379799_4016272,CM021100.1,1,29379799,457303261,4787914,4016272,461319533,422048978
29380744_4139434,CM021100.1,1,29380744,457310971,7043141,4139434,461450405,422179850
29380744_4139473,CM021100.1,1,29380744,457310971,7043141,4139473,461450444,422179889
29380744_4164374,CM021100.1,1,29380744,457310971,7043141,4164374,461475345,422204790
29379799_4219046,CM021100.1,1,29379799,457303261,4787914,4219046,461522307,422251752
29379799_4250229,CM021100.1,1,29379799,457303261,4787914,4250229,461553490,422282935
29381423_19864,CM021100.1,1,29381423,461923604,1955761,19864,461943468,422672913
29377545_18705,CM021100.1,1,29377545,461926419,1028622,18705,461945124,422674569
29382112_49224,CM021100.1,1,29382112,461925885,831766,49224,461975109,422704554
29382112_49268,CM021100.1,1,29382112,461925885,831766,49268,461975153,422704598
29379998_53159,CM021100.1,1,29379998,461924758,602032,53159,461977917,422707362
29382112_74307,CM021100.1,1,29382112,461925885,831766,74307,462000192,422729637
29380744_4710996,CM021100.1,1,29380744,457310971,7043141,4710996,462021967,422751412
29377099_105052,CM021100.1,1,29377099,461923604,4815671,105052,462028656,422758101
29377099_105053,CM021100.1,1,29377099,461923604,4815671,105053,462028657,422758102
29377099_105066,CM021100.1,1,29377099,461923604,4815671,105066,462028670,422758115
29377099_105091,CM021100.1,1,29377099,461923604,4815671,105091,462028695,422758140
29377099_105103,CM021100.1,1,29377099,461923604,4815671,105103,462028707,422758152
29380744_4720687,CM021100.1,1,29380744,457310971,7043141,4720687,462031658,422761103
29380744_4720782,CM021100.1,1,29380744,457310971,7043141,4720782,462031753,422761198
29380744_4720886,CM021100.1,1,29380744,457310971,7043141,4720886,462031857,422761302
29382112_105986,CM021100.1,1,29382112,461925885,831766,105986,462031871,422761316
29382112_106006,CM021100.1,1,29382112,461925885,831766,106006,462031891,422761336
29382112_106023,CM021100.1,1,29382112,461925885,831766,106023,462031908,422761353
29382112_106026,CM021100.1,1,29382112,461925885,831766,106026,462031911,422761356
29382112_106044,CM021100.1,1,29382112,461925885,831766,106044,462031929,422761374
29382112_106058,CM021100.1,1,29382112,461925885,831766,106058,462031943,422761388
29382112_106095,CM021100.1,1,29382112,461925885,831766,106095,462031980,422761425
29379103_208434,CM021100.1,1,29379103,461923603,344809,208434,462132037,422861482
29379103_208451,CM021100.1,1,29379103,461923603,344809,208451,462132054,422861499
29379103_208525,CM021100.1,1,29379103,461923603,344809,208525,462132128,422861573
29379103_208530,CM021100.1,1,29379103,461923603,344809,208530,462132133,422861578
29377751_207047,CM021100.1,1,29377751,461925581,588425,207047,462132628,422862073
29379297_206381,CM021100.1,1,29379297,461927924,283171,206381,462134305,422863750
29380086_221116,CM021100.1,1,29380086,461923603,901296,221116,462144719,422874164
29381423_273189,CM021100.1,1,29381423,461923604,1955761,273189,462196793,422926238
29381423_273236,CM021100.1,1,29381423,461923604,1955761,273236,462196840,422926285
29380130_271948,CM021100.1,1,29380130,461925294,2956086,271948,462197242,422926687
29381423_273654,CM021100.1,1,29381423,461923604,1955761,273654,462197258,422926703
29380130_272004,CM021100.1,1,29380130,461925294,2956086,272004,462197298,422926743
29380130_272041,CM021100.1,1,29380130,461925294,2956086,272041,462197335,422926780
29381423_276277,CM021100.1,1,29381423,461923604,1955761,276277,462199881,422929326
29379297_276311,CM021100.1,1,29379297,461927924,283171,276311,462204235,422933680
29379297_276317,CM021100.1,1,29379297,461927924,283171,276317,462204241,422933686
29379297_276337,CM021100.1,1,29379297,461927924,283171,276337,462204261,422933706
29378362_299894,CM021100.1,1,29378362,461923604,445475,299894,462223498,422952943
29378362_299932,CM021100.1,1,29378362,461923604,445475,299932,462223536,422952981
29378362_300023,CM021100.1,1,29378362,461923604,445475,300023,462223627,422953072
29381423_300408,CM021100.1,1,29381423,461923604,1955761,300408,462224012,422953457
29378798_325556,CM021100.1,1,29378798,461923608,2683300,325556,462249164,422978609
29377784_4965862,CM021100.1,1,29377784,457303263,6301745,4965862,462269125,422998570
29377784_4965875,CM021100.1,1,29377784,457303263,6301745,4965875,462269138,422998583
29377099_375415,CM021100.1,1,29377099,461923604,4815671,375415,462299019,423028464
29378798_402511,CM021100.1,1,29378798,461923608,2683300,402511,462326119,423055564
29378798_402545,CM021100.1,1,29378798,461923608,2683300,402545,462326153,423055598
29377545_423573,CM021100.1,1,29377545,461926419,1028622,423573,462349992,423079437
29378362_432810,CM021100.1,1,29378362,461923604,445475,432810,462356414,423085859
29377784_5076944,CM021100.1,1,29377784,457303263,6301745,5076944,462380207,423109652
29380086_480867,CM021100.1,1,29380086,461923603,901296,480867,462404470,423133915
29377020_542840,CM021100.1,1,29377020,461923604,1475235,542840,462466444,423195889
29377020_544773,CM021100.1,1,29377020,461923604,1475235,544773,462468377,423197822
29377545_560996,CM021100.1,1,29377545,461926419,1028622,560996,462487415,423216860
29377020_587394,CM021100.1,1,29377020,461923604,1475235,587394,462510998,423240443
29377099_597671,CM021100.1,1,29377099,461923604,4815671,597671,462521275,423250720
29377099_598142,CM021100.1,1,29377099,461923604,4815671,598142,462521746,423251191
29377099_598174,CM021100.1,1,29377099,461923604,4815671,598174,462521778,423251223
29377020_598997,CM021100.1,1,29377020,461923604,1475235,598997,462522601,423252046
29377099_618456,CM021100.1,1,29377099,461923604,4815671,618456,462542060,423271505
29378408_623009,CM021100.1,1,29378408,461924875,1377694,623009,462547884,423277329
29378408_623037,CM021100.1,1,29378408,461924875,1377694,623037,462547912,423277357
29378408_623041,CM021100.1,1,29378408,461924875,1377694,623041,462547916,423277361
29377099_635149,CM021100.1,1,29377099,461923604,4815671,635149,462558753,423288198
29382271_643300,CM021100.1,1,29382271,461924314,2121261,643300,462567614,423297059
29382271_645786,CM021100.1,1,29382271,461924314,2121261,645786,462570100,423299545
29382271_647379,CM021100.1,1,29382271,461924314,2121261,647379,462571693,423301138
29378434_656744,CM021100.1,1,29378434,461925792,1876739,656744,462582536,423311981
29380744_5281845,CM021100.1,1,29380744,457310971,7043141,5281845,462592816,423322261
29380744_5281895,CM021100.1,1,29380744,457310971,7043141,5281895,462592866,423322311
29377099_688474,CM021100.1,1,29377099,461923604,4815671,688474,462612078,423341523
29377099_688616,CM021100.1,1,29377099,461923604,4815671,688616,462612220,423341665
29377099_706273,CM021100.1,1,29377099,461923604,4815671,706273,462629877,423359322
29381423_710112,CM021100.1,1,29381423,461923604,1955761,710112,462633716,423363161
29377784_5343506,CM021100.1,1,29377784,457303263,6301745,5343506,462646769,423376214
29377784_5343535,CM021100.1,1,29377784,457303263,6301745,5343535,462646798,423376243
29381423_742100,CM021100.1,1,29381423,461923604,1955761,742100,462665704,423395149
29377099_786343,CM021100.1,1,29377099,461923604,4815671,786343,462709947,423439392
29379094_804515,CM021100.1,1,29379094,461924385,916405,804515,462728900,423458345
29379094_804525,CM021100.1,1,29379094,461924385,916405,804525,462728910,423458355
29379094_804530,CM021100.1,1,29379094,461924385,916405,804530,462728915,423458360
29379094_804539,CM021100.1,1,29379094,461924385,916405,804539,462728924,423458369
29379094_804561,CM021100.1,1,29379094,461924385,916405,804561,462728946,423458391
29379094_804591,CM021100.1,1,29379094,461924385,916405,804591,462728976,423458421
29379094_804631,CM021100.1,1,29379094,461924385,916405,804631,462729016,423458461
29379094_804655,CM021100.1,1,29379094,461924385,916405,804655,462729040,423458485
29379094_804673,CM021100.1,1,29379094,461924385,916405,804673,462729058,423458503
29379094_804685,CM021100.1,1,29379094,461924385,916405,804685,462729070,423458515
29379094_804691,CM021100.1,1,29379094,461924385,916405,804691,462729076,423458521
29380744_5458823,CM021100.1,1,29380744,457310971,7043141,5458823,462769794,423499239
29378434_862407,CM021100.1,1,29378434,461925792,1876739,862407,462788199,423517644
29380744_5524746,CM021100.1,1,29380744,457310971,7043141,5524746,462835717,423565162
29379610_960445,CM021100.1,1,29379610,461923604,1763586,960445,462884049,423613494
29379610_960447,CM021100.1,1,29379610,461923604,1763586,960447,462884051,423613496
29379610_960469,CM021100.1,1,29379610,461923604,1763586,960469,462884073,423613518
29379610_960502,CM021100.1,1,29379610,461923604,1763586,960502,462884106,423613551
29379610_960516,CM021100.1,1,29379610,461923604,1763586,960516,462884120,423613565
29379610_960530,CM021100.1,1,29379610,461923604,1763586,960530,462884134,423613579
29379610_960534,CM021100.1,1,29379610,461923604,1763586,960534,462884138,423613583
29379610_960557,CM021100.1,1,29379610,461923604,1763586,960557,462884161,423613606
29377099_965259,CM021100.1,1,29377099,461923604,4815671,965259,462888863,423618308
29379610_973789,CM021100.1,1,29379610,461923604,1763586,973789,462897393,423626838
29379610_974449,CM021100.1,1,29379610,461923604,1763586,974449,462898053,423627498
29379610_974454,CM021100.1,1,29379610,461923604,1763586,974454,462898058,423627503
29379610_974490,CM021100.1,1,29379610,461923604,1763586,974490,462898094,423627539
29379610_979989,CM021100.1,1,29379610,461923604,1763586,979989,462903593,423633038
29378434_1001085,CM021100.1,1,29378434,461925792,1876739,1001085,462926877,423656322
29378434_1001089,CM021100.1,1,29378434,461925792,1876739,1001089,462926881,423656326
29378434_1001103,CM021100.1,1,29378434,461925792,1876739,1001103,462926895,423656340
29378434_1001356,CM021100.1,1,29378434,461925792,1876739,1001356,462927148,423656593
29378434_1001445,CM021100.1,1,29378434,461925792,1876739,1001445,462927237,423656682
29377020_1006465,CM021100.1,1,29377020,461923604,1475235,1006465,462930069,423659514
29377020_1006691,CM021100.1,1,29377020,461923604,1475235,1006691,462930295,423659740
29380286_1148735,CM021100.1,1,29380286,461923603,1365622,1148735,463072338,423801783
29380286_1149946,CM021100.1,1,29380286,461923603,1365622,1149946,463073549,423802994
29379610_1157558,CM021100.1,1,29379610,461923604,1763586,1157558,463081162,423810607
29379610_1170735,CM021100.1,1,29379610,461923604,1763586,1170735,463094339,423823784
29379610_1172043,CM021100.1,1,29379610,461923604,1763586,1172043,463095647,423825092
29377099_1180775,CM021100.1,1,29377099,461923604,4815671,1180775,463104379,423833824
29377099_1181398,CM021100.1,1,29377099,461923604,4815671,1181398,463105002,423834447
29377099_1198245,CM021100.1,1,29377099,461923604,4815671,1198245,463121849,423851294
29377099_1198290,CM021100.1,1,29377099,461923604,4815671,1198290,463121894,423851339
29377099_1198373,CM021100.1,1,29377099,461923604,4815671,1198373,463121977,423851422
29377099_1198434,CM021100.1,1,29377099,461923604,4815671,1198434,463122038,423851483
29377099_1198457,CM021100.1,1,29377099,461923604,4815671,1198457,463122061,423851506
29377099_1198515,CM021100.1,1,29377099,461923604,4815671,1198515,463122119,423851564
29380485_1223992,CM021100.1,1,29380485,461925866,2052896,1223992,463149858,423879303
29378798_1396160,CM021100.1,1,29378798,461923608,2683300,1396160,463319768,424049213
29378434_1691201,CM021100.1,1,29378434,461925792,1876739,1691201,463616993,424346438
29378434_1736299,CM021100.1,1,29378434,461925792,1876739,1736299,463662091,424391536
29378434_1788507,CM021100.1,1,29378434,461925792,1876739,1788507,463714299,424443744
29378434_1788526,CM021100.1,1,29378434,461925792,1876739,1788526,463714318,424443763
29377099_1984731,CM021100.1,1,29377099,461923604,4815671,1984731,463908335,424637780
29380744_6696265,CM021100.1,1,29380744,457310971,7043141,6696265,464007236,424736681
29380744_6801138,CM021100.1,1,29380744,457310971,7043141,6801138,464112109,424841554
29377099_2938694,CM021100.1,1,29377099,461923604,4815671,2938694,464862298,425591743
29377099_2938748,CM021100.1,1,29377099,461923604,4815671,2938748,464862352,425591797
29377099_2942827,CM021100.1,1,29377099,461923604,4815671,2942827,464866431,425595876
29377099_3543660,CM021100.1,1,29377099,461923604,4815671,3543660,465467264,426196709
29377099_3896313,CM021100.1,1,29377099,461923604,4815671,3896313,465819917,426549362
29377099_3896360,CM021100.1,1,29377099,461923604,4815671,3896360,465819964,426549409
29377099_3896370,CM021100.1,1,29377099,461923604,4815671,3896370,465819974,426549419
29377099_3896373,CM021100.1,1,29377099,461923604,4815671,3896373,465819977,426549422
29377099_3896378,CM021100.1,1,29377099,461923604,4815671,3896378,465819982,426549427
29377099_3896408,CM021100.1,1,29377099,461923604,4815671,3896408,465820012,426549457
29377099_3896414,CM021100.1,1,29377099,461923604,4815671,3896414,465820018,426549463
29377099_3896444,CM021100.1,1,29377099,461923604,4815671,3896444,465820048,426549493
29378064_4133251,CM021100.1,1,29378064,461924748,5171370,4133251,466057999,426787444
29378064_4133322,CM021100.1,1,29378064,461924748,5171370,4133322,466058070,426787515
29378064_4185357,CM021100.1,1,29378064,461924748,5171370,4185357,466110105,426839550
29378064_4185433,CM021100.1,1,29378064,461924748,5171370,4185433,466110181,426839626
29378064_4185440,CM021100.1,1,29378064,461924748,5171370,4185440,466110188,426839633
29378064_4188894,CM021100.1,1,29378064,461924748,5171370,4188894,466113642,426843087
29378064_4188895,CM021100.1,1,29378064,461924748,5171370,4188895,466113643,426843088
29378064_4204995,CM021100.1,1,29378064,461924748,5171370,4204995,466129743,426859188
29378064_4506660,CM021100.1,1,29378064,461924748,5171370,4506660,466431408,427160853
29378064_4512008,CM021100.1,1,29378064,461924748,5171370,4512008,466436756,427166201
29378064_4512010,CM021100.1,1,29378064,461924748,5171370,4512010,466436758,427166203
29378064_4512011,CM021100.1,1,29378064,461924748,5171370,4512011,466436759,427166204
29378064_4512048,CM021100.1,1,29378064,461924748,5171370,4512048,466436796,427166241
29378064_4543361,CM021100.1,1,29378064,461924748,5171370,4543361,466468109,427197554
29378064_4581847,CM021100.1,1,29378064,461924748,5171370,4581847,466506595,427236040
29378064_4581955,CM021100.1,1,29378064,461924748,5171370,4581955,466506703,427236148
29378064_4582610,CM021100.1,1,29378064,461924748,5171370,4582610,466507358,427236803
29375457_454,CM021100.1,1,29375457,475459439,83360,454,475459893,436189338
29375457_469,CM021100.1,1,29375457,475459439,83360,469,475459908,436189353
29375457_485,CM021100.1,1,29375457,475459439,83360,485,475459924,436189369
29375457_529,CM021100.1,1,29375457,475459439,83360,529,475459968,436189413
29375457_547,CM021100.1,1,29375457,475459439,83360,547,475459986,436189431
29375457_589,CM021100.1,1,29375457,475459439,83360,589,475460028,436189473
29375457_670,CM021100.1,1,29375457,475459439,83360,670,475460109,436189554
29375457_674,CM021100.1,1,29375457,475459439,83360,674,475460113,436189558
29379368_40804,CM021100.1,1,29379368,475460586,225848,40804,475501390,436230835
29382052_625240,CM021100.1,1,29382052,475459439,1182725,625240,476084679,436814124
29382052_625265,CM021100.1,1,29382052,475459439,1182725,625265,476084704,436814149
29380367_168859,CM021100.1,1,29380367,487902397,885034,168859,488071256,448800701
29380367_168933,CM021100.1,1,29380367,487902397,885034,168933,488071330,448800775
29380367_168987,CM021100.1,1,29380367,487902397,885034,168987,488071384,448800829
29380367_169018,CM021100.1,1,29380367,487902397,885034,169018,488071415,448800860
29380367_169036,CM021100.1,1,29380367,487902397,885034,169036,488071433,448800878
29380367_169087,CM021100.1,1,29380367,487902397,885034,169087,488071484,448800929
29380367_169101,CM021100.1,1,29380367,487902397,885034,169101,488071498,448800943
29378557_302369,CM021100.1,1,29378557,487902400,566929,302369,488204769,448934214
29378557_302401,CM021100.1,1,29378557,487902400,566929,302401,488204801,448934246
29380367_543162,CM021100.1,1,29380367,487902397,885034,543162,488445559,449175004
29380367_543233,CM021100.1,1,29380367,487902397,885034,543233,488445630,449175075
29380367_543280,CM021100.1,1,29380367,487902397,885034,543280,488445677,449175122
29380367_543281,CM021100.1,1,29380367,487902397,885034,543281,488445678,449175123
29380367_543292,CM021100.1,1,29380367,487902397,885034,543292,488445689,449175134
29380367_739498,CM021100.1,1,29380367,487902397,885034,739498,488641895,449371340
29380367_775880,CM021100.1,1,29380367,487902397,885034,775880,488678277,449407722
29378532_1281600,CM021100.1,1,29378532,487902400,1776114,1281600,489184000,449913445
29381808_10304,CM021100.1,1,29381808,503570234,335046,10304,503580538,464309983
29381808_36318,CM021100.1,1,29381808,503570234,335046,36318,503606552,464335997
29381808_36322,CM021100.1,1,29381808,503570234,335046,36322,503606556,464336001
29377912_91940,CM021100.1,1,29377912,503568493,1025747,91940,503660433,464389878
29377912_92025,CM021100.1,1,29377912,503568493,1025747,92025,503660518,464389963
29377912_92788,CM021100.1,1,29377912,503568493,1025747,92788,503661281,464390726
29377912_92825,CM021100.1,1,29377912,503568493,1025747,92825,503661318,464390763
29379060_186375,CM021100.1,1,29379060,503568493,1106066,186375,503754868,464484313
29379060_186405,CM021100.1,1,29379060,503568493,1106066,186405,503754898,464484343
29377912_375084,CM021100.1,1,29377912,503568493,1025747,375084,503943577,464673022
29379060_802102,CM021100.1,1,29379060,503568493,1106066,802102,504370595,465100040
29379060_802133,CM021100.1,1,29379060,503568493,1106066,802133,504370626,465100071
29379060_802146,CM021100.1,1,29379060,503568493,1106066,802146,504370639,465100084
29377401_35684,CM021100.1,1,29377401,508880539,3261707,35684,508916223,469645668
29377401_35755,CM021100.1,1,29377401,508880539,3261707,35755,508916294,469645739
29377401_53630,CM021100.1,1,29377401,508880539,3261707,53630,508934169,469663614
29377401_83407,CM021100.1,1,29377401,508880539,3261707,83407,508963946,469693391
29377401_83443,CM021100.1,1,29377401,508880539,3261707,83443,508963982,469693427
29377401_83538,CM021100.1,1,29377401,508880539,3261707,83538,508964077,469693522
29377401_83609,CM021100.1,1,29377401,508880539,3261707,83609,508964148,469693593
29377401_83665,CM021100.1,1,29377401,508880539,3261707,83665,508964204,469693649
29377401_83721,CM021100.1,1,29377401,508880539,3261707,83721,508964260,469693705
29377401_83983,CM021100.1,1,29377401,508880539,3261707,83983,508964522,469693967
29377401_275443,CM021100.1,1,29377401,508880539,3261707,275443,509155982,469885427
29377401_277058,CM021100.1,1,29377401,508880539,3261707,277058,509157597,469887042
29377401_297338,CM021100.1,1,29377401,508880539,3261707,297338,509177877,469907322
29377401_297539,CM021100.1,1,29377401,508880539,3261707,297539,509178078,469907523
29377401_297681,CM021100.1,1,29377401,508880539,3261707,297681,509178220,469907665
29377401_297700,CM021100.1,1,29377401,508880539,3261707,297700,509178239,469907684
29377401_298850,CM021100.1,1,29377401,508880539,3261707,298850,509179389,469908834
29377401_298964,CM021100.1,1,29377401,508880539,3261707,298964,509179503,469908948
29377401_304341,CM021100.1,1,29377401,508880539,3261707,304341,509184880,469914325
29377401_304363,CM021100.1,1,29377401,508880539,3261707,304363,509184902,469914347
29377091_456069,CM021100.1,1,29377091,508880541,3535359,456069,509336610,470066055
29377091_456124,CM021100.1,1,29377091,508880541,3535359,456124,509336665,470066110
29377091_456134,CM021100.1,1,29377091,508880541,3535359,456134,509336675,470066120
29377091_456187,CM021100.1,1,29377091,508880541,3535359,456187,509336728,470066173
29377091_456209,CM021100.1,1,29377091,508880541,3535359,456209,509336750,470066195
29382480_503839,CM021100.1,1,29382480,508880537,1491015,503839,509384376,470113821
29382480_503900,CM021100.1,1,29382480,508880537,1491015,503900,509384437,470113882
29377908_505529,CM021100.1,1,29377908,508880523,519421,505529,509386052,470115497
29377908_505637,CM021100.1,1,29377908,508880523,519421,505637,509386160,470115605
29377091_619391,CM021100.1,1,29377091,508880541,3535359,619391,509499932,470229377
29377091_619442,CM021100.1,1,29377091,508880541,3535359,619442,509499983,470229428
29377091_619450,CM021100.1,1,29377091,508880541,3535359,619450,509499991,470229436
29377091_643994,CM021100.1,1,29377091,508880541,3535359,643994,509524535,470253980
29377091_644052,CM021100.1,1,29377091,508880541,3535359,644052,509524593,470254038
29377091_660335,CM021100.1,1,29377091,508880541,3535359,660335,509540876,470270321
29377401_797309,CM021100.1,1,29377401,508880539,3261707,797309,509677848,470407293
29377401_797336,CM021100.1,1,29377401,508880539,3261707,797336,509677875,470407320
29377401_797345,CM021100.1,1,29377401,508880539,3261707,797345,509677884,470407329
29377401_797363,CM021100.1,1,29377401,508880539,3261707,797363,509677902,470407347
29377401_963871,CM021100.1,1,29377401,508880539,3261707,963871,509844410,470573855
29377401_963872,CM021100.1,1,29377401,508880539,3261707,963872,509844411,470573856
29377401_963898,CM021100.1,1,29377401,508880539,3261707,963898,509844437,470573882
29377401_963913,CM021100.1,1,29377401,508880539,3261707,963913,509844452,470573897
29377401_964008,CM021100.1,1,29377401,508880539,3261707,964008,509844547,470573992
29377401_964012,CM021100.1,1,29377401,508880539,3261707,964012,509844551,470573996
29377401_964029,CM021100.1,1,29377401,508880539,3261707,964029,509844568,470574013
29377401_964036,CM021100.1,1,29377401,508880539,3261707,964036,509844575,470574020
29377401_964073,CM021100.1,1,29377401,508880539,3261707,964073,509844612,470574057
29382480_1040837,CM021100.1,1,29382480,508880537,1491015,1040837,509921374,470650819
29381619_1057626,CM021100.1,1,29381619,508880539,2619134,1057626,509938165,470667610
29381619_1057707,CM021100.1,1,29381619,508880539,2619134,1057707,509938246,470667691
29377091_1058711,CM021100.1,1,29377091,508880541,3535359,1058711,509939252,470668697
29377091_1058744,CM021100.1,1,29377091,508880541,3535359,1058744,509939285,470668730
29377091_1058871,CM021100.1,1,29377091,508880541,3535359,1058871,509939412,470668857
29377091_1058893,CM021100.1,1,29377091,508880541,3535359,1058893,509939434,470668879
29377091_1110525,CM021100.1,1,29377091,508880541,3535359,1110525,509991066,470720511
29377091_1110560,CM021100.1,1,29377091,508880541,3535359,1110560,509991101,470720546
29377091_1110615,CM021100.1,1,29377091,508880541,3535359,1110615,509991156,470720601
29377091_1153147,CM021100.1,1,29377091,508880541,3535359,1153147,510033688,470763133
29377091_1153192,CM021100.1,1,29377091,508880541,3535359,1153192,510033733,470763178
29377091_1153240,CM021100.1,1,29377091,508880541,3535359,1153240,510033781,470763226
29377401_1194506,CM021100.1,1,29377401,508880539,3261707,1194506,510075045,470804490
29377091_1201145,CM021100.1,1,29377091,508880541,3535359,1201145,510081686,470811131
29377091_1201162,CM021100.1,1,29377091,508880541,3535359,1201162,510081703,470811148
29377091_1201222,CM021100.1,1,29377091,508880541,3535359,1201222,510081763,470811208
29377091_1201239,CM021100.1,1,29377091,508880541,3535359,1201239,510081780,470811225
29377401_1211601,CM021100.1,1,29377401,508880539,3261707,1211601,510092140,470821585
29381778_9579,CM021100.1,1,29381778,510368569,1525874,9579,510378148,471107593
29381778_9581,CM021100.1,1,29381778,510368569,1525874,9581,510378150,471107595
29377175_1509513,CM021100.1,1,29377175,508880537,2893606,1509513,510390050,471119495
29377175_1509540,CM021100.1,1,29377175,508880537,2893606,1509540,510390077,471119522
29377175_1509561,CM021100.1,1,29377175,508880537,2893606,1509561,510390098,471119543
29378275_21557,CM021100.1,1,29378275,510369011,2820642,21557,510390568,471120013
29377401_1544512,CM021100.1,1,29377401,508880539,3261707,1544512,510425051,471154496
29377401_1544524,CM021100.1,1,29377401,508880539,3261707,1544524,510425063,471154508
29377401_1544558,CM021100.1,1,29377401,508880539,3261707,1544558,510425097,471154542
29377401_1544617,CM021100.1,1,29377401,508880539,3261707,1544617,510425156,471154601
29377401_1576962,CM021100.1,1,29377401,508880539,3261707,1576962,510457501,471186946
29381619_1631677,CM021100.1,1,29381619,508880539,2619134,1631677,510512216,471241661
29381619_1631756,CM021100.1,1,29381619,508880539,2619134,1631756,510512295,471241740
29381619_1631761,CM021100.1,1,29381619,508880539,2619134,1631761,510512300,471241745
29377401_1688355,CM021100.1,1,29377401,508880539,3261707,1688355,510568894,471298339
29377091_1791590,CM021100.1,1,29377091,508880541,3535359,1791590,510672131,471401576
29381106_343093,CM021100.1,1,29381106,510368567,416556,343093,510711660,471441105
29381106_343094,CM021100.1,1,29381106,510368567,416556,343094,510711661,471441106
29377401_1836430,CM021100.1,1,29377401,508880539,3261707,1836430,510716969,471446414
29377401_1838413,CM021100.1,1,29377401,508880539,3261707,1838413,510718952,471448397
29377401_1847728,CM021100.1,1,29377401,508880539,3261707,1847728,510728267,471457712
29377401_1847730,CM021100.1,1,29377401,508880539,3261707,1847730,510728269,471457714
29377401_1847732,CM021100.1,1,29377401,508880539,3261707,1847732,510728271,471457716
29380377_475709,CM021100.1,1,29380377,510368569,1942171,475709,510844278,471573723
29377401_2037829,CM021100.1,1,29377401,508880539,3261707,2037829,510918368,471647813
29377401_2037859,CM021100.1,1,29377401,508880539,3261707,2037859,510918398,471647843
29377401_2037866,CM021100.1,1,29377401,508880539,3261707,2037866,510918405,471647850
29377401_2037884,CM021100.1,1,29377401,508880539,3261707,2037884,510918423,471647868
29377401_2038051,CM021100.1,1,29377401,508880539,3261707,2038051,510918590,471648035
29377401_2038981,CM021100.1,1,29377401,508880539,3261707,2038981,510919520,471648965
29377401_2039238,CM021100.1,1,29377401,508880539,3261707,2039238,510919777,471649222
29380787_554323,CM021100.1,1,29380787,510368569,778161,554323,510922892,471652337
29380787_554353,CM021100.1,1,29380787,510368569,778161,554353,510922922,471652367
29380787_554391,CM021100.1,1,29380787,510368569,778161,554391,510922960,471652405
29380336_101214,CM021100.1,1,29380336,510828208,589971,101214,510929422,471658867
29377401_2101595,CM021100.1,1,29377401,508880539,3261707,2101595,510982134,471711579
29377401_2101625,CM021100.1,1,29377401,508880539,3261707,2101625,510982164,471711609
29377401_2102666,CM021100.1,1,29377401,508880539,3261707,2102666,510983205,471712650
29377401_2102702,CM021100.1,1,29377401,508880539,3261707,2102702,510983241,471712686
29377401_2102733,CM021100.1,1,29377401,508880539,3261707,2102733,510983272,471712717
29377401_2116020,CM021100.1,1,29377401,508880539,3261707,2116020,510996559,471726004
29377401_2137029,CM021100.1,1,29377401,508880539,3261707,2137029,511017568,471747013
29377401_2137089,CM021100.1,1,29377401,508880539,3261707,2137089,511017628,471747073
29377401_2137120,CM021100.1,1,29377401,508880539,3261707,2137120,511017659,471747104
29380787_654584,CM021100.1,1,29380787,510368569,778161,654584,511023153,471752598
29380787_654844,CM021100.1,1,29380787,510368569,778161,654844,511023413,471752858
29380787_654851,CM021100.1,1,29380787,510368569,778161,654851,511023420,471752865
29380787_654853,CM021100.1,1,29380787,510368569,778161,654853,511023422,471752867
29380787_654870,CM021100.1,1,29380787,510368569,778161,654870,511023439,471752884
29380336_295553,CM021100.1,1,29380336,510828208,589971,295553,511123761,471853206
29377401_2275721,CM021100.1,1,29377401,508880539,3261707,2275721,511156260,471885705
29377401_2275726,CM021100.1,1,29377401,508880539,3261707,2275726,511156265,471885710
29377401_2275733,CM021100.1,1,29377401,508880539,3261707,2275733,511156272,471885717
29377401_2275734,CM021100.1,1,29377401,508880539,3261707,2275734,511156273,471885718
29377401_2275782,CM021100.1,1,29377401,508880539,3261707,2275782,511156321,471885766
29377401_2275788,CM021100.1,1,29377401,508880539,3261707,2275788,511156327,471885772
29377401_2275807,CM021100.1,1,29377401,508880539,3261707,2275807,511156346,471885791
29377401_2275828,CM021100.1,1,29377401,508880539,3261707,2275828,511156367,471885812
29377401_2275863,CM021100.1,1,29377401,508880539,3261707,2275863,511156402,471885847
29380377_794563,CM021100.1,1,29380377,510368569,1942171,794563,511163132,471892577
29377091_2292879,CM021100.1,1,29377091,508880541,3535359,2292879,511173420,471902865
29380377_918152,CM021100.1,1,29380377,510368569,1942171,918152,511286721,472016166
29380377_950840,CM021100.1,1,29380377,510368569,1942171,950840,511319409,472048854
29380377_950841,CM021100.1,1,29380377,510368569,1942171,950841,511319410,472048855
29380377_950843,CM021100.1,1,29380377,510368569,1942171,950843,511319412,472048857
29380377_950871,CM021100.1,1,29380377,510368569,1942171,950871,511319440,472048885
29380377_950898,CM021100.1,1,29380377,510368569,1942171,950898,511319467,472048912
29380377_950986,CM021100.1,1,29380377,510368569,1942171,950986,511319555,472049000
29380377_951051,CM021100.1,1,29380377,510368569,1942171,951051,511319620,472049065
29380377_951111,CM021100.1,1,29380377,510368569,1942171,951111,511319680,472049125
29380377_951112,CM021100.1,1,29380377,510368569,1942171,951112,511319681,472049126
29381778_1000023,CM021100.1,1,29381778,510368569,1525874,1000023,511368592,472098037
29381778_1000043,CM021100.1,1,29381778,510368569,1525874,1000043,511368612,472098057
29378275_1044999,CM021100.1,1,29378275,510369011,2820642,1044999,511414010,472143455
29378275_1045099,CM021100.1,1,29378275,510369011,2820642,1045099,511414110,472143555
29377175_2543061,CM021100.1,1,29377175,508880537,2893606,2543061,511423598,472153043
29377175_2543584,CM021100.1,1,29377175,508880537,2893606,2543584,511424121,472153566
29380377_1061954,CM021100.1,1,29380377,510368569,1942171,1061954,511430523,472159968
29380377_1061980,CM021100.1,1,29380377,510368569,1942171,1061980,511430549,472159994
29380377_1064401,CM021100.1,1,29380377,510368569,1942171,1064401,511432970,472162415
29380377_1065629,CM021100.1,1,29380377,510368569,1942171,1065629,511434198,472163643
29380377_1068314,CM021100.1,1,29380377,510368569,1942171,1068314,511436883,472166328
29380377_1069140,CM021100.1,1,29380377,510368569,1942171,1069140,511437709,472167154
29379118_1099018,CM021100.1,1,29379118,510368569,2090228,1099018,511467587,472197032
29379118_1099022,CM021100.1,1,29379118,510368569,2090228,1099022,511467591,472197036
29380377_1104589,CM021100.1,1,29380377,510368569,1942171,1104589,511473158,472202603
29381619_2599187,CM021100.1,1,29381619,508880539,2619134,2599187,511479726,472209171
29381619_2599298,CM021100.1,1,29381619,508880539,2619134,2599298,511479837,472209282
29379118_1154433,CM021100.1,1,29379118,510368569,2090228,1154433,511523002,472252447
29379118_1154434,CM021100.1,1,29379118,510368569,2090228,1154434,511523003,472252448
29379118_1154469,CM021100.1,1,29379118,510368569,2090228,1154469,511523038,472252483
29380377_1174573,CM021100.1,1,29380377,510368569,1942171,1174573,511543142,472272587
29377175_2670269,CM021100.1,1,29377175,508880537,2893606,2670269,511550806,472280251
29379118_1195757,CM021100.1,1,29379118,510368569,2090228,1195757,511564326,472293771
29379118_1195835,CM021100.1,1,29379118,510368569,2090228,1195835,511564404,472293849
29379118_1195838,CM021100.1,1,29379118,510368569,2090228,1195838,511564407,472293852
29377401_2745188,CM021100.1,1,29377401,508880539,3261707,2745188,511625727,472355172
29377401_2745197,CM021100.1,1,29377401,508880539,3261707,2745197,511625736,472355181
29377401_2745243,CM021100.1,1,29377401,508880539,3261707,2745243,511625782,472355227
29377401_2745274,CM021100.1,1,29377401,508880539,3261707,2745274,511625813,472355258
29377401_2746498,CM021100.1,1,29377401,508880539,3261707,2746498,511627037,472356482
29377401_2746517,CM021100.1,1,29377401,508880539,3261707,2746517,511627056,472356501
29377401_2746521,CM021100.1,1,29377401,508880539,3261707,2746521,511627060,472356505
29377401_2746557,CM021100.1,1,29377401,508880539,3261707,2746557,511627096,472356541
29377401_2746613,CM021100.1,1,29377401,508880539,3261707,2746613,511627152,472356597
29377534_1327917,CM021100.1,1,29377534,510368569,5116256,1327917,511696486,472425931
29377534_1327923,CM021100.1,1,29377534,510368569,5116256,1327923,511696492,472425937
29377175_2827345,CM021100.1,1,29377175,508880537,2893606,2827345,511707882,472437327
29377401_2864081,CM021100.1,1,29377401,508880539,3261707,2864081,511744620,472474065
29377401_2864118,CM021100.1,1,29377401,508880539,3261707,2864118,511744657,472474102
29377401_2864141,CM021100.1,1,29377401,508880539,3261707,2864141,511744680,472474125
29377401_2864198,CM021100.1,1,29377401,508880539,3261707,2864198,511744737,472474182
29380377_1381031,CM021100.1,1,29380377,510368569,1942171,1381031,511749600,472479045
29380377_1381032,CM021100.1,1,29380377,510368569,1942171,1381032,511749601,472479046
29380377_1381098,CM021100.1,1,29380377,510368569,1942171,1381098,511749667,472479112
29380377_1383380,CM021100.1,1,29380377,510368569,1942171,1383380,511751949,472481394
29380377_1384196,CM021100.1,1,29380377,510368569,1942171,1384196,511752765,472482210
29380377_1384275,CM021100.1,1,29380377,510368569,1942171,1384275,511752844,472482289
29380377_1384276,CM021100.1,1,29380377,510368569,1942171,1384276,511752845,472482290
29379118_1440080,CM021100.1,1,29379118,510368569,2090228,1440080,511808649,472538094
29377091_2930038,CM021100.1,1,29377091,508880541,3535359,2930038,511810579,472540024
29377534_1469037,CM021100.1,1,29377534,510368569,5116256,1469037,511837606,472567051
29377534_1469115,CM021100.1,1,29377534,510368569,5116256,1469115,511837684,472567129
29377534_1469195,CM021100.1,1,29377534,510368569,5116256,1469195,511837764,472567209
29377534_1532376,CM021100.1,1,29377534,510368569,5116256,1532376,511900945,472630390
29377534_1666740,CM021100.1,1,29377534,510368569,5116256,1666740,512035309,472764754
29377534_1666766,CM021100.1,1,29377534,510368569,5116256,1666766,512035335,472764780
29377534_1735592,CM021100.1,1,29377534,510368569,5116256,1735592,512104161,472833606
29377091_3248314,CM021100.1,1,29377091,508880541,3535359,3248314,512128855,472858300
29378023_1778472,CM021100.1,1,29378023,510368568,5658225,1778472,512147040,472876485
29378023_1778482,CM021100.1,1,29378023,510368568,5658225,1778482,512147050,472876495
29378023_1778494,CM021100.1,1,29378023,510368568,5658225,1778494,512147062,472876507
29378023_1778518,CM021100.1,1,29378023,510368568,5658225,1778518,512147086,472876531
29378023_1778550,CM021100.1,1,29378023,510368568,5658225,1778550,512147118,472876563
29378023_1778593,CM021100.1,1,29378023,510368568,5658225,1778593,512147161,472876606
29378023_1778599,CM021100.1,1,29378023,510368568,5658225,1778599,512147167,472876612
29378023_1778601,CM021100.1,1,29378023,510368568,5658225,1778601,512147169,472876614
29378023_1778604,CM021100.1,1,29378023,510368568,5658225,1778604,512147172,472876617
29377091_3272421,CM021100.1,1,29377091,508880541,3535359,3272421,512152962,472882407
29380377_1920922,CM021100.1,1,29380377,510368569,1942171,1920922,512289491,473018936
29380377_1920940,CM021100.1,1,29380377,510368569,1942171,1920940,512289509,473018954
29377534_1941907,CM021100.1,1,29377534,510368569,5116256,1941907,512310476,473039921
29377534_1941911,CM021100.1,1,29377534,510368569,5116256,1941911,512310480,473039925
29377534_1941956,CM021100.1,1,29377534,510368569,5116256,1941956,512310525,473039970
29377534_1942003,CM021100.1,1,29377534,510368569,5116256,1942003,512310572,473040017
29377534_1942092,CM021100.1,1,29377534,510368569,5116256,1942092,512310661,473040106
29377534_1942146,CM021100.1,1,29377534,510368569,5116256,1942146,512310715,473040160
29377534_2113068,CM021100.1,1,29377534,510368569,5116256,2113068,512481637,473211082
29377534_2113074,CM021100.1,1,29377534,510368569,5116256,2113074,512481643,473211088
29377534_2113086,CM021100.1,1,29377534,510368569,5116256,2113086,512481655,473211100
29377534_2364071,CM021100.1,1,29377534,510368569,5116256,2364071,512732640,473462085
29377534_2364085,CM021100.1,1,29377534,510368569,5116256,2364085,512732654,473462099
29378023_2392215,CM021100.1,1,29378023,510368568,5658225,2392215,512760783,473490228
29378023_2392237,CM021100.1,1,29378023,510368568,5658225,2392237,512760805,473490250
29378023_2418648,CM021100.1,1,29378023,510368568,5658225,2418648,512787216,473516661
29378023_2449052,CM021100.1,1,29378023,510368568,5658225,2449052,512817620,473547065
29378023_2449093,CM021100.1,1,29378023,510368568,5658225,2449093,512817661,473547106
29378023_2449150,CM021100.1,1,29378023,510368568,5658225,2449150,512817718,473547163
29378023_2467022,CM021100.1,1,29378023,510368568,5658225,2467022,512835590,473565035
29378023_2467028,CM021100.1,1,29378023,510368568,5658225,2467028,512835596,473565041
29378023_2467075,CM021100.1,1,29378023,510368568,5658225,2467075,512835643,473565088
29378023_2483923,CM021100.1,1,29378023,510368568,5658225,2483923,512852491,473581936
29378023_2483995,CM021100.1,1,29378023,510368568,5658225,2483995,512852563,473582008
29378023_2484068,CM021100.1,1,29378023,510368568,5658225,2484068,512852636,473582081
29378023_2505852,CM021100.1,1,29378023,510368568,5658225,2505852,512874420,473603865
29380259_2734522,CM021100.1,1,29380259,510368567,4548683,2734522,513103089,473832534
29377534_2880434,CM021100.1,1,29377534,510368569,5116256,2880434,513249003,473978448
29380259_3097551,CM021100.1,1,29380259,510368567,4548683,3097551,513466118,474195563
29380259_3628155,CM021100.1,1,29380259,510368567,4548683,3628155,513996722,474726167
29380259_3628218,CM021100.1,1,29380259,510368567,4548683,3628218,513996785,474726230
29380259_3798487,CM021100.1,1,29380259,510368567,4548683,3798487,514167054,474896499
29378023_3807226,CM021100.1,1,29378023,510368568,5658225,3807226,514175794,474905239
29378023_3859294,CM021100.1,1,29378023,510368568,5658225,3859294,514227862,474957307
29378023_3859313,CM021100.1,1,29378023,510368568,5658225,3859313,514227881,474957326
29378023_3892312,CM021100.1,1,29378023,510368568,5658225,3892312,514260880,474990325
29378023_3892354,CM021100.1,1,29378023,510368568,5658225,3892354,514260922,474990367
29378023_3892537,CM021100.1,1,29378023,510368568,5658225,3892537,514261105,474990550
29378023_3939016,CM021100.1,1,29378023,510368568,5658225,3939016,514307584,475037029
29378023_3939091,CM021100.1,1,29378023,510368568,5658225,3939091,514307659,475037104
29378023_3991002,CM021100.1,1,29378023,510368568,5658225,3991002,514359570,475089015
29378023_3991127,CM021100.1,1,29378023,510368568,5658225,3991127,514359695,475089140
29378023_3991186,CM021100.1,1,29378023,510368568,5658225,3991186,514359754,475089199
29378023_3992487,CM021100.1,1,29378023,510368568,5658225,3992487,514361055,475090500
29378023_3992912,CM021100.1,1,29378023,510368568,5658225,3992912,514361480,475090925
29378023_3994135,CM021100.1,1,29378023,510368568,5658225,3994135,514362703,475092148
29378023_3994146,CM021100.1,1,29378023,510368568,5658225,3994146,514362714,475092159
29378023_3994837,CM021100.1,1,29378023,510368568,5658225,3994837,514363405,475092850
29380259_4176319,CM021100.1,1,29380259,510368567,4548683,4176319,514544886,475274331
29377534_4469911,CM021100.1,1,29377534,510368569,5116256,4469911,514838480,475567925
29378023_4534443,CM021100.1,1,29378023,510368568,5658225,4534443,514903011,475632456
29377534_4748414,CM021100.1,1,29377534,510368569,5116256,4748414,515116983,475846428
29377534_4809807,CM021100.1,1,29377534,510368569,5116256,4809807,515178376,475907821
29377534_4871603,CM021100.1,1,29377534,510368569,5116256,4871603,515240172,475969617
29377534_4871609,CM021100.1,1,29377534,510368569,5116256,4871609,515240178,475969623
29355187_12983,CM021100.1,1,29355187,516739197,328248,12983,516752180,477481625
29355187_13010,CM021100.1,1,29355187,516739197,328248,13010,516752207,477481652
29355187_13025,CM021100.1,1,29355187,516739197,328248,13025,516752222,477481667
29355187_13052,CM021100.1,1,29355187,516739197,328248,13052,516752249,477481694
29355187_13078,CM021100.1,1,29355187,516739197,328248,13078,516752275,477481720
29355187_13082,CM021100.1,1,29355187,516739197,328248,13082,516752279,477481724
29355187_13093,CM021100.1,1,29355187,516739197,328248,13093,516752290,477481735
29355187_13118,CM021100.1,1,29355187,516739197,328248,13118,516752315,477481760
29355187_13179,CM021100.1,1,29355187,516739197,328248,13179,516752376,477481821
29355187_13207,CM021100.1,1,29355187,516739197,328248,13207,516752404,477481849
29355187_13224,CM021100.1,1,29355187,516739197,328248,13224,516752421,477481866
29379615_156893,CM021100.1,1,29379615,516739379,1403694,156893,516896272,477625717
29379615_187230,CM021100.1,1,29379615,516739379,1403694,187230,516926609,477656054
29379615_234765,CM021100.1,1,29379615,516739379,1403694,234765,516974144,477703589
29382269_319176,CM021100.1,1,29382269,516739197,1044238,319176,517058373,477787818
29382269_567664,CM021100.1,1,29382269,516739197,1044238,567664,517306861,478036306
29379210_693796,CM021100.1,1,29379210,516739197,901460,693796,517432993,478162438
29379210_693797,CM021100.1,1,29379210,516739197,901460,693797,517432994,478162439
29379615_716485,CM021100.1,1,29379615,516739379,1403694,716485,517455864,478185309
29379615_716533,CM021100.1,1,29379615,516739379,1403694,716533,517455912,478185357
29379615_716599,CM021100.1,1,29379615,516739379,1403694,716599,517455978,478185423
29379615_1012971,CM021100.1,1,29379615,516739379,1403694,1012971,517752350,478481795
29379615_1119739,CM021100.1,1,29379615,516739379,1403694,1119739,517859118,478588563
29339724_7082,CM021100.1,1,29339724,518969714,30014,7082,518976796,479706241
29339724_7101,CM021100.1,1,29339724,518969714,30014,7101,518976815,479706260
29381233_204,CM021100.1,1,29381233,518977295,3058790,204,518977499,479706944
29381233_229,CM021100.1,1,29381233,518977295,3058790,229,518977524,479706969
29378725_96444,CM021100.1,1,29378725,518899559,673864,96444,518996003,479725448
29378725_96536,CM021100.1,1,29378725,518899559,673864,96536,518996095,479725540
29378725_96697,CM021100.1,1,29378725,518899559,673864,96697,518996256,479725701
29369386_37299,CM021100.1,1,29369386,518969718,493582,37299,519007017,479736462
29369386_38820,CM021100.1,1,29369386,518969718,493582,38820,519008538,479737983
29369386_38831,CM021100.1,1,29369386,518969718,493582,38831,519008549,479737994
29369386_79703,CM021100.1,1,29369386,518969718,493582,79703,519049421,479778866
29369386_79721,CM021100.1,1,29369386,518969718,493582,79721,519049439,479778884
29369386_79741,CM021100.1,1,29369386,518969718,493582,79741,519049459,479778904
29369386_79747,CM021100.1,1,29369386,518969718,493582,79747,519049465,479778910
29381078_84349,CM021100.1,1,29381078,518977341,2828517,84349,519061690,479791135
29380249_131292,CM021100.1,1,29380249,518969716,1072218,131292,519101008,479830453
29380925_142168,CM021100.1,1,29380925,518976535,4126041,142168,519118703,479848148
29380925_142191,CM021100.1,1,29380925,518976535,4126041,142191,519118726,479848171
29380925_142200,CM021100.1,1,29380925,518976535,4126041,142200,519118735,479848180
29377670_165190,CM021100.1,1,29377670,518979149,3338542,165190,519144339,479873784
29381078_172167,CM021100.1,1,29381078,518977341,2828517,172167,519149508,479878953
29377186_184725,CM021100.1,1,29377186,518969708,227948,184725,519154433,479883878
29377186_184811,CM021100.1,1,29377186,518969708,227948,184811,519154519,479883964
29377186_184823,CM021100.1,1,29377186,518969708,227948,184823,519154531,479883976
29377186_184846,CM021100.1,1,29377186,518969708,227948,184846,519154554,479883999
29377186_184898,CM021100.1,1,29377186,518969708,227948,184898,519154606,479884051
29377186_184900,CM021100.1,1,29377186,518969708,227948,184900,519154608,479884053
29379987_263320,CM021100.1,1,29379987,518969714,684604,263320,519233034,479962479
29379987_263595,CM021100.1,1,29379987,518969714,684604,263595,519233309,479962754
29380713_264021,CM021100.1,1,29380713,518971288,1486945,264021,519235309,479964754
29379987_267187,CM021100.1,1,29379987,518969714,684604,267187,519236901,479966346
29379987_268487,CM021100.1,1,29379987,518969714,684604,268487,519238201,479967646
29379987_268582,CM021100.1,1,29379987,518969714,684604,268582,519238296,479967741
29379987_269095,CM021100.1,1,29379987,518969714,684604,269095,519238809,479968254
29378352_289031,CM021100.1,1,29378352,518977192,1836954,289031,519266223,479995668
29380222_301436,CM021100.1,1,29380222,518977521,3192630,301436,519278957,480008402
29380222_302694,CM021100.1,1,29380222,518977521,3192630,302694,519280215,480009660
29380222_302718,CM021100.1,1,29380222,518977521,3192630,302718,519280239,480009684
29380222_333685,CM021100.1,1,29380222,518977521,3192630,333685,519311206,480040651
29369386_353212,CM021100.1,1,29369386,518969718,493582,353212,519322930,480052375
29369386_353260,CM021100.1,1,29369386,518969718,493582,353260,519322978,480052423
29369386_353295,CM021100.1,1,29369386,518969718,493582,353295,519323013,480052458
29380925_362946,CM021100.1,1,29380925,518976535,4126041,362946,519339481,480068926
29380925_363968,CM021100.1,1,29380925,518976535,4126041,363968,519340503,480069948
29380925_363999,CM021100.1,1,29380925,518976535,4126041,363999,519340534,480069979
29378352_364552,CM021100.1,1,29378352,518977192,1836954,364552,519341744,480071189
29378352_364627,CM021100.1,1,29378352,518977192,1836954,364627,519341819,480071264
29369386_386850,CM021100.1,1,29369386,518969718,493582,386850,519356568,480086013
29378352_396346,CM021100.1,1,29378352,518977192,1836954,396346,519373538,480102983
29378352_396545,CM021100.1,1,29378352,518977192,1836954,396545,519373737,480103182
29378352_396573,CM021100.1,1,29378352,518977192,1836954,396573,519373765,480103210
29378352_396616,CM021100.1,1,29378352,518977192,1836954,396616,519373808,480103253
29379987_425989,CM021100.1,1,29379987,518969714,684604,425989,519395703,480125148
29379987_429121,CM021100.1,1,29379987,518969714,684604,429121,519398835,480128280
29379987_431360,CM021100.1,1,29379987,518969714,684604,431360,519401074,480130519
29379987_439929,CM021100.1,1,29379987,518969714,684604,439929,519409643,480139088
29379987_439981,CM021100.1,1,29379987,518969714,684604,439981,519409695,480139140
29379987_439982,CM021100.1,1,29379987,518969714,684604,439982,519409696,480139141
29379987_439987,CM021100.1,1,29379987,518969714,684604,439987,519409701,480139146
29379987_439988,CM021100.1,1,29379987,518969714,684604,439988,519409702,480139147
29379987_439989,CM021100.1,1,29379987,518969714,684604,439989,519409703,480139148
29379987_439990,CM021100.1,1,29379987,518969714,684604,439990,519409704,480139149
29379987_440021,CM021100.1,1,29379987,518969714,684604,440021,519409735,480139180
29381417_457213,CM021100.1,1,29381417,518980447,475404,457213,519437660,480167105
29381417_459037,CM021100.1,1,29381417,518980447,475404,459037,519439484,480168929
29381417_459127,CM021100.1,1,29381417,518980447,475404,459127,519439574,480169019
29381417_459287,CM021100.1,1,29381417,518980447,475404,459287,519439734,480169179
29381417_459361,CM021100.1,1,29381417,518980447,475404,459361,519439808,480169253
29381417_474513,CM021100.1,1,29381417,518980447,475404,474513,519454960,480184405
29379987_492741,CM021100.1,1,29379987,518969714,684604,492741,519462455,480191900
29378725_586521,CM021100.1,1,29378725,518899559,673864,586521,519486080,480215525
29378725_608562,CM021100.1,1,29378725,518899559,673864,608562,519508121,480237566
29378725_608636,CM021100.1,1,29378725,518899559,673864,608636,519508195,480237640
29377332_532774,CM021100.1,1,29377332,518977707,2703772,532774,519510481,480239926
29381618_560599,CM021100.1,1,29381618,518977631,962996,560599,519538230,480267675
29378693_562639,CM021100.1,1,29378693,518976510,996799,562639,519539149,480268594
29378693_562729,CM021100.1,1,29378693,518976510,996799,562729,519539239,480268684
29380249_574047,CM021100.1,1,29380249,518969716,1072218,574047,519543763,480273208
29380249_574048,CM021100.1,1,29380249,518969716,1072218,574048,519543764,480273209
29380249_574051,CM021100.1,1,29380249,518969716,1072218,574051,519543767,480273212
29380249_574054,CM021100.1,1,29380249,518969716,1072218,574054,519543770,480273215
29380249_574138,CM021100.1,1,29380249,518969716,1072218,574138,519543854,480273299
29378725_664133,CM021100.1,1,29378725,518899559,673864,664133,519563692,480293137
29378725_664143,CM021100.1,1,29378725,518899559,673864,664143,519563702,480293147
29377506_699765,CM021100.1,1,29377506,518977399,886159,699765,519677164,480406609
29377506_699933,CM021100.1,1,29377506,518977399,886159,699933,519677332,480406777
29377506_699944,CM021100.1,1,29377506,518977399,886159,699944,519677343,480406788
29378352_746531,CM021100.1,1,29378352,518977192,1836954,746531,519723723,480453168
29378352_746594,CM021100.1,1,29378352,518977192,1836954,746594,519723786,480453231
29378693_755218,CM021100.1,1,29378693,518976510,996799,755218,519731728,480461173
29378693_755240,CM021100.1,1,29378693,518976510,996799,755240,519731750,480461195
29378693_755241,CM021100.1,1,29378693,518976510,996799,755241,519731751,480461196
29379319_757507,CM021100.1,1,29379319,518977875,1165996,757507,519735382,480464827
29379319_757520,CM021100.1,1,29379319,518977875,1165996,757520,519735395,480464840
29379319_757546,CM021100.1,1,29379319,518977875,1165996,757546,519735421,480464866
29379319_757580,CM021100.1,1,29379319,518977875,1165996,757580,519735455,480464900
29379319_757597,CM021100.1,1,29379319,518977875,1165996,757597,519735472,480464917
29379319_757600,CM021100.1,1,29379319,518977875,1165996,757600,519735475,480464920
29380176_776878,CM021100.1,1,29380176,518972636,3023855,776878,519749514,480478959
29379319_792769,CM021100.1,1,29379319,518977875,1165996,792769,519770644,480500089
29379319_792853,CM021100.1,1,29379319,518977875,1165996,792853,519770728,480500173
29379319_793019,CM021100.1,1,29379319,518977875,1165996,793019,519770894,480500339
29379319_793023,CM021100.1,1,29379319,518977875,1165996,793023,519770898,480500343
29379319_793195,CM021100.1,1,29379319,518977875,1165996,793195,519771070,480500515
29380479_838931,CM021100.1,1,29380479,518969716,1495637,838931,519808647,480538092
29381233_839152,CM021100.1,1,29381233,518977295,3058790,839152,519816447,480545892
29381233_839189,CM021100.1,1,29381233,518977295,3058790,839189,519816484,480545929
29381233_839200,CM021100.1,1,29381233,518977295,3058790,839200,519816495,480545940
29381233_839209,CM021100.1,1,29381233,518977295,3058790,839209,519816504,480545949
29381233_839236,CM021100.1,1,29381233,518977295,3058790,839236,519816531,480545976
29381618_862436,CM021100.1,1,29381618,518977631,962996,862436,519840067,480569512
29378693_872207,CM021100.1,1,29378693,518976510,996799,872207,519848717,480578162
29378693_872215,CM021100.1,1,29378693,518976510,996799,872215,519848725,480578170
29378693_872217,CM021100.1,1,29378693,518976510,996799,872217,519848727,480578172
29378693_872299,CM021100.1,1,29378693,518976510,996799,872299,519848809,480578254
29378693_872312,CM021100.1,1,29378693,518976510,996799,872312,519848822,480578267
29379409_939441,CM021100.1,1,29379409,518969716,5056544,939441,519909157,480638602
29378693_972372,CM021100.1,1,29378693,518976510,996799,972372,519948882,480678327
29378693_972400,CM021100.1,1,29378693,518976510,996799,972400,519948910,480678355
29378693_972405,CM021100.1,1,29378693,518976510,996799,972405,519948915,480678360
29380713_1005649,CM021100.1,1,29380713,518971288,1486945,1005649,519976937,480706382
29380713_1005685,CM021100.1,1,29380713,518971288,1486945,1005685,519976973,480706418
29380713_1005700,CM021100.1,1,29380713,518971288,1486945,1005700,519976988,480706433
29380713_1005709,CM021100.1,1,29380713,518971288,1486945,1005709,519976997,480706442
29380713_1005723,CM021100.1,1,29380713,518971288,1486945,1005723,519977011,480706456
29380713_1005741,CM021100.1,1,29380713,518971288,1486945,1005741,519977029,480706474
29380713_1005745,CM021100.1,1,29380713,518971288,1486945,1005745,519977033,480706478
29380713_1005746,CM021100.1,1,29380713,518971288,1486945,1005746,519977034,480706479
29380713_1005754,CM021100.1,1,29380713,518971288,1486945,1005754,519977042,480706487
29380713_1005790,CM021100.1,1,29380713,518971288,1486945,1005790,519977078,480706523
29380713_1005802,CM021100.1,1,29380713,518971288,1486945,1005802,519977090,480706535
29380713_1005831,CM021100.1,1,29380713,518971288,1486945,1005831,519977119,480706564
29380713_1005853,CM021100.1,1,29380713,518971288,1486945,1005853,519977141,480706586
29380713_1005863,CM021100.1,1,29380713,518971288,1486945,1005863,519977151,480706596
29380713_1005881,CM021100.1,1,29380713,518971288,1486945,1005881,519977169,480706614
29380713_1006005,CM021100.1,1,29380713,518971288,1486945,1006005,519977293,480706738
29377855_1028017,CM021100.1,1,29377855,518976909,1796497,1028017,520004926,480734371
29377855_1028058,CM021100.1,1,29377855,518976909,1796497,1028058,520004967,480734412
29380925_1124009,CM021100.1,1,29380925,518976535,4126041,1124009,520100544,480829989
29380925_1139709,CM021100.1,1,29380925,518976535,4126041,1139709,520116244,480845689
29380925_1139727,CM021100.1,1,29380925,518976535,4126041,1139727,520116262,480845707
29380925_1147122,CM021100.1,1,29380925,518976535,4126041,1147122,520123657,480853102
29378352_1227190,CM021100.1,1,29378352,518977192,1836954,1227190,520204382,480933827
29378352_1228282,CM021100.1,1,29378352,518977192,1836954,1228282,520205474,480934919
29380925_1417650,CM021100.1,1,29380925,518976535,4126041,1417650,520394185,481123630
29380222_1421316,CM021100.1,1,29380222,518977521,3192630,1421316,520398837,481128282
29380222_1421359,CM021100.1,1,29380222,518977521,3192630,1421359,520398880,481128325
29380222_1421386,CM021100.1,1,29380222,518977521,3192630,1421386,520398907,481128352
29380222_1421408,CM021100.1,1,29380222,518977521,3192630,1421408,520398929,481128374
29378407_1450540,CM021100.1,1,29378407,518976556,5784153,1450540,520427096,481156541
29378407_1450611,CM021100.1,1,29378407,518976556,5784153,1450611,520427167,481156612
29378407_1450638,CM021100.1,1,29378407,518976556,5784153,1450638,520427194,481156639
29379409_1482803,CM021100.1,1,29379409,518969716,5056544,1482803,520452519,481181964
29379409_1482852,CM021100.1,1,29379409,518969716,5056544,1482852,520452568,481182013
29379409_1482878,CM021100.1,1,29379409,518969716,5056544,1482878,520452594,481182039
29379409_1482988,CM021100.1,1,29379409,518969716,5056544,1482988,520452704,481182149
29379409_1483019,CM021100.1,1,29379409,518969716,5056544,1483019,520452735,481182180
29379409_1493721,CM021100.1,1,29379409,518969716,5056544,1493721,520463437,481192882
29379409_1493829,CM021100.1,1,29379409,518969716,5056544,1493829,520463545,481192990
29379409_1496045,CM021100.1,1,29379409,518969716,5056544,1496045,520465761,481195206
29379409_1496082,CM021100.1,1,29379409,518969716,5056544,1496082,520465798,481195243
29379409_1504908,CM021100.1,1,29379409,518969716,5056544,1504908,520474624,481204069
29380176_1528190,CM021100.1,1,29380176,518972636,3023855,1528190,520500826,481230271
29380176_1532333,CM021100.1,1,29380176,518972636,3023855,1532333,520504969,481234414
29381403_1544275,CM021100.1,1,29381403,518969717,4318899,1544275,520513992,481243437
29381403_1544367,CM021100.1,1,29381403,518969717,4318899,1544367,520514084,481243529
29381403_1544766,CM021100.1,1,29381403,518969717,4318899,1544766,520514483,481243928
29381403_1546351,CM021100.1,1,29381403,518969717,4318899,1546351,520516068,481245513
29381403_1546426,CM021100.1,1,29381403,518969717,4318899,1546426,520516143,481245588
29381403_1546495,CM021100.1,1,29381403,518969717,4318899,1546495,520516212,481245657
29381403_1546657,CM021100.1,1,29381403,518969717,4318899,1546657,520516374,481245819
29379409_1591672,CM021100.1,1,29379409,518969716,5056544,1591672,520561388,481290833
29379409_1591811,CM021100.1,1,29379409,518969716,5056544,1591811,520561527,481290972
29379409_1592255,CM021100.1,1,29379409,518969716,5056544,1592255,520561971,481291416
29379409_1592287,CM021100.1,1,29379409,518969716,5056544,1592287,520562003,481291448
29379409_1592299,CM021100.1,1,29379409,518969716,5056544,1592299,520562015,481291460
29381233_1589335,CM021100.1,1,29381233,518977295,3058790,1589335,520566630,481296075
29381233_1589340,CM021100.1,1,29381233,518977295,3058790,1589340,520566635,481296080
29381233_1589345,CM021100.1,1,29381233,518977295,3058790,1589345,520566640,481296085
29381233_1589373,CM021100.1,1,29381233,518977295,3058790,1589373,520566668,481296113
29381233_1589381,CM021100.1,1,29381233,518977295,3058790,1589381,520566676,481296121
29379409_1600512,CM021100.1,1,29379409,518969716,5056544,1600512,520570228,481299673
29379409_1600595,CM021100.1,1,29379409,518969716,5056544,1600595,520570311,481299756
29379390_1687440,CM021100.1,1,29379390,518976085,3393578,1687440,520663525,481392970
29379390_1687496,CM021100.1,1,29379390,518976085,3393578,1687496,520663581,481393026
29379390_1687505,CM021100.1,1,29379390,518976085,3393578,1687505,520663590,481393035
29379390_1687511,CM021100.1,1,29379390,518976085,3393578,1687511,520663596,481393041
29379390_1687515,CM021100.1,1,29379390,518976085,3393578,1687515,520663600,481393045
29379390_1687517,CM021100.1,1,29379390,518976085,3393578,1687517,520663602,481393047
29379390_1687526,CM021100.1,1,29379390,518976085,3393578,1687526,520663611,481393056
29382201_1764762,CM021100.1,1,29382201,518969716,2058825,1764762,520734478,481463923
29382201_1764837,CM021100.1,1,29382201,518969716,2058825,1764837,520734553,481463998
29382201_1764890,CM021100.1,1,29382201,518969716,2058825,1764890,520734606,481464051
29382201_1764921,CM021100.1,1,29382201,518969716,2058825,1764921,520734637,481464082
29379409_1907308,CM021100.1,1,29379409,518969716,5056544,1907308,520877024,481606469
29379409_1907408,CM021100.1,1,29379409,518969716,5056544,1907408,520877124,481606569
29379409_1907453,CM021100.1,1,29379409,518969716,5056544,1907453,520877169,481606614
29379409_1907733,CM021100.1,1,29379409,518969716,5056544,1907733,520877449,481606894
29381233_1932472,CM021100.1,1,29381233,518977295,3058790,1932472,520909767,481639212
29381233_1932528,CM021100.1,1,29381233,518977295,3058790,1932528,520909823,481639268
29379409_1965391,CM021100.1,1,29379409,518969716,5056544,1965391,520935107,481664552
29379409_1965432,CM021100.1,1,29379409,518969716,5056544,1965432,520935148,481664593
29379409_1965494,CM021100.1,1,29379409,518969716,5056544,1965494,520935210,481664655
29379409_1986139,CM021100.1,1,29379409,518969716,5056544,1986139,520955855,481685300
29379409_1986207,CM021100.1,1,29379409,518969716,5056544,1986207,520955923,481685368
29379409_1986214,CM021100.1,1,29379409,518969716,5056544,1986214,520955930,481685375
29379409_1986227,CM021100.1,1,29379409,518969716,5056544,1986227,520955943,481685388
29379409_1986239,CM021100.1,1,29379409,518969716,5056544,1986239,520955955,481685400
29379409_1986255,CM021100.1,1,29379409,518969716,5056544,1986255,520955971,481685416
29379409_1986259,CM021100.1,1,29379409,518969716,5056544,1986259,520955975,481685420
29378407_1979660,CM021100.1,1,29378407,518976556,5784153,1979660,520956216,481685661
29378407_1979785,CM021100.1,1,29378407,518976556,5784153,1979785,520956341,481685786
29378407_1979803,CM021100.1,1,29378407,518976556,5784153,1979803,520956359,481685804
29378407_1979815,CM021100.1,1,29378407,518976556,5784153,1979815,520956371,481685816
29378407_1979819,CM021100.1,1,29378407,518976556,5784153,1979819,520956375,481685820
29380925_1992757,CM021100.1,1,29380925,518976535,4126041,1992757,520969292,481698737
29380925_1992814,CM021100.1,1,29380925,518976535,4126041,1992814,520969349,481698794
29379409_2012880,CM021100.1,1,29379409,518969716,5056544,2012880,520982596,481712041
29379409_2012935,CM021100.1,1,29379409,518969716,5056544,2012935,520982651,481712096
29379409_2025297,CM021100.1,1,29379409,518969716,5056544,2025297,520995013,481724458
29380780_2091007,CM021100.1,1,29380780,518976573,4402869,2091007,521067580,481797025
29380176_2110326,CM021100.1,1,29380176,518972636,3023855,2110326,521082962,481812407
29379802_2152039,CM021100.1,1,29379802,518976856,2177959,2152039,521128895,481858340
29379802_2152306,CM021100.1,1,29379802,518976856,2177959,2152306,521129162,481858607
29378485_2176396,CM021100.1,1,29378485,518977466,8672982,2176396,521153862,481883307
29378485_2176491,CM021100.1,1,29378485,518977466,8672982,2176491,521153957,481883402
29381077_2392487,CM021100.1,1,29381077,518969713,2700588,2392487,521362200,482091645
29379409_2479217,CM021100.1,1,29379409,518969716,5056544,2479217,521448933,482178378
29379409_2479218,CM021100.1,1,29379409,518969716,5056544,2479218,521448934,482178379
29379409_2570377,CM021100.1,1,29379409,518969716,5056544,2570377,521540093,482269538
29381403_2589251,CM021100.1,1,29381403,518969717,4318899,2589251,521558968,482288413
29381403_2589338,CM021100.1,1,29381403,518969717,4318899,2589338,521559055,482288500
29381403_2589396,CM021100.1,1,29381403,518969717,4318899,2589396,521559113,482288558
29381403_2589505,CM021100.1,1,29381403,518969717,4318899,2589505,521559222,482288667
29381403_2593308,CM021100.1,1,29381403,518969717,4318899,2593308,521563025,482292470
29381403_2593331,CM021100.1,1,29381403,518969717,4318899,2593331,521563048,482292493
29381403_2600472,CM021100.1,1,29381403,518969717,4318899,2600472,521570189,482299634
29381403_2618413,CM021100.1,1,29381403,518969717,4318899,2618413,521588130,482317575
29379390_2811759,CM021100.1,1,29379390,518976085,3393578,2811759,521787844,482517289
29379390_2813695,CM021100.1,1,29379390,518976085,3393578,2813695,521789780,482519225
29380176_2991077,CM021100.1,1,29380176,518972636,3023855,2991077,521963713,482693158
29379409_3253190,CM021100.1,1,29379409,518969716,5056544,3253190,522222906,482952351
29379409_3253204,CM021100.1,1,29379409,518969716,5056544,3253204,522222920,482952365
29379409_3253205,CM021100.1,1,29379409,518969716,5056544,3253205,522222921,482952366
29379409_3253222,CM021100.1,1,29379409,518969716,5056544,3253222,522222938,482952383
29379409_3253263,CM021100.1,1,29379409,518969716,5056544,3253263,522222979,482952424
29379409_3253272,CM021100.1,1,29379409,518969716,5056544,3253272,522222988,482952433
29379409_3253273,CM021100.1,1,29379409,518969716,5056544,3253273,522222989,482952434
29379409_3253280,CM021100.1,1,29379409,518969716,5056544,3253280,522222996,482952441
29379409_3253655,CM021100.1,1,29379409,518969716,5056544,3253655,522223371,482952816
29381403_3327897,CM021100.1,1,29381403,518969717,4318899,3327897,522297614,483027059
29381403_3327906,CM021100.1,1,29381403,518969717,4318899,3327906,522297623,483027068
29381403_3327943,CM021100.1,1,29381403,518969717,4318899,3327943,522297660,483027105
29381403_3328762,CM021100.1,1,29381403,518969717,4318899,3328762,522298479,483027924
29379409_3974672,CM021100.1,1,29379409,518969716,5056544,3974672,522944388,483673833
29378485_3990782,CM021100.1,1,29378485,518977466,8672982,3990782,522968248,483697693
29378485_3990875,CM021100.1,1,29378485,518977466,8672982,3990875,522968341,483697786
29378485_3991056,CM021100.1,1,29378485,518977466,8672982,3991056,522968522,483697967
29378485_4218791,CM021100.1,1,29378485,518977466,8672982,4218791,523196257,483925702
29378485_4365975,CM021100.1,1,29378485,518977466,8672982,4365975,523343441,484072886
29378485_4366042,CM021100.1,1,29378485,518977466,8672982,4366042,523343508,484072953
29378485_4366060,CM021100.1,1,29378485,518977466,8672982,4366060,523343526,484072971
29378407_4549350,CM021100.1,1,29378407,518976556,5784153,4549350,523525906,484255351
29378407_4549393,CM021100.1,1,29378407,518976556,5784153,4549393,523525949,484255394
29378407_4549427,CM021100.1,1,29378407,518976556,5784153,4549427,523525983,484255428
29378407_4598128,CM021100.1,1,29378407,518976556,5784153,4598128,523574684,484304129
29378407_4598144,CM021100.1,1,29378407,518976556,5784153,4598144,523574700,484304145
29379409_4793268,CM021100.1,1,29379409,518969716,5056544,4793268,523762984,484492429
29379409_4793377,CM021100.1,1,29379409,518969716,5056544,4793377,523763093,484492538
29379409_4793392,CM021100.1,1,29379409,518969716,5056544,4793392,523763108,484492553
29378485_4897247,CM021100.1,1,29378485,518977466,8672982,4897247,523874713,484604158
29378407_5684174,CM021100.1,1,29378407,518976556,5784153,5684174,524660730,485390175
29378485_6004870,CM021100.1,1,29378485,518977466,8672982,6004870,524982336,485711781
29378485_6004873,CM021100.1,1,29378485,518977466,8672982,6004873,524982339,485711784
29378485_6004874,CM021100.1,1,29378485,518977466,8672982,6004874,524982340,485711785
29378485_6021144,CM021100.1,1,29378485,518977466,8672982,6021144,524998610,485728055
29378485_6655234,CM021100.1,1,29378485,518977466,8672982,6655234,525632700,486362145
29378485_6655999,CM021100.1,1,29378485,518977466,8672982,6655999,525633465,486362910
29378485_7152485,CM021100.1,1,29378485,518977466,8672982,7152485,526129951,486859396
29378485_7152494,CM021100.1,1,29378485,518977466,8672982,7152494,526129960,486859405
29378485_7196603,CM021100.1,1,29378485,518977466,8672982,7196603,526174069,486903514
29378485_7196614,CM021100.1,1,29378485,518977466,8672982,7196614,526174080,486903525
29378485_7409455,CM021100.1,1,29378485,518977466,8672982,7409455,526386921,487116366
29378485_7409489,CM021100.1,1,29378485,518977466,8672982,7409489,526386955,487116400
29378485_7409492,CM021100.1,1,29378485,518977466,8672982,7409492,526386958,487116403
29378485_7409550,CM021100.1,1,29378485,518977466,8672982,7409550,526387016,487116461
29378485_7409740,CM021100.1,1,29378485,518977466,8672982,7409740,526387206,487116651
29378485_7409780,CM021100.1,1,29378485,518977466,8672982,7409780,526387246,487116691
29378485_7409817,CM021100.1,1,29378485,518977466,8672982,7409817,526387283,487116728
29378485_7434999,CM021100.1,1,29378485,518977466,8672982,7434999,526412465,487141910
29378485_7435395,CM021100.1,1,29378485,518977466,8672982,7435395,526412861,487142306
29378485_7435420,CM021100.1,1,29378485,518977466,8672982,7435420,526412886,487142331
29378485_7435530,CM021100.1,1,29378485,518977466,8672982,7435530,526412996,487142441
29378485_7522419,CM021100.1,1,29378485,518977466,8672982,7522419,526499885,487229330
29378485_7522518,CM021100.1,1,29378485,518977466,8672982,7522518,526499984,487229429
29378485_7522632,CM021100.1,1,29378485,518977466,8672982,7522632,526500098,487229543
29378485_7523412,CM021100.1,1,29378485,518977466,8672982,7523412,526500878,487230323
29378485_7523417,CM021100.1,1,29378485,518977466,8672982,7523417,526500883,487230328
29378485_7523497,CM021100.1,1,29378485,518977466,8672982,7523497,526500963,487230408
29378485_7584822,CM021100.1,1,29378485,518977466,8672982,7584822,526562288,487291733
29378485_7585038,CM021100.1,1,29378485,518977466,8672982,7585038,526562504,487291949
29378485_7585137,CM021100.1,1,29378485,518977466,8672982,7585137,526562603,487292048
29378849_20211,CM021100.1,1,29378849,526671251,695689,20211,526691462,487420907
29377601_46461,CM021100.1,1,29377601,526672467,262768,46461,526718928,487448373
29377601_46464,CM021100.1,1,29377601,526672467,262768,46464,526718931,487448376
29378485_7775748,CM021100.1,1,29378485,518977466,8672982,7775748,526753214,487482659
29381492_90804,CM021100.1,1,29381492,526671996,4455684,90804,526762800,487492245
29381492_90806,CM021100.1,1,29381492,526671996,4455684,90806,526762802,487492247
29381492_90835,CM021100.1,1,29381492,526671996,4455684,90835,526762831,487492276
29381492_90841,CM021100.1,1,29381492,526671996,4455684,90841,526762837,487492282
29381492_90842,CM021100.1,1,29381492,526671996,4455684,90842,526762838,487492283
29381492_90869,CM021100.1,1,29381492,526671996,4455684,90869,526762865,487492310
29381492_90940,CM021100.1,1,29381492,526671996,4455684,90940,526762936,487492381
29378485_7825381,CM021100.1,1,29378485,518977466,8672982,7825381,526802847,487532292
29378485_7825486,CM021100.1,1,29378485,518977466,8672982,7825486,526802952,487532397
29380276_190773,CM021100.1,1,29380276,526672426,1519951,190773,526863199,487592644
29380276_190782,CM021100.1,1,29380276,526672426,1519951,190782,526863208,487592653
29380276_190799,CM021100.1,1,29380276,526672426,1519951,190799,526863225,487592670
29380276_190828,CM021100.1,1,29380276,526672426,1519951,190828,526863254,487592699
29380276_190830,CM021100.1,1,29380276,526672426,1519951,190830,526863256,487592701
29380276_190831,CM021100.1,1,29380276,526672426,1519951,190831,526863257,487592702
29378169_194057,CM021100.1,1,29378169,526671251,2905960,194057,526865308,487594753
29377601_228230,CM021100.1,1,29377601,526672467,262768,228230,526900697,487630142
29382428_254851,CM021100.1,1,29382428,526672022,2653669,254851,526926873,487656318
29377786_267424,CM021100.1,1,29377786,526671250,882347,267424,526938674,487668119
29382428_282581,CM021100.1,1,29382428,526672022,2653669,282581,526954603,487684048
29382428_282642,CM021100.1,1,29382428,526672022,2653669,282642,526954664,487684109
29382428_283086,CM021100.1,1,29382428,526672022,2653669,283086,526955108,487684553
29382428_283112,CM021100.1,1,29382428,526672022,2653669,283112,526955134,487684579
29377258_302245,CM021100.1,1,29377258,526671250,751963,302245,526973495,487702940
29379112_300212,CM021100.1,1,29379112,526674518,1131017,300212,526974730,487704175
29379112_300213,CM021100.1,1,29379112,526674518,1131017,300213,526974731,487704176
29379112_300328,CM021100.1,1,29379112,526674518,1131017,300328,526974846,487704291
29382428_342465,CM021100.1,1,29382428,526672022,2653669,342465,527014487,487743932
29378485_8050199,CM021100.1,1,29378485,518977466,8672982,8050199,527027665,487757110
29378485_8050204,CM021100.1,1,29378485,518977466,8672982,8050204,527027670,487757115
29378485_8050525,CM021100.1,1,29378485,518977466,8672982,8050525,527027991,487757436
29378485_8054612,CM021100.1,1,29378485,518977466,8672982,8054612,527032078,487761523
29379251_590473,CM021100.1,1,29379251,526671251,635444,590473,527261724,487991169
29379251_590566,CM021100.1,1,29379251,526671251,635444,590566,527261817,487991262
29379251_590668,CM021100.1,1,29379251,526671251,635444,590668,527261919,487991364
29378169_636195,CM021100.1,1,29378169,526671251,2905960,636195,527307446,488036891
29378169_636319,CM021100.1,1,29378169,526671251,2905960,636319,527307570,488037015
29378485_8380450,CM021100.1,1,29378485,518977466,8672982,8380450,527357916,488087361
29378485_8380460,CM021100.1,1,29378485,518977466,8672982,8380460,527357926,488087371
29378485_8380462,CM021100.1,1,29378485,518977466,8672982,8380462,527357928,488087373
29378485_8380518,CM021100.1,1,29378485,518977466,8672982,8380518,527357984,488087429
29380178_822250,CM021100.1,1,29380178,526671250,1920166,822250,527493500,488222945
29382428_839786,CM021100.1,1,29382428,526672022,2653669,839786,527511808,488241253
29382428_872778,CM021100.1,1,29382428,526672022,2653669,872778,527544800,488274245
29382428_872814,CM021100.1,1,29382428,526672022,2653669,872814,527544836,488274281
29382428_877394,CM021100.1,1,29382428,526672022,2653669,877394,527549416,488278861
29382428_894307,CM021100.1,1,29382428,526672022,2653669,894307,527566329,488295774
29379238_908593,CM021100.1,1,29379238,526671253,8925528,908593,527579846,488309291
29380300_942976,CM021100.1,1,29380300,526671253,2586855,942976,527614229,488343674
29380300_943354,CM021100.1,1,29380300,526671253,2586855,943354,527614607,488344052
29380300_943988,CM021100.1,1,29380300,526671253,2586855,943988,527615241,488344686
29380276_969285,CM021100.1,1,29380276,526672426,1519951,969285,527641711,488371156
29378536_1567705,CM021100.1,1,29378536,526671251,2282539,1567705,528238956,488968401
29378536_1567797,CM021100.1,1,29378536,526671251,2282539,1567797,528239048,488968493
29378536_1567876,CM021100.1,1,29378536,526671251,2282539,1567876,528239127,488968572
29378536_1567904,CM021100.1,1,29378536,526671251,2282539,1567904,528239155,488968600
29378536_1767307,CM021100.1,1,29378536,526671251,2282539,1767307,528438558,489168003
29381492_1842175,CM021100.1,1,29381492,526671996,4455684,1842175,528514171,489243616
29381492_1842241,CM021100.1,1,29381492,526671996,4455684,1842241,528514237,489243682
29379116_2040281,CM021100.1,1,29379116,526671251,4751294,2040281,528711532,489440977
29379116_2040336,CM021100.1,1,29379116,526671251,4751294,2040336,528711587,489441032
29379116_2042256,CM021100.1,1,29379116,526671251,4751294,2042256,528713507,489442952
29379116_2042342,CM021100.1,1,29379116,526671251,4751294,2042342,528713593,489443038
29379027_2103347,CM021100.1,1,29379027,526672221,2400304,2103347,528775568,489505013
29379027_2103436,CM021100.1,1,29379027,526672221,2400304,2103436,528775657,489505102
29378169_2150864,CM021100.1,1,29378169,526671251,2905960,2150864,528822115,489551560
29380226_2156959,CM021100.1,1,29380226,526671251,3206650,2156959,528828210,489557655
29378169_2470934,CM021100.1,1,29378169,526671251,2905960,2470934,529142185,489871630
29378169_2470941,CM021100.1,1,29378169,526671251,2905960,2470941,529142192,489871637
29378169_2470953,CM021100.1,1,29378169,526671251,2905960,2470953,529142204,489871649
29378169_2471065,CM021100.1,1,29378169,526671251,2905960,2471065,529142316,489871761
29378169_2515012,CM021100.1,1,29378169,526671251,2905960,2515012,529186263,489915708
29378169_2515043,CM021100.1,1,29378169,526671251,2905960,2515043,529186294,489915739
29378169_2515045,CM021100.1,1,29378169,526671251,2905960,2515045,529186296,489915741
29378169_2573515,CM021100.1,1,29378169,526671251,2905960,2573515,529244766,489974211
29378169_2573516,CM021100.1,1,29378169,526671251,2905960,2573516,529244767,489974212
29378169_2573539,CM021100.1,1,29378169,526671251,2905960,2573539,529244790,489974235
29378169_2573588,CM021100.1,1,29378169,526671251,2905960,2573588,529244839,489974284
29378169_2573605,CM021100.1,1,29378169,526671251,2905960,2573605,529244856,489974301
29378169_2573871,CM021100.1,1,29378169,526671251,2905960,2573871,529245122,489974567
29378169_2573882,CM021100.1,1,29378169,526671251,2905960,2573882,529245133,489974578
29382428_2579125,CM021100.1,1,29382428,526672022,2653669,2579125,529251147,489980592
29382428_2615489,CM021100.1,1,29382428,526672022,2653669,2615489,529287511,490016956
29380226_3027946,CM021100.1,1,29380226,526671251,3206650,3027946,529699197,490428642
29380226_3205728,CM021100.1,1,29380226,526671251,3206650,3205728,529876979,490606424
29380226_3205754,CM021100.1,1,29380226,526671251,3206650,3205754,529877005,490606450
29377610_3579925,CM021100.1,1,29377610,526671251,4756780,3579925,530251176,490980621
29377610_3581786,CM021100.1,1,29377610,526671251,4756780,3581786,530253037,490982482
29377610_3581859,CM021100.1,1,29377610,526671251,4756780,3581859,530253110,490982555
29377610_3676549,CM021100.1,1,29377610,526671251,4756780,3676549,530347800,491077245
29377610_3676590,CM021100.1,1,29377610,526671251,4756780,3676590,530347841,491077286
29377610_3676595,CM021100.1,1,29377610,526671251,4756780,3676595,530347846,491077291
29377610_3676619,CM021100.1,1,29377610,526671251,4756780,3676619,530347870,491077315
29377720_3962466,CM021100.1,1,29377720,526672394,4463417,3962466,530634860,491364305
29377610_4029228,CM021100.1,1,29377610,526671251,4756780,4029228,530700479,491429924
29377610_4029335,CM021100.1,1,29377610,526671251,4756780,4029335,530700586,491430031
29377610_4029337,CM021100.1,1,29377610,526671251,4756780,4029337,530700588,491430033
29379116_4049131,CM021100.1,1,29379116,526671251,4751294,4049131,530720382,491449827
29379238_4082766,CM021100.1,1,29379238,526671253,8925528,4082766,530754019,491483464
29379238_4082780,CM021100.1,1,29379238,526671253,8925528,4082780,530754033,491483478
29379238_4082790,CM021100.1,1,29379238,526671253,8925528,4082790,530754043,491483488
29379238_4082797,CM021100.1,1,29379238,526671253,8925528,4082797,530754050,491483495
29379238_4082815,CM021100.1,1,29379238,526671253,8925528,4082815,530754068,491483513
29379238_4082822,CM021100.1,1,29379238,526671253,8925528,4082822,530754075,491483520
29379238_4082828,CM021100.1,1,29379238,526671253,8925528,4082828,530754081,491483526
29377610_4127378,CM021100.1,1,29377610,526671251,4756780,4127378,530798629,491528074
29377610_4127392,CM021100.1,1,29377610,526671251,4756780,4127392,530798643,491528088
29379116_4678060,CM021100.1,1,29379116,526671251,4751294,4678060,531349311,492078756
29379116_4678078,CM021100.1,1,29379116,526671251,4751294,4678078,531349329,492078774
29379116_4678090,CM021100.1,1,29379116,526671251,4751294,4678090,531349341,492078786
29379116_4678093,CM021100.1,1,29379116,526671251,4751294,4678093,531349344,492078789
29379238_5230866,CM021100.1,1,29379238,526671253,8925528,5230866,531902119,492631564
29379238_6934880,CM021100.1,1,29379238,526671253,8925528,6934880,533606133,494335578
29379238_6935062,CM021100.1,1,29379238,526671253,8925528,6935062,533606315,494335760
29379238_6935087,CM021100.1,1,29379238,526671253,8925528,6935087,533606340,494335785
29378187_10927,CM021100.1,1,29378187,558874171,3004208,10927,558885098,519614543
29379789_12175,CM021100.1,1,29379789,558873907,1174571,12175,558886082,519615527
29380020_60311,CM021100.1,1,29380020,558873907,1848955,60311,558934218,519663663
29380020_60341,CM021100.1,1,29380020,558873907,1848955,60341,558934248,519663693
29380020_60397,CM021100.1,1,29380020,558873907,1848955,60397,558934304,519663749
29380020_60445,CM021100.1,1,29380020,558873907,1848955,60445,558934352,519663797
29380661_69734,CM021100.1,1,29380661,558873907,291876,69734,558943641,519673086
29381067_70185,CM021100.1,1,29381067,558874701,1707120,70185,558944886,519674331
29381067_70256,CM021100.1,1,29381067,558874701,1707120,70256,558944957,519674402
29381067_70274,CM021100.1,1,29381067,558874701,1707120,70274,558944975,519674420
29381067_70285,CM021100.1,1,29381067,558874701,1707120,70285,558944986,519674431
29381067_70293,CM021100.1,1,29381067,558874701,1707120,70293,558944994,519674439
29381067_70327,CM021100.1,1,29381067,558874701,1707120,70327,558945028,519674473
29381067_70352,CM021100.1,1,29381067,558874701,1707120,70352,558945053,519674498
29381067_70387,CM021100.1,1,29381067,558874701,1707120,70387,558945088,519674533
29380020_79610,CM021100.1,1,29380020,558873907,1848955,79610,558953517,519682962
29380020_79635,CM021100.1,1,29380020,558873907,1848955,79635,558953542,519682987
29380020_79651,CM021100.1,1,29380020,558873907,1848955,79651,558953558,519683003
29380020_79708,CM021100.1,1,29380020,558873907,1848955,79708,558953615,519683060
29380020_81371,CM021100.1,1,29380020,558873907,1848955,81371,558955278,519684723
29380020_81395,CM021100.1,1,29380020,558873907,1848955,81395,558955302,519684747
29380020_81444,CM021100.1,1,29380020,558873907,1848955,81444,558955351,519684796
29380020_81457,CM021100.1,1,29380020,558873907,1848955,81457,558955364,519684809
29380020_81481,CM021100.1,1,29380020,558873907,1848955,81481,558955388,519684833
29380020_81537,CM021100.1,1,29380020,558873907,1848955,81537,558955444,519684889
29380020_81566,CM021100.1,1,29380020,558873907,1848955,81566,558955473,519684918
29379253_91029,CM021100.1,1,29379253,558874500,1313771,91029,558965529,519694974
29381535_96444,CM021100.1,1,29381535,558873907,4359594,96444,558970351,519699796
29381535_96526,CM021100.1,1,29381535,558873907,4359594,96526,558970433,519699878
29379789_97275,CM021100.1,1,29379789,558873907,1174571,97275,558971182,519700627
29381393_97243,CM021100.1,1,29381393,558874026,2050493,97243,558971269,519700714
29381535_98172,CM021100.1,1,29381535,558873907,4359594,98172,558972079,519701524
29377090_96990,CM021100.1,1,29377090,558876040,419919,96990,558973030,519702475
29377090_96998,CM021100.1,1,29377090,558876040,419919,96998,558973038,519702483
29377090_97004,CM021100.1,1,29377090,558876040,419919,97004,558973044,519702489
29377090_97028,CM021100.1,1,29377090,558876040,419919,97028,558973068,519702513
29377090_97045,CM021100.1,1,29377090,558876040,419919,97045,558973085,519702530
29377090_97064,CM021100.1,1,29377090,558876040,419919,97064,558973104,519702549
29377090_97071,CM021100.1,1,29377090,558876040,419919,97071,558973111,519702556
29377090_97077,CM021100.1,1,29377090,558876040,419919,97077,558973117,519702562
29377090_97081,CM021100.1,1,29377090,558876040,419919,97081,558973121,519702566
29377090_97148,CM021100.1,1,29377090,558876040,419919,97148,558973188,519702633
29377090_97154,CM021100.1,1,29377090,558876040,419919,97154,558973194,519702639
29377090_97166,CM021100.1,1,29377090,558876040,419919,97166,558973206,519702651
29377090_97205,CM021100.1,1,29377090,558876040,419919,97205,558973245,519702690
29377090_97208,CM021100.1,1,29377090,558876040,419919,97208,558973248,519702693
29377090_97217,CM021100.1,1,29377090,558876040,419919,97217,558973257,519702702
29377090_97273,CM021100.1,1,29377090,558876040,419919,97273,558973313,519702758
29381608_103073,CM021100.1,1,29381608,558876438,747832,103073,558979511,519708956
29379115_114251,CM021100.1,1,29379115,558873907,1170569,114251,558988158,519717603
29382050_118415,CM021100.1,1,29382050,558873905,4031876,118415,558992320,519721765
29382050_118588,CM021100.1,1,29382050,558873905,4031876,118588,558992493,519721938
29379727_218747,CM021100.1,1,29379727,558873907,355583,218747,559092654,519822099
29379727_218778,CM021100.1,1,29379727,558873907,355583,218778,559092685,519822130
29379727_218852,CM021100.1,1,29379727,558873907,355583,218852,559092759,519822204
29379727_218877,CM021100.1,1,29379727,558873907,355583,218877,559092784,519822229
29379727_218995,CM021100.1,1,29379727,558873907,355583,218995,559092902,519822347
29377090_236425,CM021100.1,1,29377090,558876040,419919,236425,559112465,519841910
29377090_236446,CM021100.1,1,29377090,558876040,419919,236446,559112486,519841931
29377574_250476,CM021100.1,1,29377574,558873907,1492694,250476,559124383,519853828
29377574_250479,CM021100.1,1,29377574,558873907,1492694,250479,559124386,519853831
29377574_250516,CM021100.1,1,29377574,558873907,1492694,250516,559124423,519853868
29377574_250520,CM021100.1,1,29377574,558873907,1492694,250520,559124427,519853872
29377574_250682,CM021100.1,1,29377574,558873907,1492694,250682,559124589,519854034
29381067_255602,CM021100.1,1,29381067,558874701,1707120,255602,559130303,519859748
29381067_255708,CM021100.1,1,29381067,558874701,1707120,255708,559130409,519859854
29381067_255727,CM021100.1,1,29381067,558874701,1707120,255727,559130428,519859873
29382435_267939,CM021100.1,1,29382435,558873907,293104,267939,559141846,519871291
29379789_284327,CM021100.1,1,29379789,558873907,1174571,284327,559158234,519887679
29379789_284374,CM021100.1,1,29379789,558873907,1174571,284374,559158281,519887726
29379789_286420,CM021100.1,1,29379789,558873907,1174571,286420,559160327,519889772
29379789_286422,CM021100.1,1,29379789,558873907,1174571,286422,559160329,519889774
29379789_286434,CM021100.1,1,29379789,558873907,1174571,286434,559160341,519889786
29379789_286452,CM021100.1,1,29379789,558873907,1174571,286452,559160359,519889804
29379789_286482,CM021100.1,1,29379789,558873907,1174571,286482,559160389,519889834
29379789_286489,CM021100.1,1,29379789,558873907,1174571,286489,559160396,519889841
29379789_286507,CM021100.1,1,29379789,558873907,1174571,286507,559160414,519889859
29379789_286547,CM021100.1,1,29379789,558873907,1174571,286547,559160454,519889899
29379789_286554,CM021100.1,1,29379789,558873907,1174571,286554,559160461,519889906
29379789_286573,CM021100.1,1,29379789,558873907,1174571,286573,559160480,519889925
29380255_290021,CM021100.1,1,29380255,558875658,1596080,290021,559165679,519895124
29380255_290026,CM021100.1,1,29380255,558875658,1596080,290026,559165684,519895129
29380255_290055,CM021100.1,1,29380255,558875658,1596080,290055,559165713,519895158
29381896_292968,CM021100.1,1,29381896,558875752,501984,292968,559168720,519898165
29380978_319306,CM021100.1,1,29380978,558873906,2120650,319306,559193212,519922657
29377354_342009,CM021100.1,1,29377354,558876946,1568476,342009,559218955,519948400
29378883_347813,CM021100.1,1,29378883,558873907,543990,347813,559221720,519951165
29378883_347829,CM021100.1,1,29378883,558873907,543990,347829,559221736,519951181
29342720_370155,CM021100.1,1,29342720,558876635,535342,370155,559246790,519976235
29342720_370160,CM021100.1,1,29342720,558876635,535342,370160,559246795,519976240
29342720_370166,CM021100.1,1,29342720,558876635,535342,370166,559246801,519976246
29342720_370226,CM021100.1,1,29342720,558876635,535342,370226,559246861,519976306
29342720_370269,CM021100.1,1,29342720,558876635,535342,370269,559246904,519976349
29342720_370279,CM021100.1,1,29342720,558876635,535342,370279,559246914,519976359
29379789_373598,CM021100.1,1,29379789,558873907,1174571,373598,559247505,519976950
29379789_373756,CM021100.1,1,29379789,558873907,1174571,373756,559247663,519977108
29379789_373764,CM021100.1,1,29379789,558873907,1174571,373764,559247671,519977116
29379789_373770,CM021100.1,1,29379789,558873907,1174571,373770,559247677,519977122
29342720_371930,CM021100.1,1,29342720,558876635,535342,371930,559248565,519978010
29378187_390852,CM021100.1,1,29378187,558874171,3004208,390852,559265023,519994468
29378187_390908,CM021100.1,1,29378187,558874171,3004208,390908,559265079,519994524
29379789_406326,CM021100.1,1,29379789,558873907,1174571,406326,559280233,520009678
29381087_430717,CM021100.1,1,29381087,558873910,3640888,430717,559304627,520034072
29380114_452428,CM021100.1,1,29380114,558873910,10181246,452428,559326338,520055783
29380114_452451,CM021100.1,1,29380114,558873910,10181246,452451,559326361,520055806
29380114_452453,CM021100.1,1,29380114,558873910,10181246,452453,559326363,520055808
29380114_452478,CM021100.1,1,29380114,558873910,10181246,452478,559326388,520055833
29380114_452480,CM021100.1,1,29380114,558873910,10181246,452480,559326390,520055835
29381896_459895,CM021100.1,1,29381896,558875752,501984,459895,559335647,520065092
29381896_459907,CM021100.1,1,29381896,558875752,501984,459907,559335659,520065104
29381896_459940,CM021100.1,1,29381896,558875752,501984,459940,559335692,520065137
29379284_465396,CM021100.1,1,29379284,558873907,862568,465396,559339303,520068748
29379284_465399,CM021100.1,1,29379284,558873907,862568,465399,559339306,520068751
29377354_466844,CM021100.1,1,29377354,558876946,1568476,466844,559343790,520073235
29377354_466868,CM021100.1,1,29377354,558876946,1568476,466868,559343814,520073259
29377354_466887,CM021100.1,1,29377354,558876946,1568476,466887,559343833,520073278
29377354_466948,CM021100.1,1,29377354,558876946,1568476,466948,559343894,520073339
29377354_467094,CM021100.1,1,29377354,558876946,1568476,467094,559344040,520073485
29377354_467108,CM021100.1,1,29377354,558876946,1568476,467108,559344054,520073499
29381087_484651,CM021100.1,1,29381087,558873910,3640888,484651,559358561,520088006
29379789_518276,CM021100.1,1,29379789,558873907,1174571,518276,559392183,520121628
29379789_518302,CM021100.1,1,29379789,558873907,1174571,518302,559392209,520121654
29379789_518312,CM021100.1,1,29379789,558873907,1174571,518312,559392219,520121664
29379789_518354,CM021100.1,1,29379789,558873907,1174571,518354,559392261,520121706
29380255_524916,CM021100.1,1,29380255,558875658,1596080,524916,559400574,520130019
29380255_524944,CM021100.1,1,29380255,558875658,1596080,524944,559400602,520130047
29380255_524972,CM021100.1,1,29380255,558875658,1596080,524972,559400630,520130075
29380255_524991,CM021100.1,1,29380255,558875658,1596080,524991,559400649,520130094
29380255_525037,CM021100.1,1,29380255,558875658,1596080,525037,559400695,520130140
29380255_525060,CM021100.1,1,29380255,558875658,1596080,525060,559400718,520130163
29381067_579270,CM021100.1,1,29381067,558874701,1707120,579270,559453971,520183416
29379284_632221,CM021100.1,1,29379284,558873907,862568,632221,559506128,520235573
29379789_671847,CM021100.1,1,29379789,558873907,1174571,671847,559545754,520275199
29379789_672004,CM021100.1,1,29379789,558873907,1174571,672004,559545911,520275356
29379789_672008,CM021100.1,1,29379789,558873907,1174571,672008,559545915,520275360
29379789_672052,CM021100.1,1,29379789,558873907,1174571,672052,559545959,520275404
29379789_672231,CM021100.1,1,29379789,558873907,1174571,672231,559546138,520275583
29379789_675189,CM021100.1,1,29379789,558873907,1174571,675189,559549096,520278541
29378628_701018,CM021100.1,1,29378628,558875000,1924931,701018,559576018,520305463
29378628_701030,CM021100.1,1,29378628,558875000,1924931,701030,559576030,520305475
29378628_701031,CM021100.1,1,29378628,558875000,1924931,701031,559576031,520305476
29381067_764443,CM021100.1,1,29381067,558874701,1707120,764443,559639144,520368589
29381067_764460,CM021100.1,1,29381067,558874701,1707120,764460,559639161,520368606
29377354_804755,CM021100.1,1,29377354,558876946,1568476,804755,559681701,520411146
29377354_804796,CM021100.1,1,29377354,558876946,1568476,804796,559681742,520411187
29379789_814493,CM021100.1,1,29379789,558873907,1174571,814493,559688400,520417845
29379789_816413,CM021100.1,1,29379789,558873907,1174571,816413,559690320,520419765
29379789_816419,CM021100.1,1,29379789,558873907,1174571,816419,559690326,520419771
29380020_822596,CM021100.1,1,29380020,558873907,1848955,822596,559696503,520425948
29380020_822629,CM021100.1,1,29380020,558873907,1848955,822629,559696536,520425981
29378426_832556,CM021100.1,1,29378426,558873907,1408235,832556,559706463,520435908
29379050_835425,CM021100.1,1,29379050,558874473,4370839,835425,559709898,520439343
29379050_835442,CM021100.1,1,29379050,558874473,4370839,835442,559709915,520439360
29379050_836022,CM021100.1,1,29379050,558874473,4370839,836022,559710495,520439940
29379050_836037,CM021100.1,1,29379050,558874473,4370839,836037,559710510,520439955
29379050_836095,CM021100.1,1,29379050,558874473,4370839,836095,559710568,520440013
29379380_865364,CM021100.1,1,29379380,558873907,1057426,865364,559739271,520468716
29381393_881245,CM021100.1,1,29381393,558874026,2050493,881245,559755271,520484716
29379115_902616,CM021100.1,1,29379115,558873907,1170569,902616,559776523,520505968
29379115_902625,CM021100.1,1,29379115,558873907,1170569,902625,559776532,520505977
29379115_902634,CM021100.1,1,29379115,558873907,1170569,902634,559776541,520505986
29377456_904315,CM021100.1,1,29377456,558874064,1462457,904315,559778379,520507824
29377456_904451,CM021100.1,1,29377456,558874064,1462457,904451,559778515,520507960
29379789_911583,CM021100.1,1,29379789,558873907,1174571,911583,559785490,520514935
29379789_911791,CM021100.1,1,29379789,558873907,1174571,911791,559785698,520515143
29379789_911879,CM021100.1,1,29379789,558873907,1174571,911879,559785786,520515231
29379789_911964,CM021100.1,1,29379789,558873907,1174571,911964,559785871,520515316
29379789_958953,CM021100.1,1,29379789,558873907,1174571,958953,559832860,520562305
29379789_958967,CM021100.1,1,29379789,558873907,1174571,958967,559832874,520562319
29379789_958983,CM021100.1,1,29379789,558873907,1174571,958983,559832890,520562335
29379789_959021,CM021100.1,1,29379789,558873907,1174571,959021,559832928,520562373
29379789_959032,CM021100.1,1,29379789,558873907,1174571,959032,559832939,520562384
29379789_959062,CM021100.1,1,29379789,558873907,1174571,959062,559832969,520562414
29381067_1005515,CM021100.1,1,29381067,558874701,1707120,1005515,559880216,520609661
29378871_1021326,CM021100.1,1,29378871,558875844,1100055,1021326,559897170,520626615
29379789_1037450,CM021100.1,1,29379789,558873907,1174571,1037450,559911357,520640802
29379789_1038810,CM021100.1,1,29379789,558873907,1174571,1038810,559912717,520642162
29379789_1039000,CM021100.1,1,29379789,558873907,1174571,1039000,559912907,520642352
29379789_1039023,CM021100.1,1,29379789,558873907,1174571,1039023,559912930,520642375
29379789_1039075,CM021100.1,1,29379789,558873907,1174571,1039075,559912982,520642427
29379789_1039151,CM021100.1,1,29379789,558873907,1174571,1039151,559913058,520642503
29379789_1039154,CM021100.1,1,29379789,558873907,1174571,1039154,559913061,520642506
29377354_1046642,CM021100.1,1,29377354,558876946,1568476,1046642,559923588,520653033
29378187_1071710,CM021100.1,1,29378187,558874171,3004208,1071710,559945881,520675326
29378187_1071928,CM021100.1,1,29378187,558874171,3004208,1071928,559946099,520675544
29377456_1087670,CM021100.1,1,29377456,558874064,1462457,1087670,559961734,520691179
29377456_1087778,CM021100.1,1,29377456,558874064,1462457,1087778,559961842,520691287
29377456_1087821,CM021100.1,1,29377456,558874064,1462457,1087821,559961885,520691330
29377354_1096435,CM021100.1,1,29377354,558876946,1568476,1096435,559973381,520702826
29377354_1099094,CM021100.1,1,29377354,558876946,1568476,1099094,559976040,520705485
29379050_1139889,CM021100.1,1,29379050,558874473,4370839,1139889,560014362,520743807
29379050_1139891,CM021100.1,1,29379050,558874473,4370839,1139891,560014364,520743809
29379050_1139907,CM021100.1,1,29379050,558874473,4370839,1139907,560014380,520743825
29380255_1139072,CM021100.1,1,29380255,558875658,1596080,1139072,560014730,520744175
29380915_1177785,CM021100.1,1,29380915,558873907,2076370,1177785,560051692,520781137
29378427_1262475,CM021100.1,1,29378427,558874122,3281198,1262475,560136597,520866042
29377379_1309549,CM021100.1,1,29377379,558874308,1539283,1309549,560183857,520913302
29377456_1333104,CM021100.1,1,29377456,558874064,1462457,1333104,560207168,520936613
29377456_1333106,CM021100.1,1,29377456,558874064,1462457,1333106,560207170,520936615
29377456_1333108,CM021100.1,1,29377456,558874064,1462457,1333108,560207172,520936617
29377456_1333131,CM021100.1,1,29377456,558874064,1462457,1333131,560207195,520936640
29377354_1346133,CM021100.1,1,29377354,558876946,1568476,1346133,560223079,520952524
29381393_1352371,CM021100.1,1,29381393,558874026,2050493,1352371,560226397,520955842
29381393_1352407,CM021100.1,1,29381393,558874026,2050493,1352407,560226433,520955878
29377354_1437219,CM021100.1,1,29377354,558876946,1568476,1437219,560314165,521043610
29379050_1441406,CM021100.1,1,29379050,558874473,4370839,1441406,560315879,521045324
29379050_1441435,CM021100.1,1,29379050,558874473,4370839,1441435,560315908,521045353
29379050_1441444,CM021100.1,1,29379050,558874473,4370839,1441444,560315917,521045362
29379050_1441466,CM021100.1,1,29379050,558874473,4370839,1441466,560315939,521045384
29379050_1441483,CM021100.1,1,29379050,558874473,4370839,1441483,560315956,521045401
29379050_1441542,CM021100.1,1,29379050,558874473,4370839,1441542,560316015,521045460
29381535_1582337,CM021100.1,1,29381535,558873907,4359594,1582337,560456244,521185689
29381535_1582347,CM021100.1,1,29381535,558873907,4359594,1582347,560456254,521185699
29378310_1610635,CM021100.1,1,29378310,558875294,1982971,1610635,560485929,521215374
29378310_1610681,CM021100.1,1,29378310,558875294,1982971,1610681,560485975,521215420
29378310_1610693,CM021100.1,1,29378310,558875294,1982971,1610693,560485987,521215432
29378310_1610702,CM021100.1,1,29378310,558875294,1982971,1610702,560485996,521215441
29378310_1610733,CM021100.1,1,29378310,558875294,1982971,1610733,560486027,521215472
29378310_1610797,CM021100.1,1,29378310,558875294,1982971,1610797,560486091,521215536
29378310_1610841,CM021100.1,1,29378310,558875294,1982971,1610841,560486135,521215580
29378310_1610868,CM021100.1,1,29378310,558875294,1982971,1610868,560486162,521215607
29377016_1657570,CM021100.1,1,29377016,558873907,2021487,1657570,560531477,521260922
29381393_1680141,CM021100.1,1,29381393,558874026,2050493,1680141,560554167,521283612
29381067_1701404,CM021100.1,1,29381067,558874701,1707120,1701404,560576105,521305550
29381067_1701413,CM021100.1,1,29381067,558874701,1707120,1701413,560576114,521305559
29381067_1701464,CM021100.1,1,29381067,558874701,1707120,1701464,560576165,521305610
29381067_1701471,CM021100.1,1,29381067,558874701,1707120,1701471,560576172,521305617
29381067_1701511,CM021100.1,1,29381067,558874701,1707120,1701511,560576212,521305657
29380978_1752367,CM021100.1,1,29380978,558873906,2120650,1752367,560626273,521355718
29381393_1776313,CM021100.1,1,29381393,558874026,2050493,1776313,560650339,521379784
29381535_1859045,CM021100.1,1,29381535,558873907,4359594,1859045,560732952,521462397
29380915_1905433,CM021100.1,1,29380915,558873907,2076370,1905433,560779340,521508785
29380915_1905439,CM021100.1,1,29380915,558873907,2076370,1905439,560779346,521508791
29378310_1911235,CM021100.1,1,29378310,558875294,1982971,1911235,560786529,521515974
29378310_1911241,CM021100.1,1,29378310,558875294,1982971,1911241,560786535,521515980
29378310_1911538,CM021100.1,1,29378310,558875294,1982971,1911538,560786832,521516277
29381994_1937992,CM021100.1,1,29381994,558873907,3233231,1937992,560811899,521541344
29381994_1938015,CM021100.1,1,29381994,558873907,3233231,1938015,560811922,521541367
29381994_1938098,CM021100.1,1,29381994,558873907,3233231,1938098,560812005,521541450
29381994_1938176,CM021100.1,1,29381994,558873907,3233231,1938176,560812083,521541528
29381393_1958206,CM021100.1,1,29381393,558874026,2050493,1958206,560832232,521561677
29378510_2005941,CM021100.1,1,29378510,558874368,2964641,2005941,560880309,521609754
29380114_2323189,CM021100.1,1,29380114,558873910,10181246,2323189,561197099,521926544
29378510_2461388,CM021100.1,1,29378510,558874368,2964641,2461388,561335756,522065201
29378510_2461392,CM021100.1,1,29378510,558874368,2964641,2461392,561335760,522065205
29378510_2461403,CM021100.1,1,29378510,558874368,2964641,2461403,561335771,522065216
29378510_2461405,CM021100.1,1,29378510,558874368,2964641,2461405,561335773,522065218
29378510_2461408,CM021100.1,1,29378510,558874368,2964641,2461408,561335776,522065221
29378510_2461439,CM021100.1,1,29378510,558874368,2964641,2461439,561335807,522065252
29378510_2461449,CM021100.1,1,29378510,558874368,2964641,2461449,561335817,522065262
29378510_2461450,CM021100.1,1,29378510,558874368,2964641,2461450,561335818,522065263
29378510_2461456,CM021100.1,1,29378510,558874368,2964641,2461456,561335824,522065269
29378510_2461458,CM021100.1,1,29378510,558874368,2964641,2461458,561335826,522065271
29378510_2461465,CM021100.1,1,29378510,558874368,2964641,2461465,561335833,522065278
29378510_2461469,CM021100.1,1,29378510,558874368,2964641,2461469,561335837,522065282
29378510_2461526,CM021100.1,1,29378510,558874368,2964641,2461526,561335894,522065339
29382050_2646075,CM021100.1,1,29382050,558873905,4031876,2646075,561519980,522249425
29382050_2646102,CM021100.1,1,29382050,558873905,4031876,2646102,561520007,522249452
29382050_2646133,CM021100.1,1,29382050,558873905,4031876,2646133,561520038,522249483
29382050_2646153,CM021100.1,1,29382050,558873905,4031876,2646153,561520058,522249503
29382050_2646195,CM021100.1,1,29382050,558873905,4031876,2646195,561520100,522249545
29382050_2646207,CM021100.1,1,29382050,558873905,4031876,2646207,561520112,522249557
29382050_2646211,CM021100.1,1,29382050,558873905,4031876,2646211,561520116,522249561
29382050_2646286,CM021100.1,1,29382050,558873905,4031876,2646286,561520191,522249636
29380114_2845321,CM021100.1,1,29380114,558873910,10181246,2845321,561719231,522448676
29380114_2845327,CM021100.1,1,29380114,558873910,10181246,2845327,561719237,522448682
29380114_2845338,CM021100.1,1,29380114,558873910,10181246,2845338,561719248,522448693
29378510_2876903,CM021100.1,1,29378510,558874368,2964641,2876903,561751271,522480716
29378427_3103624,CM021100.1,1,29378427,558874122,3281198,3103624,561977746,522707191
29378427_3103625,CM021100.1,1,29378427,558874122,3281198,3103625,561977747,522707192
29382050_3312360,CM021100.1,1,29382050,558873905,4031876,3312360,562186265,522915710
29382050_3313616,CM021100.1,1,29382050,558873905,4031876,3313616,562187521,522916966
29379050_3528508,CM021100.1,1,29379050,558874473,4370839,3528508,562402981,523132426
29379050_3528569,CM021100.1,1,29379050,558874473,4370839,3528569,562403042,523132487
29379050_3528581,CM021100.1,1,29379050,558874473,4370839,3528581,562403054,523132499
29379050_3529273,CM021100.1,1,29379050,558874473,4370839,3529273,562403746,523133191
29380114_3547250,CM021100.1,1,29380114,558873910,10181246,3547250,562421160,523150605
29380114_3547268,CM021100.1,1,29380114,558873910,10181246,3547268,562421178,523150623
29380114_3547334,CM021100.1,1,29380114,558873910,10181246,3547334,562421244,523150689
29380114_3547343,CM021100.1,1,29380114,558873910,10181246,3547343,562421253,523150698
29379050_4063715,CM021100.1,1,29379050,558874473,4370839,4063715,562938188,523667633
29380114_7100741,CM021100.1,1,29380114,558873910,10181246,7100741,565974651,526704096
29380114_7101495,CM021100.1,1,29380114,558873910,10181246,7101495,565975405,526704850
29380114_7101496,CM021100.1,1,29380114,558873910,10181246,7101496,565975406,526704851
29380114_7101561,CM021100.1,1,29380114,558873910,10181246,7101561,565975471,526704916
29380114_8141851,CM021100.1,1,29380114,558873910,10181246,8141851,567015761,527745206
29380114_8141941,CM021100.1,1,29380114,558873910,10181246,8141941,567015851,527745296
29380114_8409180,CM021100.1,1,29380114,558873910,10181246,8409180,567283090,528012535
29380114_10017913,CM021100.1,1,29380114,558873910,10181246,10017913,568891823,529621268
29347572_92150,CM021100.1,1,29347572,581534414,108395,92150,581626564,542356009
28536438_1011,CM021100.1,1,28536438,582935923,4165,1011,582936934,543666379
29380285_77947,CM021100.1,1,29380285,591298514,643389,77947,591376461,552105906
29380285_78093,CM021100.1,1,29380285,591298514,643389,78093,591376607,552106052
29380285_124685,CM021100.1,1,29380285,591298514,643389,124685,591423199,552152644
29380285_124731,CM021100.1,1,29380285,591298514,643389,124731,591423245,552152690
29380285_210408,CM021100.1,1,29380285,591298514,643389,210408,591508922,552238367
29380285_210446,CM021100.1,1,29380285,591298514,643389,210446,591508960,552238405
29380285_213134,CM021100.1,1,29380285,591298514,643389,213134,591511648,552241093
29380285_213160,CM021100.1,1,29380285,591298514,643389,213160,591511674,552241119
29380285_213161,CM021100.1,1,29380285,591298514,643389,213161,591511675,552241120
29377029_8541,CM021100.1,1,29377029,591574065,739237,8541,591582606,552312051
29377029_8565,CM021100.1,1,29377029,591574065,739237,8565,591582630,552312075
29367860_10740,CM021100.1,1,29367860,591573855,266611,10740,591584595,552314040
29367860_10820,CM021100.1,1,29367860,591573855,266611,10820,591584675,552314120
29367860_10835,CM021100.1,1,29367860,591573855,266611,10835,591584690,552314135
29376990_10656,CM021100.1,1,29376990,591574605,2105778,10656,591585261,552314706
29351185_34098,CM021100.1,1,29351185,591572174,83350,34098,591606272,552335717
29379435_39651,CM021100.1,1,29379435,591572176,146644,39651,591611827,552341272
29379435_39653,CM021100.1,1,29379435,591572176,146644,39653,591611829,552341274
29377268_78281,CM021100.1,1,29377268,591572178,818584,78281,591650459,552379904
29377826_86760,CM021100.1,1,29377826,591575252,2974571,86760,591662012,552391457
29377826_86822,CM021100.1,1,29377826,591575252,2974571,86822,591662074,552391519
29377826_86835,CM021100.1,1,29377826,591575252,2974571,86835,591662087,552391532
29377826_86856,CM021100.1,1,29377826,591575252,2974571,86856,591662108,552391553
29379435_95262,CM021100.1,1,29379435,591572176,146644,95262,591667438,552396883
29379435_95267,CM021100.1,1,29379435,591572176,146644,95267,591667443,552396888
29381239_112673,CM021100.1,1,29381239,591574617,1933698,112673,591687290,552416735
29381239_112887,CM021100.1,1,29381239,591574617,1933698,112887,591687504,552416949
29379435_123256,CM021100.1,1,29379435,591572176,146644,123256,591695432,552424877
29379435_123369,CM021100.1,1,29379435,591572176,146644,123369,591695545,552424990
29377455_169952,CM021100.1,1,29377455,591572170,1070083,169952,591742122,552471567
29377455_170075,CM021100.1,1,29377455,591572170,1070083,170075,591742245,552471690
29381239_219524,CM021100.1,1,29381239,591574617,1933698,219524,591794141,552523586
29378659_255272,CM021100.1,1,29378659,591576377,356548,255272,591831649,552561094
29381239_304219,CM021100.1,1,29381239,591574617,1933698,304219,591878836,552608281
29381239_304316,CM021100.1,1,29381239,591574617,1933698,304316,591878933,552608378
29381239_304678,CM021100.1,1,29381239,591574617,1933698,304678,591879295,552608740
29381239_304729,CM021100.1,1,29381239,591574617,1933698,304729,591879346,552608791
29381239_378732,CM021100.1,1,29381239,591574617,1933698,378732,591953349,552682794
29381239_378780,CM021100.1,1,29381239,591574617,1933698,378780,591953397,552682842
29379704_385057,CM021100.1,1,29379704,591576498,994393,385057,591961555,552691000
29377268_417298,CM021100.1,1,29377268,591572178,818584,417298,591989476,552718921
29379750_444498,CM021100.1,1,29379750,591572177,1026575,444498,592016675,552746120
29379750_444499,CM021100.1,1,29379750,591572177,1026575,444499,592016676,552746121
29379750_444511,CM021100.1,1,29379750,591572177,1026575,444511,592016688,552746133
29379750_444517,CM021100.1,1,29379750,591572177,1026575,444517,592016694,552746139
29379750_444540,CM021100.1,1,29379750,591572177,1026575,444540,592016717,552746162
29381239_498012,CM021100.1,1,29381239,591574617,1933698,498012,592072629,552802074
29381239_498035,CM021100.1,1,29381239,591574617,1933698,498035,592072652,552802097
29381239_498065,CM021100.1,1,29381239,591574617,1933698,498065,592072682,552802127
29381239_498069,CM021100.1,1,29381239,591574617,1933698,498069,592072686,552802131
29381239_498097,CM021100.1,1,29381239,591574617,1933698,498097,592072714,552802159
29381239_498235,CM021100.1,1,29381239,591574617,1933698,498235,592072852,552802297
29379704_498716,CM021100.1,1,29379704,591576498,994393,498716,592075214,552804659
29379481_515163,CM021100.1,1,29379481,591572178,898862,515163,592087341,552816786
29379481_519259,CM021100.1,1,29379481,591572178,898862,519259,592091437,552820882
29379481_519262,CM021100.1,1,29379481,591572178,898862,519262,592091440,552820885
29379481_519404,CM021100.1,1,29379481,591572178,898862,519404,592091582,552821027
29379481_519658,CM021100.1,1,29379481,591572178,898862,519658,592091836,552821281
29379750_560308,CM021100.1,1,29379750,591572177,1026575,560308,592132485,552861930
29375488_574683,CM021100.1,1,29375488,591572174,795734,574683,592146857,552876302
29375488_574731,CM021100.1,1,29375488,591572174,795734,574731,592146905,552876350
29375488_574740,CM021100.1,1,29375488,591572174,795734,574740,592146914,552876359
29375488_574741,CM021100.1,1,29375488,591572174,795734,574741,592146915,552876360
29375488_574803,CM021100.1,1,29375488,591572174,795734,574803,592146977,552876422
29381239_581977,CM021100.1,1,29381239,591574617,1933698,581977,592156594,552886039
29375488_607152,CM021100.1,1,29375488,591572174,795734,607152,592179326,552908771
29377228_609156,CM021100.1,1,29377228,591572177,904494,609156,592181333,552910778
29377455_662522,CM021100.1,1,29377455,591572170,1070083,662522,592234692,552964137
29381239_660095,CM021100.1,1,29381239,591574617,1933698,660095,592234712,552964157
29381239_660246,CM021100.1,1,29381239,591574617,1933698,660246,592234863,552964308
29378039_672444,CM021100.1,1,29378039,591572172,2337598,672444,592244616,552974061
29378039_672463,CM021100.1,1,29378039,591572172,2337598,672463,592244635,552974080
29378039_672506,CM021100.1,1,29378039,591572172,2337598,672506,592244678,552974123
29378039_672521,CM021100.1,1,29378039,591572172,2337598,672521,592244693,552974138
29378039_672605,CM021100.1,1,29378039,591572172,2337598,672605,592244777,552974222
29378039_672688,CM021100.1,1,29378039,591572172,2337598,672688,592244860,552974305
29377974_699279,CM021100.1,1,29377974,591572178,2957280,699279,592271457,553000902
29375488_699932,CM021100.1,1,29375488,591572174,795734,699932,592272106,553001551
29375488_700009,CM021100.1,1,29375488,591572174,795734,700009,592272183,553001628
29375488_732235,CM021100.1,1,29375488,591572174,795734,732235,592304409,553033854
29375488_732236,CM021100.1,1,29375488,591572174,795734,732236,592304410,553033855
29375488_733494,CM021100.1,1,29375488,591572174,795734,733494,592305668,553035113
29375488_733647,CM021100.1,1,29375488,591572174,795734,733647,592305821,553035266
29375488_733765,CM021100.1,1,29375488,591572174,795734,733765,592305939,553035384
29375488_733784,CM021100.1,1,29375488,591572174,795734,733784,592305958,553035403
29379458_739623,CM021100.1,1,29379458,591572177,6207956,739623,592311800,553041245
29378039_746286,CM021100.1,1,29378039,591572172,2337598,746286,592318458,553047903
29380660_793439,CM021100.1,1,29380660,591572173,1609726,793439,592365612,553095057
29377455_832460,CM021100.1,1,29377455,591572170,1070083,832460,592404630,553134075
29378039_894064,CM021100.1,1,29378039,591572172,2337598,894064,592466236,553195681
29378039_894152,CM021100.1,1,29378039,591572172,2337598,894152,592466324,553195769
29377826_974139,CM021100.1,1,29377826,591575252,2974571,974139,592549391,553278836
29377826_974184,CM021100.1,1,29377826,591575252,2974571,974184,592549436,553278881
29377455_1021482,CM021100.1,1,29377455,591572170,1070083,1021482,592593652,553323097
29377455_1021566,CM021100.1,1,29377455,591572170,1070083,1021566,592593736,553323181
29377455_1021580,CM021100.1,1,29377455,591572170,1070083,1021580,592593750,553323195
29377455_1021597,CM021100.1,1,29377455,591572170,1070083,1021597,592593767,553323212
29377455_1022643,CM021100.1,1,29377455,591572170,1070083,1022643,592594813,553324258
29377455_1022647,CM021100.1,1,29377455,591572170,1070083,1022647,592594817,553324262
29377455_1022682,CM021100.1,1,29377455,591572170,1070083,1022682,592594852,553324297
29377455_1022720,CM021100.1,1,29377455,591572170,1070083,1022720,592594890,553324335
29379152_1053302,CM021100.1,1,29379152,591572178,2684512,1053302,592625480,553354925
29379152_1063527,CM021100.1,1,29379152,591572178,2684512,1063527,592635705,553365150
29379152_1063559,CM021100.1,1,29379152,591572178,2684512,1063559,592635737,553365182
29379856_1079953,CM021100.1,1,29379856,591573014,2229820,1079953,592652967,553382412
29379856_1079958,CM021100.1,1,29379856,591573014,2229820,1079958,592652972,553382417
29379856_1079963,CM021100.1,1,29379856,591573014,2229820,1079963,592652977,553382422
29379856_1080077,CM021100.1,1,29379856,591573014,2229820,1080077,592653091,553382536
29379856_1080081,CM021100.1,1,29379856,591573014,2229820,1080081,592653095,553382540
29379856_1080105,CM021100.1,1,29379856,591573014,2229820,1080105,592653119,553382564
29379856_1080160,CM021100.1,1,29379856,591573014,2229820,1080160,592653174,553382619
29377974_1093285,CM021100.1,1,29377974,591572178,2957280,1093285,592665463,553394908
29377826_1129638,CM021100.1,1,29377826,591575252,2974571,1129638,592704890,553434335
29382023_1192042,CM021100.1,1,29382023,591572178,6814054,1192042,592764220,553493665
29377826_1318860,CM021100.1,1,29377826,591575252,2974571,1318860,592894112,553623557
29377826_1318902,CM021100.1,1,29377826,591575252,2974571,1318902,592894154,553623599
29377826_1318976,CM021100.1,1,29377826,591575252,2974571,1318976,592894228,553623673
29377826_1319033,CM021100.1,1,29377826,591575252,2974571,1319033,592894285,553623730
29377826_1346189,CM021100.1,1,29377826,591575252,2974571,1346189,592921441,553650886
29378151_1356463,CM021100.1,1,29378151,591574754,3646939,1356463,592931217,553660662
29376990_1407109,CM021100.1,1,29376990,591574605,2105778,1407109,592981714,553711159
29376990_1407188,CM021100.1,1,29376990,591574605,2105778,1407188,592981793,553711238
29378039_1419514,CM021100.1,1,29378039,591572172,2337598,1419514,592991686,553721131
29381239_1490321,CM021100.1,1,29381239,591574617,1933698,1490321,593064938,553794383
29381239_1490411,CM021100.1,1,29381239,591574617,1933698,1490411,593065028,553794473
29381239_1490475,CM021100.1,1,29381239,591574617,1933698,1490475,593065092,553794537
29377826_1502984,CM021100.1,1,29377826,591575252,2974571,1502984,593078236,553807681
29377826_1502987,CM021100.1,1,29377826,591575252,2974571,1502987,593078239,553807684
29377826_1502992,CM021100.1,1,29377826,591575252,2974571,1502992,593078244,553807689
29377826_1503004,CM021100.1,1,29377826,591575252,2974571,1503004,593078256,553807701
29377826_1503034,CM021100.1,1,29377826,591575252,2974571,1503034,593078286,553807731
29377826_1503037,CM021100.1,1,29377826,591575252,2974571,1503037,593078289,553807734
29377826_1503093,CM021100.1,1,29377826,591575252,2974571,1503093,593078345,553807790
29377826_1503111,CM021100.1,1,29377826,591575252,2974571,1503111,593078363,553807808
29377826_1503117,CM021100.1,1,29377826,591575252,2974571,1503117,593078369,553807814
29382023_1568983,CM021100.1,1,29382023,591572178,6814054,1568983,593141161,553870606
29378039_1715949,CM021100.1,1,29378039,591572172,2337598,1715949,593288121,554017566
29379657_1722422,CM021100.1,1,29379657,591572177,1828980,1722422,593294599,554024044
29379657_1722455,CM021100.1,1,29379657,591572177,1828980,1722455,593294632,554024077
29377974_1784004,CM021100.1,1,29377974,591572178,2957280,1784004,593356182,554085627
29381239_1802384,CM021100.1,1,29381239,591574617,1933698,1802384,593377001,554106446
29381239_1802388,CM021100.1,1,29381239,591574617,1933698,1802388,593377005,554106450
29378151_2310668,CM021100.1,1,29378151,591574754,3646939,2310668,593885422,554614867
29378151_2310683,CM021100.1,1,29378151,591574754,3646939,2310683,593885437,554614882
29378151_2310741,CM021100.1,1,29378151,591574754,3646939,2310741,593885495,554614940
29378151_2374094,CM021100.1,1,29378151,591574754,3646939,2374094,593948848,554678293
29378151_2438341,CM021100.1,1,29378151,591574754,3646939,2438341,594013095,554742540
29379152_2468833,CM021100.1,1,29379152,591572178,2684512,2468833,594041011,554770456
29378202_2484980,CM021100.1,1,29378202,591574292,3465757,2484980,594059272,554788717
29378151_2495598,CM021100.1,1,29378151,591574754,3646939,2495598,594070352,554799797
29378151_2495605,CM021100.1,1,29378151,591574754,3646939,2495605,594070359,554799804
29378151_2496310,CM021100.1,1,29378151,591574754,3646939,2496310,594071064,554800509
29378151_2834221,CM021100.1,1,29378151,591574754,3646939,2834221,594408975,555138420
29378151_2834409,CM021100.1,1,29378151,591574754,3646939,2834409,594409163,555138608
29378202_2859378,CM021100.1,1,29378202,591574292,3465757,2859378,594433670,555163115
29378202_2859419,CM021100.1,1,29378202,591574292,3465757,2859419,594433711,555163156
29378202_2859421,CM021100.1,1,29378202,591574292,3465757,2859421,594433713,555163158
29378151_2875159,CM021100.1,1,29378151,591574754,3646939,2875159,594449913,555179358
29378151_3635226,CM021100.1,1,29378151,591574754,3646939,3635226,595209980,555939425
29380115_96888,CM021100.1,1,29380115,609468272,851111,96888,609565160,570294605
29378387_339545,CM021100.1,1,29378387,609468358,981430,339545,609807903,570537348
29378387_339606,CM021100.1,1,29378387,609468358,981430,339606,609807964,570537409
29378387_339607,CM021100.1,1,29378387,609468358,981430,339607,609807965,570537410
29378387_339634,CM021100.1,1,29378387,609468358,981430,339634,609807992,570537437
29378387_339696,CM021100.1,1,29378387,609468358,981430,339696,609808054,570537499
29380115_577917,CM021100.1,1,29380115,609468272,851111,577917,610046189,570775634
29378387_979366,CM021100.1,1,29378387,609468358,981430,979366,610447724,571177169
29379366_163250,CM021100.1,1,29379366,611373703,289468,163250,611536953,572266398
29379366_163256,CM021100.1,1,29379366,611373703,289468,163256,611536959,572266404
29379366_163319,CM021100.1,1,29379366,611373703,289468,163319,611537022,572266467
29378902_43621,CM021100.1,1,29378902,620110578,236965,43621,620154199,580883644
29378902_43734,CM021100.1,1,29378902,620110578,236965,43734,620154312,580883757
29378902_43757,CM021100.1,1,29378902,620110578,236965,43757,620154335,580883780
29378902_43812,CM021100.1,1,29378902,620110578,236965,43812,620154390,580883835
29380949_272513,CM021100.1,1,29380949,620110579,1593418,272513,620383092,581112537
29379735_276723,CM021100.1,1,29379735,620110582,322811,276723,620387305,581116750
29379457_321242,CM021100.1,1,29379457,620110588,2931822,321242,620431830,581161275
29379457_882198,CM021100.1,1,29379457,620110588,2931822,882198,620992786,581722231
29379457_1206133,CM021100.1,1,29379457,620110588,2931822,1206133,621316721,582046166
29379193_1262259,CM021100.1,1,29379193,620110578,2900855,1262259,621372837,582102282
29378271_1373526,CM021100.1,1,29378271,620110578,4692629,1373526,621484104,582213549
29379193_1489354,CM021100.1,1,29379193,620110578,2900855,1489354,621599932,582329377
29379193_1493981,CM021100.1,1,29379193,620110578,2900855,1493981,621604559,582334004
29379193_1494043,CM021100.1,1,29379193,620110578,2900855,1494043,621604621,582334066
29378271_1875953,CM021100.1,1,29378271,620110578,4692629,1875953,621986531,582715976
29378271_1876005,CM021100.1,1,29378271,620110578,4692629,1876005,621986583,582716028
29378271_1877621,CM021100.1,1,29378271,620110578,4692629,1877621,621988199,582717644
29378271_1877728,CM021100.1,1,29378271,620110578,4692629,1877728,621988306,582717751
29379193_1942629,CM021100.1,1,29379193,620110578,2900855,1942629,622053207,582782652
29379193_1942758,CM021100.1,1,29379193,620110578,2900855,1942758,622053336,582782781
29379457_2246624,CM021100.1,1,29379457,620110588,2931822,2246624,622357212,583086657
29379457_2246662,CM021100.1,1,29379457,620110588,2931822,2246662,622357250,583086695
29379457_2246682,CM021100.1,1,29379457,620110588,2931822,2246682,622357270,583086715
29378271_2299048,CM021100.1,1,29378271,620110578,4692629,2299048,622409626,583139071
29379457_2312751,CM021100.1,1,29379457,620110588,2931822,2312751,622423339,583152784
29379457_2312805,CM021100.1,1,29379457,620110588,2931822,2312805,622423393,583152838
29379457_2313319,CM021100.1,1,29379457,620110588,2931822,2313319,622423907,583153352
29378271_2620459,CM021100.1,1,29378271,620110578,4692629,2620459,622731037,583460482
29378271_3211682,CM021100.1,1,29378271,620110578,4692629,3211682,623322260,584051705
29378271_3846317,CM021100.1,1,29378271,620110578,4692629,3846317,623956895,584686340
29378271_3846330,CM021100.1,1,29378271,620110578,4692629,3846330,623956908,584686353
29378271_3846335,CM021100.1,1,29378271,620110578,4692629,3846335,623956913,584686358
29378271_3846395,CM021100.1,1,29378271,620110578,4692629,3846395,623956973,584686418
29378271_3879393,CM021100.1,1,29378271,620110578,4692629,3879393,623989971,584719416
29378271_3926497,CM021100.1,1,29378271,620110578,4692629,3926497,624037075,584766520
29378271_4242625,CM021100.1,1,29378271,620110578,4692629,4242625,624353203,585082648
29378271_4485056,CM021100.1,1,29378271,620110578,4692629,4485056,624595634,585325079
29346310_258634,CM021100.1,1,29346310,629171154,344402,258634,629429788,590159233
29346310_258681,CM021100.1,1,29346310,629171154,344402,258681,629429835,590159280
29346310_258685,CM021100.1,1,29346310,629171154,344402,258685,629429839,590159284
29346310_258740,CM021100.1,1,29346310,629171154,344402,258740,629429894,590159339
29375424_21560,CM021100.1,1,29375424,630691782,33646,21560,630713342,591442787
29375424_21566,CM021100.1,1,29375424,630691782,33646,21566,630713348,591442793
29375424_21578,CM021100.1,1,29375424,630691782,33646,21578,630713360,591442805
29375424_21597,CM021100.1,1,29375424,630691782,33646,21597,630713379,591442824
29375424_21614,CM021100.1,1,29375424,630691782,33646,21614,630713396,591442841
29375424_21616,CM021100.1,1,29375424,630691782,33646,21616,630713398,591442843
29375424_21635,CM021100.1,1,29375424,630691782,33646,21635,630713417,591442862
29375424_21636,CM021100.1,1,29375424,630691782,33646,21636,630713418,591442863
29375424_21638,CM021100.1,1,29375424,630691782,33646,21638,630713420,591442865
29375424_21645,CM021100.1,1,29375424,630691782,33646,21645,630713427,591442872
29375424_21650,CM021100.1,1,29375424,630691782,33646,21650,630713432,591442877
29375424_21661,CM021100.1,1,29375424,630691782,33646,21661,630713443,591442888
29375424_21675,CM021100.1,1,29375424,630691782,33646,21675,630713457,591442902
29375424_21676,CM021100.1,1,29375424,630691782,33646,21676,630713458,591442903
29375424_21680,CM021100.1,1,29375424,630691782,33646,21680,630713462,591442907
29375424_21690,CM021100.1,1,29375424,630691782,33646,21690,630713472,591442917
29375424_21698,CM021100.1,1,29375424,630691782,33646,21698,630713480,591442925
29375424_21711,CM021100.1,1,29375424,630691782,33646,21711,630713493,591442938
29359432_7827,CM021100.1,1,29359432,632553789,103957,7827,632561616,593291061
29359432_7844,CM021100.1,1,29359432,632553789,103957,7844,632561633,593291078
29359432_7906,CM021100.1,1,29359432,632553789,103957,7906,632561695,593291140
29359432_7957,CM021100.1,1,29359432,632553789,103957,7957,632561746,593291191
29338161_67691,CM021100.1,1,29338161,632553981,175197,67691,632621672,593351117
29382026_74419,CM021100.1,1,29382026,638153574,546468,74419,638227993,598957438
29382026_74538,CM021100.1,1,29382026,638153574,546468,74538,638228112,598957557
29382026_74587,CM021100.1,1,29382026,638153574,546468,74587,638228161,598957606
29382026_74660,CM021100.1,1,29382026,638153574,546468,74660,638228234,598957679
29375387_5423,CM021100.1,1,29375387,640921298,158730,5423,640926721,601656166
29376489_21044,CM021100.1,1,29376489,644085373,283931,21044,644106417,604835862
29376489_21123,CM021100.1,1,29376489,644085373,283931,21123,644106496,604835941
29376489_21139,CM021100.1,1,29376489,644085373,283931,21139,644106512,604835957
29376489_21140,CM021100.1,1,29376489,644085373,283931,21140,644106513,604835958
29376489_21141,CM021100.1,1,29376489,644085373,283931,21141,644106514,604835959
29382132_378147,CM021100.1,1,29382132,644085376,1020203,378147,644463523,605192968
29382132_378232,CM021100.1,1,29382132,644085376,1020203,378232,644463608,605193053
29382132_378867,CM021100.1,1,29382132,644085376,1020203,378867,644464243,605193688
29382132_401518,CM021100.1,1,29382132,644085376,1020203,401518,644486894,605216339
29382132_524285,CM021100.1,1,29382132,644085376,1020203,524285,644609661,605339106
29357168_525807,CM021100.1,1,29357168,644085734,637917,525807,644611541,605340986
29380378_697191,CM021100.1,1,29380378,644085373,4944216,697191,644782564,605512009
29380378_697333,CM021100.1,1,29380378,644085373,4944216,697333,644782706,605512151
29380378_697595,CM021100.1,1,29380378,644085373,4944216,697595,644782968,605512413
29380378_709722,CM021100.1,1,29380378,644085373,4944216,709722,644795095,605524540
29380378_709723,CM021100.1,1,29380378,644085373,4944216,709723,644795096,605524541
29380378_709793,CM021100.1,1,29380378,644085373,4944216,709793,644795166,605524611
29380378_709821,CM021100.1,1,29380378,644085373,4944216,709821,644795194,605524639
29382132_719685,CM021100.1,1,29382132,644085376,1020203,719685,644805061,605534506
29380378_812460,CM021100.1,1,29380378,644085373,4944216,812460,644897833,605627278
29380378_817213,CM021100.1,1,29380378,644085373,4944216,817213,644902586,605632031
29380378_845923,CM021100.1,1,29380378,644085373,4944216,845923,644931296,605660741
29380378_845935,CM021100.1,1,29380378,644085373,4944216,845935,644931308,605660753
29380378_845955,CM021100.1,1,29380378,644085373,4944216,845955,644931328,605660773
29380378_845963,CM021100.1,1,29380378,644085373,4944216,845963,644931336,605660781
29380378_845973,CM021100.1,1,29380378,644085373,4944216,845973,644931346,605660791
29379237_859507,CM021100.1,1,29379237,644085376,1341057,859507,644944883,605674328
29382132_982509,CM021100.1,1,29382132,644085376,1020203,982509,645067885,605797330
29382132_982567,CM021100.1,1,29382132,644085376,1020203,982567,645067943,605797388
29382132_982575,CM021100.1,1,29382132,644085376,1020203,982575,645067951,605797396
29379237_1190541,CM021100.1,1,29379237,644085376,1341057,1190541,645275917,606005362
29380447_1219359,CM021100.1,1,29380447,644085368,2251282,1219359,645304727,606034172
29380447_1219474,CM021100.1,1,29380447,644085368,2251282,1219474,645304842,606034287
29380447_1246112,CM021100.1,1,29380447,644085368,2251282,1246112,645331480,606060925
29380447_1246314,CM021100.1,1,29380447,644085368,2251282,1246314,645331682,606061127
29380378_1254949,CM021100.1,1,29380378,644085373,4944216,1254949,645340322,606069767
29380378_1261619,CM021100.1,1,29380378,644085373,4944216,1261619,645346992,606076437
29380378_1261991,CM021100.1,1,29380378,644085373,4944216,1261991,645347364,606076809
29380378_1262061,CM021100.1,1,29380378,644085373,4944216,1262061,645347434,606076879
29380447_1284505,CM021100.1,1,29380447,644085368,2251282,1284505,645369873,606099318
29380447_1284642,CM021100.1,1,29380447,644085368,2251282,1284642,645370010,606099455
29380447_1284707,CM021100.1,1,29380447,644085368,2251282,1284707,645370075,606099520
29379352_1620756,CM021100.1,1,29379352,644085376,3147412,1620756,645706132,606435577
29379352_1620770,CM021100.1,1,29379352,644085376,3147412,1620770,645706146,606435591
29379352_1620777,CM021100.1,1,29379352,644085376,3147412,1620777,645706153,606435598
29379352_1620781,CM021100.1,1,29379352,644085376,3147412,1620781,645706157,606435602
29379352_1620792,CM021100.1,1,29379352,644085376,3147412,1620792,645706168,606435613
29379352_1620828,CM021100.1,1,29379352,644085376,3147412,1620828,645706204,606435649
29379352_1620848,CM021100.1,1,29379352,644085376,3147412,1620848,645706224,606435669
29379352_1657600,CM021100.1,1,29379352,644085376,3147412,1657600,645742976,606472421
29379352_1659058,CM021100.1,1,29379352,644085376,3147412,1659058,645744434,606473879
29379352_1743881,CM021100.1,1,29379352,644085376,3147412,1743881,645829257,606558702
29379352_1743891,CM021100.1,1,29379352,644085376,3147412,1743891,645829267,606558712
29379352_1743934,CM021100.1,1,29379352,644085376,3147412,1743934,645829310,606558755
29380378_1791523,CM021100.1,1,29380378,644085373,4944216,1791523,645876896,606606341
29380378_1791555,CM021100.1,1,29380378,644085373,4944216,1791555,645876928,606606373
29380378_1791594,CM021100.1,1,29380378,644085373,4944216,1791594,645876967,606606412
29380447_1870413,CM021100.1,1,29380447,644085368,2251282,1870413,645955781,606685226
29379352_1918940,CM021100.1,1,29379352,644085376,3147412,1918940,646004316,606733761
29379352_1919014,CM021100.1,1,29379352,644085376,3147412,1919014,646004390,606733835
29379352_1919028,CM021100.1,1,29379352,644085376,3147412,1919028,646004404,606733849
29380447_2048769,CM021100.1,1,29380447,644085368,2251282,2048769,646134137,606863582
29380447_2048838,CM021100.1,1,29380447,644085368,2251282,2048838,646134206,606863651
29380447_2048926,CM021100.1,1,29380447,644085368,2251282,2048926,646134294,606863739
29380447_2048963,CM021100.1,1,29380447,644085368,2251282,2048963,646134331,606863776
29379352_3028158,CM021100.1,1,29379352,644085376,3147412,3028158,647113534,607842979
29380378_4735888,CM021100.1,1,29380378,644085373,4944216,4735888,648821261,609550706
29379978_285755,CM021100.1,1,29379978,660211368,439142,285755,660497123,621226568
29374697_3578,CM021100.1,1,29374697,662695892,20258,3578,662699470,623428915
29374697_3739,CM021100.1,1,29374697,662695892,20258,3739,662699631,623429076
29374697_3755,CM021100.1,1,29374697,662695892,20258,3755,662699647,623429092
29379480_162576,CM021100.1,1,29379480,710705552,226954,162576,710868128,671597573
29379480_162610,CM021100.1,1,29379480,710705552,226954,162610,710868162,671597607
29379480_162647,CM021100.1,1,29379480,710705552,226954,162647,710868199,671597644
29377054_334779,CM021100.1,1,29377054,710705552,1006150,334779,711040331,671769776
29377054_334804,CM021100.1,1,29377054,710705552,1006150,334804,711040356,671769801
29377054_334877,CM021100.1,1,29377054,710705552,1006150,334877,711040429,671769874
29377269_787925,CM021100.1,1,29377269,710705553,1225109,787925,711493478,672222923
29377269_788019,CM021100.1,1,29377269,710705553,1225109,788019,711493572,672223017
29377269_788034,CM021100.1,1,29377269,710705553,1225109,788034,711493587,672223032
29379129_1104508,CM021100.1,1,29379129,710709844,1458328,1104508,711814352,672543797
29379129_1104599,CM021100.1,1,29379129,710709844,1458328,1104599,711814443,672543888
29379129_1104682,CM021100.1,1,29379129,710709844,1458328,1104682,711814526,672543971
29380936_1119803,CM021100.1,1,29380936,710705550,1587645,1119803,711825353,672554798
29380936_1173265,CM021100.1,1,29380936,710705550,1587645,1173265,711878815,672608260
29380936_1173290,CM021100.1,1,29380936,710705550,1587645,1173290,711878840,672608285
29379129_1235088,CM021100.1,1,29379129,710709844,1458328,1235088,711944932,672674377
29379129_1235109,CM021100.1,1,29379129,710709844,1458328,1235109,711944953,672674398
29379129_1235175,CM021100.1,1,29379129,710709844,1458328,1235175,711945019,672674464
29378966_2970692,CM021100.1,1,29378966,710705552,4305990,2970692,713676244,674405689
29378966_2972890,CM021100.1,1,29378966,710705552,4305990,2972890,713678442,674407887
29378966_2972895,CM021100.1,1,29378966,710705552,4305990,2972895,713678447,674407892
29378966_2972903,CM021100.1,1,29378966,710705552,4305990,2972903,713678455,674407900
29378966_3310823,CM021100.1,1,29378966,710705552,4305990,3310823,714016375,674745820
29378966_3318542,CM021100.1,1,29378966,710705552,4305990,3318542,714024094,674753539
29205484_3826,CM021100.1,1,29205484,718257440,6420,3826,718261266,678990711
29379839_19951,CM021100.1,1,29379839,721685654,2686146,19951,721705605,682435050
29379839_19957,CM021100.1,1,29379839,721685654,2686146,19957,721705611,682435056
29380221_95226,CM021100.1,1,29380221,721685653,305480,95226,721780879,682510324
29378458_107838,CM021100.1,1,29378458,721685655,2161664,107838,721793493,682522938
29380121_136047,CM021100.1,1,29380121,721685656,5490650,136047,721821703,682551148
29380121_136388,CM021100.1,1,29380121,721685656,5490650,136388,721822044,682551489
29380121_153134,CM021100.1,1,29380121,721685656,5490650,153134,721838790,682568235
29380121_153180,CM021100.1,1,29380121,721685656,5490650,153180,721838836,682568281
29360661_154568,CM021100.1,1,29360661,721685657,682422,154568,721840225,682569670
29378458_223337,CM021100.1,1,29378458,721685655,2161664,223337,721908992,682638437
29378458_223382,CM021100.1,1,29378458,721685655,2161664,223382,721909037,682638482
29378458_323848,CM021100.1,1,29378458,721685655,2161664,323848,722009503,682738948
29378458_324056,CM021100.1,1,29378458,721685655,2161664,324056,722009711,682739156
29376988_389907,CM021100.1,1,29376988,721685656,2074888,389907,722075563,682805008
29376988_389974,CM021100.1,1,29376988,721685656,2074888,389974,722075630,682805075
29376988_426771,CM021100.1,1,29376988,721685656,2074888,426771,722112427,682841872
29376988_427521,CM021100.1,1,29376988,721685656,2074888,427521,722113177,682842622
29376988_427607,CM021100.1,1,29376988,721685656,2074888,427607,722113263,682842708
29378458_500697,CM021100.1,1,29378458,721685655,2161664,500697,722186352,682915797
29381266_537893,CM021100.1,1,29381266,721685655,632900,537893,722223548,682952993
29382296_521928,CM021100.1,1,29382296,721715627,1304198,521928,722237555,682967000
29382296_522023,CM021100.1,1,29382296,721715627,1304198,522023,722237650,682967095
29382262_666708,CM021100.1,1,29382262,721685658,1333833,666708,722352366,683081811
29382262_666983,CM021100.1,1,29382262,721685658,1333833,666983,722352641,683082086
29376988_675507,CM021100.1,1,29376988,721685656,2074888,675507,722361163,683090608
29376988_675635,CM021100.1,1,29376988,721685656,2074888,675635,722361291,683090736
29376988_675651,CM021100.1,1,29376988,721685656,2074888,675651,722361307,683090752
29376988_682164,CM021100.1,1,29376988,721685656,2074888,682164,722367820,683097265
29376988_682263,CM021100.1,1,29376988,721685656,2074888,682263,722367919,683097364
29377169_725505,CM021100.1,1,29377169,721685654,8188359,725505,722411159,683140604
29377169_748875,CM021100.1,1,29377169,721685654,8188359,748875,722434529,683163974
29377169_752884,CM021100.1,1,29377169,721685654,8188359,752884,722438538,683167983
29379839_760232,CM021100.1,1,29379839,721685654,2686146,760232,722445886,683175331
29379839_760290,CM021100.1,1,29379839,721685654,2686146,760290,722445944,683175389
29379839_760298,CM021100.1,1,29379839,721685654,2686146,760298,722445952,683175397
29379839_760430,CM021100.1,1,29379839,721685654,2686146,760430,722446084,683175529
29377169_784029,CM021100.1,1,29377169,721685654,8188359,784029,722469683,683199128
29377169_784055,CM021100.1,1,29377169,721685654,8188359,784055,722469709,683199154
29377169_784071,CM021100.1,1,29377169,721685654,8188359,784071,722469725,683199170
29378458_924729,CM021100.1,1,29378458,721685655,2161664,924729,722610384,683339829
29378458_927174,CM021100.1,1,29378458,721685655,2161664,927174,722612829,683342274
29378458_927221,CM021100.1,1,29378458,721685655,2161664,927221,722612876,683342321
29378458_1060670,CM021100.1,1,29378458,721685655,2161664,1060670,722746325,683475770
29378458_1085315,CM021100.1,1,29378458,721685655,2161664,1085315,722770970,683500415
29378458_1085427,CM021100.1,1,29378458,721685655,2161664,1085427,722771082,683500527
29378458_1126506,CM021100.1,1,29378458,721685655,2161664,1126506,722812161,683541606
29378458_1126555,CM021100.1,1,29378458,721685655,2161664,1126555,722812210,683541655
29378458_1143051,CM021100.1,1,29378458,721685655,2161664,1143051,722828706,683558151
29376988_1208831,CM021100.1,1,29376988,721685656,2074888,1208831,722894487,683623932
29376988_1208875,CM021100.1,1,29376988,721685656,2074888,1208875,722894531,683623976
29376988_1208895,CM021100.1,1,29376988,721685656,2074888,1208895,722894551,683623996
29376988_1208910,CM021100.1,1,29376988,721685656,2074888,1208910,722894566,683624011
29376988_1208914,CM021100.1,1,29376988,721685656,2074888,1208914,722894570,683624015
29376988_1209014,CM021100.1,1,29376988,721685656,2074888,1209014,722894670,683624115
29376988_1209018,CM021100.1,1,29376988,721685656,2074888,1209018,722894674,683624119
29376988_1284512,CM021100.1,1,29376988,721685656,2074888,1284512,722970168,683699613
29376988_1284549,CM021100.1,1,29376988,721685656,2074888,1284549,722970205,683699650
29376988_1284727,CM021100.1,1,29376988,721685656,2074888,1284727,722970383,683699828
29379839_1339115,CM021100.1,1,29379839,721685654,2686146,1339115,723024769,683754214
29379839_1339217,CM021100.1,1,29379839,721685654,2686146,1339217,723024871,683754316
29379839_1339306,CM021100.1,1,29379839,721685654,2686146,1339306,723024960,683754405
29378458_1474091,CM021100.1,1,29378458,721685655,2161664,1474091,723159746,683889191
29378458_1474118,CM021100.1,1,29378458,721685655,2161664,1474118,723159773,683889218
29382082_1625479,CM021100.1,1,29382082,721705418,3011847,1625479,723330897,684060342
29382082_1625480,CM021100.1,1,29382082,721705418,3011847,1625480,723330898,684060343
29382082_1628906,CM021100.1,1,29382082,721705418,3011847,1628906,723334324,684063769
29380121_1709259,CM021100.1,1,29380121,721685656,5490650,1709259,723394915,684124360
29380121_1709261,CM021100.1,1,29380121,721685656,5490650,1709261,723394917,684124362
29380121_1709276,CM021100.1,1,29380121,721685656,5490650,1709276,723394932,684124377
29380121_1709345,CM021100.1,1,29380121,721685656,5490650,1709345,723395001,684124446
29380121_1709357,CM021100.1,1,29380121,721685656,5490650,1709357,723395013,684124458
29380121_1709681,CM021100.1,1,29380121,721685656,5490650,1709681,723395337,684124782
29380121_1709708,CM021100.1,1,29380121,721685656,5490650,1709708,723395364,684124809
29380121_1709794,CM021100.1,1,29380121,721685656,5490650,1709794,723395450,684124895
29380121_1709854,CM021100.1,1,29380121,721685656,5490650,1709854,723395510,684124955
29380121_1709866,CM021100.1,1,29380121,721685656,5490650,1709866,723395522,684124967
29380121_1727516,CM021100.1,1,29380121,721685656,5490650,1727516,723413172,684142617
29380121_1727547,CM021100.1,1,29380121,721685656,5490650,1727547,723413203,684142648
29380121_1727583,CM021100.1,1,29380121,721685656,5490650,1727583,723413239,684142684
29377311_1731022,CM021100.1,1,29377311,721685658,5546121,1731022,723416680,684146125
29379839_1740434,CM021100.1,1,29379839,721685654,2686146,1740434,723426088,684155533
29379839_1740478,CM021100.1,1,29379839,721685654,2686146,1740478,723426132,684155577
29379839_1740522,CM021100.1,1,29379839,721685654,2686146,1740522,723426176,684155621
29379839_1740546,CM021100.1,1,29379839,721685654,2686146,1740546,723426200,684155645
29379839_1740563,CM021100.1,1,29379839,721685654,2686146,1740563,723426217,684155662
29379839_1740575,CM021100.1,1,29379839,721685654,2686146,1740575,723426229,684155674
29379839_1740768,CM021100.1,1,29379839,721685654,2686146,1740768,723426422,684155867
29376988_1941822,CM021100.1,1,29376988,721685656,2074888,1941822,723627478,684356923
29376988_1941841,CM021100.1,1,29376988,721685656,2074888,1941841,723627497,684356942
29376988_1941890,CM021100.1,1,29376988,721685656,2074888,1941890,723627546,684356991
29376988_1941891,CM021100.1,1,29376988,721685656,2074888,1941891,723627547,684356992
29376988_1941960,CM021100.1,1,29376988,721685656,2074888,1941960,723627616,684357061
29376988_1941991,CM021100.1,1,29376988,721685656,2074888,1941991,723627647,684357092
29376988_1941995,CM021100.1,1,29376988,721685656,2074888,1941995,723627651,684357096
29376988_1942008,CM021100.1,1,29376988,721685656,2074888,1942008,723627664,684357109
29376988_1942025,CM021100.1,1,29376988,721685656,2074888,1942025,723627681,684357126
29376988_1942034,CM021100.1,1,29376988,721685656,2074888,1942034,723627690,684357135
29376988_1942046,CM021100.1,1,29376988,721685656,2074888,1942046,723627702,684357147
29376988_1942058,CM021100.1,1,29376988,721685656,2074888,1942058,723627714,684357159
29376988_1942079,CM021100.1,1,29376988,721685656,2074888,1942079,723627735,684357180
29377169_2477153,CM021100.1,1,29377169,721685654,8188359,2477153,724162807,684892252
29377169_2477211,CM021100.1,1,29377169,721685654,8188359,2477211,724162865,684892310
29377169_2477222,CM021100.1,1,29377169,721685654,8188359,2477222,724162876,684892321
29377169_2477305,CM021100.1,1,29377169,721685654,8188359,2477305,724162959,684892404
29377169_2478032,CM021100.1,1,29377169,721685654,8188359,2478032,724163686,684893131
29377169_2478089,CM021100.1,1,29377169,721685654,8188359,2478089,724163743,684893188
29377169_2479282,CM021100.1,1,29377169,721685654,8188359,2479282,724164936,684894381
29377169_2479422,CM021100.1,1,29377169,721685654,8188359,2479422,724165076,684894521
29377169_2479484,CM021100.1,1,29377169,721685654,8188359,2479484,724165138,684894583
29377169_2479536,CM021100.1,1,29377169,721685654,8188359,2479536,724165190,684894635
29377169_2479547,CM021100.1,1,29377169,721685654,8188359,2479547,724165201,684894646
29377169_2479550,CM021100.1,1,29377169,721685654,8188359,2479550,724165204,684894649
29377169_2612005,CM021100.1,1,29377169,721685654,8188359,2612005,724297659,685027104
29377169_2612056,CM021100.1,1,29377169,721685654,8188359,2612056,724297710,685027155
29377169_2612112,CM021100.1,1,29377169,721685654,8188359,2612112,724297766,685027211
29377169_2612136,CM021100.1,1,29377169,721685654,8188359,2612136,724297790,685027235
29377169_2612147,CM021100.1,1,29377169,721685654,8188359,2612147,724297801,685027246
29377169_2612152,CM021100.1,1,29377169,721685654,8188359,2612152,724297806,685027251
29377169_2612159,CM021100.1,1,29377169,721685654,8188359,2612159,724297813,685027258
29377169_2612161,CM021100.1,1,29377169,721685654,8188359,2612161,724297815,685027260
29377169_2612168,CM021100.1,1,29377169,721685654,8188359,2612168,724297822,685027267
29377169_2612192,CM021100.1,1,29377169,721685654,8188359,2612192,724297846,685027291
29379783_2675674,CM021100.1,1,29379783,721685658,3339158,2675674,724361332,685090777
29379783_2675884,CM021100.1,1,29379783,721685658,3339158,2675884,724361542,685090987
29380121_2855069,CM021100.1,1,29380121,721685656,5490650,2855069,724540725,685270170
29380121_2855259,CM021100.1,1,29380121,721685656,5490650,2855259,724540915,685270360
29380121_2855265,CM021100.1,1,29380121,721685656,5490650,2855265,724540921,685270366
29377169_2939442,CM021100.1,1,29377169,721685654,8188359,2939442,724625096,685354541
29377169_2941465,CM021100.1,1,29377169,721685654,8188359,2941465,724627119,685356564
29377169_2941532,CM021100.1,1,29377169,721685654,8188359,2941532,724627186,685356631
29338666_11177,CM021100.1,1,29338666,725389645,18136,11177,725400822,686130267
29338666_11222,CM021100.1,1,29338666,725389645,18136,11222,725400867,686130312
29338666_11238,CM021100.1,1,29338666,725389645,18136,11238,725400883,686130328
29377898_51381,CM021100.1,1,29377898,725389648,162394,51381,725441029,686170474
29377898_51387,CM021100.1,1,29377898,725389648,162394,51387,725441035,686170480
29377898_51390,CM021100.1,1,29377898,725389648,162394,51390,725441038,686170483
29377898_51400,CM021100.1,1,29377898,725389648,162394,51400,725441048,686170493
29377199_138221,CM021100.1,1,29377199,725389641,2881132,138221,725527862,686257307
29377199_138316,CM021100.1,1,29377199,725389641,2881132,138316,725527957,686257402
29377199_139533,CM021100.1,1,29377199,725389641,2881132,139533,725529174,686258619
29377199_140936,CM021100.1,1,29377199,725389641,2881132,140936,725530577,686260022
29377199_140947,CM021100.1,1,29377199,725389641,2881132,140947,725530588,686260033
29377199_140982,CM021100.1,1,29377199,725389641,2881132,140982,725530623,686260068
29377199_140983,CM021100.1,1,29377199,725389641,2881132,140983,725530624,686260069
29377199_140993,CM021100.1,1,29377199,725389641,2881132,140993,725530634,686260079
29377199_140994,CM021100.1,1,29377199,725389641,2881132,140994,725530635,686260080
29377199_140995,CM021100.1,1,29377199,725389641,2881132,140995,725530636,686260081
29377199_141024,CM021100.1,1,29377199,725389641,2881132,141024,725530665,686260110
29377199_141147,CM021100.1,1,29377199,725389641,2881132,141147,725530788,686260233
29377199_141152,CM021100.1,1,29377199,725389641,2881132,141152,725530793,686260238
29377199_141167,CM021100.1,1,29377199,725389641,2881132,141167,725530808,686260253
29377199_141179,CM021100.1,1,29377199,725389641,2881132,141179,725530820,686260265
29377199_141183,CM021100.1,1,29377199,725389641,2881132,141183,725530824,686260269
29377199_141188,CM021100.1,1,29377199,725389641,2881132,141188,725530829,686260274
29363785_161489,CM021100.1,1,29363785,725389647,449377,161489,725551136,686280581
29363785_161923,CM021100.1,1,29363785,725389647,449377,161923,725551570,686281015
29363785_162082,CM021100.1,1,29363785,725389647,449377,162082,725551729,686281174
29363785_162160,CM021100.1,1,29363785,725389647,449377,162160,725551807,686281252
29381115_252962,CM021100.1,1,29381115,725389637,1302835,252962,725642599,686372044
29381132_269134,CM021100.1,1,29381132,725391532,1331225,269134,725660666,686390111
29377199_303416,CM021100.1,1,29377199,725389641,2881132,303416,725693057,686422502
29377199_303437,CM021100.1,1,29377199,725389641,2881132,303437,725693078,686422523
29377436_410502,CM021100.1,1,29377436,725389651,563737,410502,725800153,686529598
29380474_515876,CM021100.1,1,29380474,725389648,1752852,515876,725905524,686634969
29380474_515899,CM021100.1,1,29380474,725389648,1752852,515899,725905547,686634992
29380474_578375,CM021100.1,1,29380474,725389648,1752852,578375,725968023,686697468
29380474_610849,CM021100.1,1,29380474,725389648,1752852,610849,726000497,686729942
29352345_628393,CM021100.1,1,29352345,725389630,1025552,628393,726018023,686747468
29378803_4342933,CM021100.1,1,29378803,721685657,11167639,4342933,726028590,686758035
29380474_684718,CM021100.1,1,29380474,725389648,1752852,684718,726074366,686803811
29380474_684776,CM021100.1,1,29380474,725389648,1752852,684776,726074424,686803869
29352345_686912,CM021100.1,1,29352345,725389630,1025552,686912,726076542,686805987
29380474_726367,CM021100.1,1,29380474,725389648,1752852,726367,726116015,686845460
29378803_4544150,CM021100.1,1,29378803,721685657,11167639,4544150,726229807,686959252
29378803_4544230,CM021100.1,1,29378803,721685657,11167639,4544230,726229887,686959332
29378803_4544432,CM021100.1,1,29378803,721685657,11167639,4544432,726230089,686959534
29378803_4553012,CM021100.1,1,29378803,721685657,11167639,4553012,726238669,686968114
29378803_4553111,CM021100.1,1,29378803,721685657,11167639,4553111,726238768,686968213
29378803_4553149,CM021100.1,1,29378803,721685657,11167639,4553149,726238806,686968251
29380474_1086414,CM021100.1,1,29380474,725389648,1752852,1086414,726476062,687205507
29380474_1086894,CM021100.1,1,29380474,725389648,1752852,1086894,726476542,687205987
29380121_4955971,CM021100.1,1,29380121,721685656,5490650,4955971,726641627,687371072
29380121_4956048,CM021100.1,1,29380121,721685656,5490650,4956048,726641704,687371149
29380121_4956054,CM021100.1,1,29380121,721685656,5490650,4956054,726641710,687371155
29380121_4956071,CM021100.1,1,29380121,721685656,5490650,4956071,726641727,687371172
29380121_4956089,CM021100.1,1,29380121,721685656,5490650,4956089,726641745,687371190
29380474_1285726,CM021100.1,1,29380474,725389648,1752852,1285726,726675374,687404819
29380474_1285730,CM021100.1,1,29380474,725389648,1752852,1285730,726675378,687404823
29377199_1313758,CM021100.1,1,29377199,725389641,2881132,1313758,726703399,687432844
29377199_1313895,CM021100.1,1,29377199,725389641,2881132,1313895,726703536,687432981
29380121_5049550,CM021100.1,1,29380121,721685656,5490650,5049550,726735206,687464651
29380121_5049611,CM021100.1,1,29380121,721685656,5490650,5049611,726735267,687464712
29380121_5050855,CM021100.1,1,29380121,721685656,5490650,5050855,726736511,687465956
29380121_5050930,CM021100.1,1,29380121,721685656,5490650,5050930,726736586,687466031
29377330_1428512,CM021100.1,1,29377330,725389643,2084969,1428512,726818155,687547600
29377330_1706927,CM021100.1,1,29377330,725389643,2084969,1706927,727096570,687826015
29377330_1706997,CM021100.1,1,29377330,725389643,2084969,1706997,727096640,687826085
29377330_1710645,CM021100.1,1,29377330,725389643,2084969,1710645,727100288,687829733
29377330_1741937,CM021100.1,1,29377330,725389643,2084969,1741937,727131580,687861025
29377330_1744900,CM021100.1,1,29377330,725389643,2084969,1744900,727134543,687863988
29377330_1744961,CM021100.1,1,29377330,725389643,2084969,1744961,727134604,687864049
29378803_5570533,CM021100.1,1,29378803,721685657,11167639,5570533,727256190,687985635
29378803_5570665,CM021100.1,1,29378803,721685657,11167639,5570665,727256322,687985767
29377330_1888608,CM021100.1,1,29377330,725389643,2084969,1888608,727278251,688007696
29377330_1888730,CM021100.1,1,29377330,725389643,2084969,1888730,727278373,688007818
29377330_1888731,CM021100.1,1,29377330,725389643,2084969,1888731,727278374,688007819
29377199_2199394,CM021100.1,1,29377199,725389641,2881132,2199394,727589035,688318480
29377199_2199521,CM021100.1,1,29377199,725389641,2881132,2199521,727589162,688318607
29377199_2199537,CM021100.1,1,29377199,725389641,2881132,2199537,727589178,688318623
29382394_2578034,CM021100.1,1,29382394,725389645,2595401,2578034,727967679,688697124
29382394_2578063,CM021100.1,1,29382394,725389645,2595401,2578063,727967708,688697153
29378803_7704277,CM021100.1,1,29378803,721685657,11167639,7704277,729389934,690119379
29378803_7704315,CM021100.1,1,29378803,721685657,11167639,7704315,729389972,690119417
29378803_7761365,CM021100.1,1,29378803,721685657,11167639,7761365,729447022,690176467
29378803_7794668,CM021100.1,1,29378803,721685657,11167639,7794668,729480325,690209770
29378803_7794727,CM021100.1,1,29378803,721685657,11167639,7794727,729480384,690209829
29378803_7794791,CM021100.1,1,29378803,721685657,11167639,7794791,729480448,690209893
29378803_7795037,CM021100.1,1,29378803,721685657,11167639,7795037,729480694,690210139
29378803_7815533,CM021100.1,1,29378803,721685657,11167639,7815533,729501190,690230635
29378803_8824343,CM021100.1,1,29378803,721685657,11167639,8824343,730510000,691239445
29378803_8824428,CM021100.1,1,29378803,721685657,11167639,8824428,730510085,691239530
29378803_10243705,CM021100.1,1,29378803,721685657,11167639,10243705,731929362,692658807
29378803_10413885,CM021100.1,1,29378803,721685657,11167639,10413885,732099542,692828987
29378803_10433827,CM021100.1,1,29378803,721685657,11167639,10433827,732119484,692848929
29382168_77799,CM021100.1,1,29382168,745297665,139157,77799,745375464,706104909
29382168_77911,CM021100.1,1,29382168,745297665,139157,77911,745375576,706105021
29379208_125906,CM021100.1,1,29379208,745297661,1467063,125906,745423567,706153012
29379208_125907,CM021100.1,1,29379208,745297661,1467063,125907,745423568,706153013
29380361_227292,CM021100.1,1,29380361,745297668,2042159,227292,745524960,706254405
29380361_227478,CM021100.1,1,29380361,745297668,2042159,227478,745525146,706254591
29378113_293559,CM021100.1,1,29378113,745298725,1610385,293559,745592284,706321729
29378113_293562,CM021100.1,1,29378113,745298725,1610385,293562,745592287,706321732
29378113_293575,CM021100.1,1,29378113,745298725,1610385,293575,745592300,706321745
29378113_293802,CM021100.1,1,29378113,745298725,1610385,293802,745592527,706321972
29378113_293879,CM021100.1,1,29378113,745298725,1610385,293879,745592604,706322049
29378113_293927,CM021100.1,1,29378113,745298725,1610385,293927,745592652,706322097
29379208_471862,CM021100.1,1,29379208,745297661,1467063,471862,745769523,706498968
29378113_541694,CM021100.1,1,29378113,745298725,1610385,541694,745840419,706569864
29379208_569633,CM021100.1,1,29379208,745297661,1467063,569633,745867294,706596739
29379208_609329,CM021100.1,1,29379208,745297661,1467063,609329,745906990,706636435
29379208_651492,CM021100.1,1,29379208,745297661,1467063,651492,745949153,706678598
29379208_651508,CM021100.1,1,29379208,745297661,1467063,651508,745949169,706678614
29381027_739465,CM021100.1,1,29381027,745297665,2366288,739465,746037130,706766575
29381027_739509,CM021100.1,1,29381027,745297665,2366288,739509,746037174,706766619
29381027_739566,CM021100.1,1,29381027,745297665,2366288,739566,746037231,706766676
29378893_787788,CM021100.1,1,29378893,745297717,3015301,787788,746085505,706814950
29378893_787912,CM021100.1,1,29378893,745297717,3015301,787912,746085629,706815074
29378893_787915,CM021100.1,1,29378893,745297717,3015301,787915,746085632,706815077
29378893_787972,CM021100.1,1,29378893,745297717,3015301,787972,746085689,706815134
29378893_788330,CM021100.1,1,29378893,745297717,3015301,788330,746086047,706815492
29378893_788405,CM021100.1,1,29378893,745297717,3015301,788405,746086122,706815567
29378893_810235,CM021100.1,1,29378893,745297717,3015301,810235,746107952,706837397
29378893_810360,CM021100.1,1,29378893,745297717,3015301,810360,746108077,706837522
29378893_815038,CM021100.1,1,29378893,745297717,3015301,815038,746112755,706842200
29378893_815058,CM021100.1,1,29378893,745297717,3015301,815058,746112775,706842220
29378893_828222,CM021100.1,1,29378893,745297717,3015301,828222,746125939,706855384
29378893_828457,CM021100.1,1,29378893,745297717,3015301,828457,746126174,706855619
29379537_860394,CM021100.1,1,29379537,745298308,1764648,860394,746158702,706888147
29379537_860399,CM021100.1,1,29379537,745298308,1764648,860399,746158707,706888152
29379537_860400,CM021100.1,1,29379537,745298308,1764648,860400,746158708,706888153
29379537_860409,CM021100.1,1,29379537,745298308,1764648,860409,746158717,706888162
29378893_877291,CM021100.1,1,29378893,745297717,3015301,877291,746175008,706904453
29378893_877372,CM021100.1,1,29378893,745297717,3015301,877372,746175089,706904534
29378893_879005,CM021100.1,1,29378893,745297717,3015301,879005,746176722,706906167
29378893_881676,CM021100.1,1,29378893,745297717,3015301,881676,746179393,706908838
29378893_920434,CM021100.1,1,29378893,745297717,3015301,920434,746218151,706947596
29378893_920492,CM021100.1,1,29378893,745297717,3015301,920492,746218209,706947654
29378893_920574,CM021100.1,1,29378893,745297717,3015301,920574,746218291,706947736
29378113_1257563,CM021100.1,1,29378113,745298725,1610385,1257563,746556288,707285733
29378113_1257621,CM021100.1,1,29378113,745298725,1610385,1257621,746556346,707285791
29379208_1315527,CM021100.1,1,29379208,745297661,1467063,1315527,746613188,707342633
29379208_1316167,CM021100.1,1,29379208,745297661,1467063,1316167,746613828,707343273
29378113_1373475,CM021100.1,1,29378113,745298725,1610385,1373475,746672200,707401645
29379208_1410829,CM021100.1,1,29379208,745297661,1467063,1410829,746708490,707437935
29379208_1453443,CM021100.1,1,29379208,745297661,1467063,1453443,746751104,707480549
29379208_1453568,CM021100.1,1,29379208,745297661,1467063,1453568,746751229,707480674
29379965_1497733,CM021100.1,1,29379965,745297664,2301903,1497733,746795397,707524842
29379965_1519715,CM021100.1,1,29379965,745297664,2301903,1519715,746817379,707546824
29379965_1519732,CM021100.1,1,29379965,745297664,2301903,1519732,746817396,707546841
29379965_1519766,CM021100.1,1,29379965,745297664,2301903,1519766,746817430,707546875
29377829_1529130,CM021100.1,1,29377829,745297664,2262853,1529130,746826794,707556239
29377829_1529179,CM021100.1,1,29377829,745297664,2262853,1529179,746826843,707556288
29377829_1529194,CM021100.1,1,29377829,745297664,2262853,1529194,746826858,707556303
29377829_1529213,CM021100.1,1,29377829,745297664,2262853,1529213,746826877,707556322
29377829_1529279,CM021100.1,1,29377829,745297664,2262853,1529279,746826943,707556388
29377829_1529280,CM021100.1,1,29377829,745297664,2262853,1529280,746826944,707556389
29378893_2682248,CM021100.1,1,29378893,745297717,3015301,2682248,747979965,708709410
29378893_2682351,CM021100.1,1,29378893,745297717,3015301,2682351,747980068,708709513
29378893_2929333,CM021100.1,1,29378893,745297717,3015301,2929333,748227050,708956495
29378893_2929445,CM021100.1,1,29378893,745297717,3015301,2929445,748227162,708956607
29378893_2929514,CM021100.1,1,29378893,745297717,3015301,2929514,748227231,708956676
29378893_2929558,CM021100.1,1,29378893,745297717,3015301,2929558,748227275,708956720
29378893_2977760,CM021100.1,1,29378893,745297717,3015301,2977760,748275477,709004922
29378893_2977816,CM021100.1,1,29378893,745297717,3015301,2977816,748275533,709004978
29377144_72259,CM021100.1,1,29377144,761033392,165358,72259,761105651,721835096
29377144_72263,CM021100.1,1,29377144,761033392,165358,72263,761105655,721835100
29377144_72283,CM021100.1,1,29377144,761033392,165358,72283,761105675,721835120
29377144_72320,CM021100.1,1,29377144,761033392,165358,72320,761105712,721835157
29377144_72336,CM021100.1,1,29377144,761033392,165358,72336,761105728,721835173
29377144_72342,CM021100.1,1,29377144,761033392,165358,72342,761105734,721835179
29377144_72402,CM021100.1,1,29377144,761033392,165358,72402,761105794,721835239
29377168_291166,CM021100.1,1,29377168,799613807,631296,291166,799904973,760634418
29377168_291221,CM021100.1,1,29377168,799613807,631296,291221,799905028,760634473
29377168_291247,CM021100.1,1,29377168,799613807,631296,291247,799905054,760634499
29377168_318204,CM021100.1,1,29377168,799613807,631296,318204,799932011,760661456
29377168_318215,CM021100.1,1,29377168,799613807,631296,318215,799932022,760661467
29381502_448693,CM021100.1,1,29381502,799613805,730996,448693,800062498,760791943
29379157_70049,CM021100.1,1,29379157,803558130,471065,70049,803628179,764357624
29380997_235062,CM021100.1,1,29380997,803554664,777538,235062,803789726,764519171
29380997_235078,CM021100.1,1,29380997,803554664,777538,235078,803789742,764519187
29349114_323503,CM021100.1,1,29349114,804404895,517242,323503,804728398,765457843
29349114_323786,CM021100.1,1,29349114,804404895,517242,323786,804728681,765458126
29028590_3654,CM021100.1,1,29028590,816924237,6219,3654,816927891,777657336
29028590_3666,CM021100.1,1,29028590,816924237,6219,3666,816927903,777657348
29373995_9228,CM021100.1,1,29373995,836107787,164661,9228,836117015,796846460
29381166_114848,CM021100.1,1,29381166,854452456,913425,114848,854567304,815296749
29377837_431023,CM021100.1,1,29377837,854451932,2542965,431023,854882955,815612400
29378155_437247,CM021100.1,1,29378155,854451932,837314,437247,854889179,815618624
29379225_460836,CM021100.1,1,29379225,854453170,691123,460836,854914006,815643451
29379225_460867,CM021100.1,1,29379225,854453170,691123,460867,854914037,815643482
29379225_508462,CM021100.1,1,29379225,854453170,691123,508462,854961632,815691077
29379225_509173,CM021100.1,1,29379225,854453170,691123,509173,854962343,815691788
29379225_509214,CM021100.1,1,29379225,854453170,691123,509214,854962384,815691829
29381220_607985,CM021100.1,1,29381220,854451932,994878,607985,855059917,815789362
29381166_775045,CM021100.1,1,29381166,854452456,913425,775045,855227501,815956946
29381166_776009,CM021100.1,1,29381166,854452456,913425,776009,855228465,815957910
29381166_776070,CM021100.1,1,29381166,854452456,913425,776070,855228526,815957971
29381166_776083,CM021100.1,1,29381166,854452456,913425,776083,855228539,815957984
29381166_776132,CM021100.1,1,29381166,854452456,913425,776132,855228588,815958033
29381166_776154,CM021100.1,1,29381166,854452456,913425,776154,855228610,815958055
29381166_777341,CM021100.1,1,29381166,854452456,913425,777341,855229797,815959242
29381166_777345,CM021100.1,1,29381166,854452456,913425,777345,855229801,815959246
29381166_777370,CM021100.1,1,29381166,854452456,913425,777370,855229826,815959271
29381166_777395,CM021100.1,1,29381166,854452456,913425,777395,855229851,815959296
29381166_777430,CM021100.1,1,29381166,854452456,913425,777430,855229886,815959331
29381166_777449,CM021100.1,1,29381166,854452456,913425,777449,855229905,815959350
29381166_777476,CM021100.1,1,29381166,854452456,913425,777476,855229932,815959377
29381166_777482,CM021100.1,1,29381166,854452456,913425,777482,855229938,815959383
29379561_846122,CM021100.1,1,29379561,854451929,1613646,846122,855298051,816027496
29377837_1055071,CM021100.1,1,29377837,854451932,2542965,1055071,855507003,816236448
29377837_1055074,CM021100.1,1,29377837,854451932,2542965,1055074,855507006,816236451
29377129_1101657,CM021100.1,1,29377129,854452694,2449695,1101657,855554351,816283796
29377129_1101809,CM021100.1,1,29377129,854452694,2449695,1101809,855554503,816283948
29377837_1184196,CM021100.1,1,29377837,854451932,2542965,1184196,855636128,816365573
29377837_1238497,CM021100.1,1,29377837,854451932,2542965,1238497,855690429,816419874
29377837_1238584,CM021100.1,1,29377837,854451932,2542965,1238584,855690516,816419961
29377837_1286270,CM021100.1,1,29377837,854451932,2542965,1286270,855738202,816467647
29377837_1286350,CM021100.1,1,29377837,854451932,2542965,1286350,855738282,816467727
29380244_1540625,CM021100.1,1,29380244,854452286,1616502,1540625,855992911,816722356
29380244_1540633,CM021100.1,1,29380244,854452286,1616502,1540633,855992919,816722364
29380244_1540639,CM021100.1,1,29380244,854452286,1616502,1540639,855992925,816722370
29377129_1739506,CM021100.1,1,29377129,854452694,2449695,1739506,856192200,816921645
29377837_2141127,CM021100.1,1,29377837,854451932,2542965,2141127,856593059,817322504
29377837_2141134,CM021100.1,1,29377837,854451932,2542965,2141134,856593066,817322511
29377837_2141194,CM021100.1,1,29377837,854451932,2542965,2141194,856593126,817322571
29377837_2141275,CM021100.1,1,29377837,854451932,2542965,2141275,856593207,817322652
29381677_86887,CM021100.1,1,29381677,902667631,132934,86887,902754518,863483963
29382275_1148946,CM021100.1,1,29382275,914520459,1489537,1148946,915669405,876398850
29355726_48273,CM021100.1,1,29355726,980892299,220271,48273,980940572,941670017
29355726_48643,CM021100.1,1,29355726,980892299,220271,48643,980940942,941670387
29355726_51775,CM021100.1,1,29355726,980892299,220271,51775,980944074,941673519
29355726_87345,CM021100.1,1,29355726,980892299,220271,87345,980979644,941709089
29355726_87397,CM021100.1,1,29355726,980892299,220271,87397,980979696,941709141
29355726_124587,CM021100.1,1,29355726,980892299,220271,124587,981016886,941746331
29355726_140638,CM021100.1,1,29355726,980892299,220271,140638,981032937,941762382
29380585_330687,CM021101.1,2,29380585,37822096,684344,330687,38152783,330687
29380585_330712,CM021101.1,2,29380585,37822096,684344,330712,38152808,330712
29380585_382386,CM021101.1,2,29380585,37822096,684344,382386,38204482,382386
29380585_382515,CM021101.1,2,29380585,37822096,684344,382515,38204611,382515
29380585_418178,CM021101.1,2,29380585,37822096,684344,418178,38240274,418178
29380585_418182,CM021101.1,2,29380585,37822096,684344,418182,38240278,418182
29379085_83757,CM021101.1,2,29379085,62052661,2816731,83757,62136418,24314322
29379085_83776,CM021101.1,2,29379085,62052661,2816731,83776,62136437,24314341
29381604_91847,CM021101.1,2,29381604,62052670,2943858,91847,62144517,24322421
29381604_91970,CM021101.1,2,29381604,62052670,2943858,91970,62144640,24322544
29381604_91972,CM021101.1,2,29381604,62052670,2943858,91972,62144642,24322546
29381604_92014,CM021101.1,2,29381604,62052670,2943858,92014,62144684,24322588
29379085_846790,CM021101.1,2,29379085,62052661,2816731,846790,62899451,25077355
29379085_940691,CM021101.1,2,29379085,62052661,2816731,940691,62993352,25171256
29379085_976152,CM021101.1,2,29379085,62052661,2816731,976152,63028813,25206717
29379085_976637,CM021101.1,2,29379085,62052661,2816731,976637,63029298,25207202
29379085_976653,CM021101.1,2,29379085,62052661,2816731,976653,63029314,25207218
29381604_1038113,CM021101.1,2,29381604,62052670,2943858,1038113,63090783,25268687
29381604_1081375,CM021101.1,2,29381604,62052670,2943858,1081375,63134045,25311949
29381604_1291039,CM021101.1,2,29381604,62052670,2943858,1291039,63343709,25521613
29381604_1291114,CM021101.1,2,29381604,62052670,2943858,1291114,63343784,25521688
29381604_1291115,CM021101.1,2,29381604,62052670,2943858,1291115,63343785,25521689
29381604_1291118,CM021101.1,2,29381604,62052670,2943858,1291118,63343788,25521692
29381604_1291355,CM021101.1,2,29381604,62052670,2943858,1291355,63344025,25521929
29381604_1291374,CM021101.1,2,29381604,62052670,2943858,1291374,63344044,25521948
29381604_1291377,CM021101.1,2,29381604,62052670,2943858,1291377,63344047,25521951
29381604_1295948,CM021101.1,2,29381604,62052670,2943858,1295948,63348618,25526522
29381604_1296061,CM021101.1,2,29381604,62052670,2943858,1296061,63348731,25526635
29379085_1654146,CM021101.1,2,29379085,62052661,2816731,1654146,63706807,25884711
29377812_2583383,CM021101.1,2,29377812,62052676,3701728,2583383,64636059,26813963
29379085_2585955,CM021101.1,2,29379085,62052661,2816731,2585955,64638616,26816520
29379489_59470,CM021101.1,2,29379489,68079145,2809342,59470,68138615,30316519
29379489_59566,CM021101.1,2,29379489,68079145,2809342,59566,68138711,30316615
29379489_59574,CM021101.1,2,29379489,68079145,2809342,59574,68138719,30316623
29379489_59584,CM021101.1,2,29379489,68079145,2809342,59584,68138729,30316633
29379489_59592,CM021101.1,2,29379489,68079145,2809342,59592,68138737,30316641
29379489_59606,CM021101.1,2,29379489,68079145,2809342,59606,68138751,30316655
29379489_59614,CM021101.1,2,29379489,68079145,2809342,59614,68138759,30316663
29379489_59617,CM021101.1,2,29379489,68079145,2809342,59617,68138762,30316666
29381214_75959,CM021101.1,2,29381214,68078529,843666,75959,68154488,30332392
29381214_75962,CM021101.1,2,29381214,68078529,843666,75962,68154491,30332395
29380519_119452,CM021101.1,2,29380519,68078800,374970,119452,68198252,30376156
29380656_132061,CM021101.1,2,29380656,68078681,959237,132061,68210742,30388646
29380971_150150,CM021101.1,2,29380971,68078446,10587983,150150,68228596,30406500
29381257_211951,CM021101.1,2,29381257,68079506,5296250,211951,68291457,30469361
29381257_212017,CM021101.1,2,29381257,68079506,5296250,212017,68291523,30469427
29381257_223866,CM021101.1,2,29381257,68079506,5296250,223866,68303372,30481276
29381322_226804,CM021101.1,2,29381322,68080737,251066,226804,68307541,30485445
29381322_226823,CM021101.1,2,29381322,68080737,251066,226823,68307560,30485464
29381322_226874,CM021101.1,2,29381322,68080737,251066,226874,68307611,30485515
29380254_236305,CM021101.1,2,29380254,68079322,2868325,236305,68315627,30493531
29377374_289133,CM021101.1,2,29377374,68079237,1540996,289133,68368370,30546274
29380254_354495,CM021101.1,2,29380254,68079322,2868325,354495,68433817,30611721
29380254_354520,CM021101.1,2,29380254,68079322,2868325,354520,68433842,30611746
29381029_408441,CM021101.1,2,29381029,68078447,2703231,408441,68486888,30664792
29381029_408472,CM021101.1,2,29381029,68078447,2703231,408472,68486919,30664823
29379795_410058,CM021101.1,2,29379795,68078447,4500773,410058,68488505,30666409
29379795_410107,CM021101.1,2,29379795,68078447,4500773,410107,68488554,30666458
29377464_528856,CM021101.1,2,29377464,68078447,4816225,528856,68607303,30785207
29377464_529113,CM021101.1,2,29377464,68078447,4816225,529113,68607560,30785464
29377464_529114,CM021101.1,2,29377464,68078447,4816225,529114,68607561,30785465
29377464_529146,CM021101.1,2,29377464,68078447,4816225,529146,68607593,30785497
29378920_543171,CM021101.1,2,29378920,68080236,3462836,543171,68623407,30801311
29377464_555384,CM021101.1,2,29377464,68078447,4816225,555384,68633831,30811735
29377464_555435,CM021101.1,2,29377464,68078447,4816225,555435,68633882,30811786
29377464_555446,CM021101.1,2,29377464,68078447,4816225,555446,68633893,30811797
29377464_555452,CM021101.1,2,29377464,68078447,4816225,555452,68633899,30811803
29377464_555493,CM021101.1,2,29377464,68078447,4816225,555493,68633940,30811844
29377464_555522,CM021101.1,2,29377464,68078447,4816225,555522,68633969,30811873
29381214_578308,CM021101.1,2,29381214,68078529,843666,578308,68656837,30834741
29378977_597759,CM021101.1,2,29378977,68078437,1751398,597759,68676196,30854100
29378977_599046,CM021101.1,2,29378977,68078437,1751398,599046,68677483,30855387
29378911_652941,CM021101.1,2,29378911,68078746,1893155,652941,68731687,30909591
29378911_653090,CM021101.1,2,29378911,68078746,1893155,653090,68731836,30909740
29378911_653108,CM021101.1,2,29378911,68078746,1893155,653108,68731854,30909758
29381427_651197,CM021101.1,2,29381427,68081183,1966946,651197,68732380,30910284
29381427_651326,CM021101.1,2,29381427,68081183,1966946,651326,68732509,30910413
29381427_651333,CM021101.1,2,29381427,68081183,1966946,651333,68732516,30910420
29381427_651488,CM021101.1,2,29381427,68081183,1966946,651488,68732671,30910575
29379795_692536,CM021101.1,2,29379795,68078447,4500773,692536,68770983,30948887
29379795_692541,CM021101.1,2,29379795,68078447,4500773,692541,68770988,30948892
29379795_692575,CM021101.1,2,29379795,68078447,4500773,692575,68771022,30948926
29379795_692601,CM021101.1,2,29379795,68078447,4500773,692601,68771048,30948952
29379795_692604,CM021101.1,2,29379795,68078447,4500773,692604,68771051,30948955
29379795_692627,CM021101.1,2,29379795,68078447,4500773,692627,68771074,30948978
29379795_692645,CM021101.1,2,29379795,68078447,4500773,692645,68771092,30948996
29379795_692790,CM021101.1,2,29379795,68078447,4500773,692790,68771237,30949141
29379795_692826,CM021101.1,2,29379795,68078447,4500773,692826,68771273,30949177
29379795_760731,CM021101.1,2,29379795,68078447,4500773,760731,68839178,31017082
29379795_760797,CM021101.1,2,29379795,68078447,4500773,760797,68839244,31017148
29379795_760819,CM021101.1,2,29379795,68078447,4500773,760819,68839266,31017170
29379182_782143,CM021101.1,2,29379182,68078438,1148116,782143,68860581,31038485
29379182_782247,CM021101.1,2,29379182,68078438,1148116,782247,68860685,31038589
29379182_782261,CM021101.1,2,29379182,68078438,1148116,782261,68860699,31038603
29379182_814635,CM021101.1,2,29379182,68078438,1148116,814635,68893073,31070977
29379182_814662,CM021101.1,2,29379182,68078438,1148116,814662,68893100,31071004
29379182_814705,CM021101.1,2,29379182,68078438,1148116,814705,68893143,31071047
29379795_840540,CM021101.1,2,29379795,68078447,4500773,840540,68918987,31096891
29379795_840542,CM021101.1,2,29379795,68078447,4500773,840542,68918989,31096893
29379795_874014,CM021101.1,2,29379795,68078447,4500773,874014,68952461,31130365
29379795_874040,CM021101.1,2,29379795,68078447,4500773,874040,68952487,31130391
29379795_874250,CM021101.1,2,29379795,68078447,4500773,874250,68952697,31130601
29381257_878467,CM021101.1,2,29381257,68079506,5296250,878467,68957973,31135877
29381257_878472,CM021101.1,2,29381257,68079506,5296250,878472,68957978,31135882
29379795_915040,CM021101.1,2,29379795,68078447,4500773,915040,68993487,31171391
29379795_915237,CM021101.1,2,29379795,68078447,4500773,915237,68993684,31171588
29379795_915282,CM021101.1,2,29379795,68078447,4500773,915282,68993729,31171633
29378828_939681,CM021101.1,2,29378828,68080194,1390057,939681,69019875,31197779
29377001_951781,CM021101.1,2,29377001,68078447,5575874,951781,69030228,31208132
29377001_951784,CM021101.1,2,29377001,68078447,5575874,951784,69030231,31208135
29377001_951835,CM021101.1,2,29377001,68078447,5575874,951835,69030282,31208186
29381427_959085,CM021101.1,2,29381427,68081183,1966946,959085,69040268,31218172
29381427_959176,CM021101.1,2,29381427,68081183,1966946,959176,69040359,31218263
29377001_979796,CM021101.1,2,29377001,68078447,5575874,979796,69058243,31236147
29377001_979876,CM021101.1,2,29377001,68078447,5575874,979876,69058323,31236227
29382007_1044799,CM021101.1,2,29382007,68078447,2837894,1044799,69123246,31301150
29382007_1045012,CM021101.1,2,29382007,68078447,2837894,1045012,69123459,31301363
29382007_1045026,CM021101.1,2,29382007,68078447,2837894,1045026,69123473,31301377
29377464_1053013,CM021101.1,2,29377464,68078447,4816225,1053013,69131460,31309364
29377464_1053026,CM021101.1,2,29377464,68078447,4816225,1053026,69131473,31309377
29377464_1053038,CM021101.1,2,29377464,68078447,4816225,1053038,69131485,31309389
29377464_1053040,CM021101.1,2,29377464,68078447,4816225,1053040,69131487,31309391
29377464_1053049,CM021101.1,2,29377464,68078447,4816225,1053049,69131496,31309400
29377464_1053087,CM021101.1,2,29377464,68078447,4816225,1053087,69131534,31309438
29377464_1053210,CM021101.1,2,29377464,68078447,4816225,1053210,69131657,31309561
29379795_1084870,CM021101.1,2,29379795,68078447,4500773,1084870,69163317,31341221
29379795_1084871,CM021101.1,2,29379795,68078447,4500773,1084871,69163318,31341222
29379795_1084888,CM021101.1,2,29379795,68078447,4500773,1084888,69163335,31341239
29379795_1084983,CM021101.1,2,29379795,68078447,4500773,1084983,69163430,31341334
29379795_1084987,CM021101.1,2,29379795,68078447,4500773,1084987,69163434,31341338
29379182_1087144,CM021101.1,2,29379182,68078438,1148116,1087144,69165582,31343486
29380971_1120633,CM021101.1,2,29380971,68078446,10587983,1120633,69199079,31376983
29380971_1126426,CM021101.1,2,29380971,68078446,10587983,1126426,69204872,31382776
29380971_1145647,CM021101.1,2,29380971,68078446,10587983,1145647,69224093,31401997
29380971_1145866,CM021101.1,2,29380971,68078446,10587983,1145866,69224312,31402216
29380971_1145979,CM021101.1,2,29380971,68078446,10587983,1145979,69224425,31402329
29379795_1167060,CM021101.1,2,29379795,68078447,4500773,1167060,69245507,31423411
29378920_1208994,CM021101.1,2,29378920,68080236,3462836,1208994,69289230,31467134
29378920_1209061,CM021101.1,2,29378920,68080236,3462836,1209061,69289297,31467201
29378920_1209152,CM021101.1,2,29378920,68080236,3462836,1209152,69289388,31467292
29378920_1209179,CM021101.1,2,29378920,68080236,3462836,1209179,69289415,31467319
29378920_1209200,CM021101.1,2,29378920,68080236,3462836,1209200,69289436,31467340
29380077_1336279,CM021101.1,2,29380077,68078935,1479465,1336279,69415214,31593118
29380077_1336285,CM021101.1,2,29380077,68078935,1479465,1336285,69415220,31593124
29380077_1336339,CM021101.1,2,29380077,68078935,1479465,1336339,69415274,31593178
29380077_1336346,CM021101.1,2,29380077,68078935,1479465,1336346,69415281,31593185
29380077_1336396,CM021101.1,2,29380077,68078935,1479465,1336396,69415331,31593235
29380077_1336397,CM021101.1,2,29380077,68078935,1479465,1336397,69415332,31593236
29380077_1336871,CM021101.1,2,29380077,68078935,1479465,1336871,69415806,31593710
29380077_1336872,CM021101.1,2,29380077,68078935,1479465,1336872,69415807,31593711
29380077_1336884,CM021101.1,2,29380077,68078935,1479465,1336884,69415819,31593723
29380077_1336956,CM021101.1,2,29380077,68078935,1479465,1336956,69415891,31593795
29380077_1344214,CM021101.1,2,29380077,68078935,1479465,1344214,69423149,31601053
29380077_1344311,CM021101.1,2,29380077,68078935,1479465,1344311,69423246,31601150
29380077_1344329,CM021101.1,2,29380077,68078935,1479465,1344329,69423264,31601168
29381257_1367349,CM021101.1,2,29381257,68079506,5296250,1367349,69446855,31624759
29381257_1367357,CM021101.1,2,29381257,68079506,5296250,1367357,69446863,31624767
29380971_1370270,CM021101.1,2,29380971,68078446,10587983,1370270,69448716,31626620
29379795_1379027,CM021101.1,2,29379795,68078447,4500773,1379027,69457474,31635378
29379795_1379121,CM021101.1,2,29379795,68078447,4500773,1379121,69457568,31635472
29377001_1513390,CM021101.1,2,29377001,68078447,5575874,1513390,69591837,31769741
29381257_1567043,CM021101.1,2,29381257,68079506,5296250,1567043,69646549,31824453
29381257_1599277,CM021101.1,2,29381257,68079506,5296250,1599277,69678783,31856687
29377372_11067,CM021101.1,2,29377372,69762672,502411,11067,69773739,31951643
29377372_11078,CM021101.1,2,29377372,69762672,502411,11078,69773750,31951654
29377372_11087,CM021101.1,2,29377372,69762672,502411,11087,69773759,31951663
29377372_11088,CM021101.1,2,29377372,69762672,502411,11088,69773760,31951664
29377372_11090,CM021101.1,2,29377372,69762672,502411,11090,69773762,31951666
29377372_11093,CM021101.1,2,29377372,69762672,502411,11093,69773765,31951669
29377372_11103,CM021101.1,2,29377372,69762672,502411,11103,69773775,31951679
29377372_151361,CM021101.1,2,29377372,69762672,502411,151361,69914033,32091937
29377372_151432,CM021101.1,2,29377372,69762672,502411,151432,69914104,32092008
29379795_1883105,CM021101.1,2,29379795,68078447,4500773,1883105,69961552,32139456
29379795_1898392,CM021101.1,2,29379795,68078447,4500773,1898392,69976839,32154743
29379939_1939612,CM021101.1,2,29379939,68078569,6140934,1939612,70018181,32196085
29379939_1939656,CM021101.1,2,29379939,68078569,6140934,1939656,70018225,32196129
29379939_1939663,CM021101.1,2,29379939,68078569,6140934,1939663,70018232,32196136
29379939_1939714,CM021101.1,2,29379939,68078569,6140934,1939714,70018283,32196187
29380254_1956646,CM021101.1,2,29380254,68079322,2868325,1956646,70035968,32213872
29378152_277254,CM021101.1,2,29378152,69762672,1268326,277254,70039926,32217830
29378152_277259,CM021101.1,2,29378152,69762672,1268326,277259,70039931,32217835
29380208_286422,CM021101.1,2,29380208,69762658,350156,286422,70049080,32226984
29380208_286487,CM021101.1,2,29380208,69762658,350156,286487,70049145,32227049
29380208_286493,CM021101.1,2,29380208,69762658,350156,286493,70049151,32227055
29379107_288577,CM021101.1,2,29379107,69762672,1663043,288577,70051249,32229153
29379107_288756,CM021101.1,2,29379107,69762672,1663043,288756,70051428,32229332
29379107_288757,CM021101.1,2,29379107,69762672,1663043,288757,70051429,32229333
29379107_288770,CM021101.1,2,29379107,69762672,1663043,288770,70051442,32229346
29379107_291584,CM021101.1,2,29379107,69762672,1663043,291584,70054256,32232160
29379107_291591,CM021101.1,2,29379107,69762672,1663043,291591,70054263,32232167
29379107_291671,CM021101.1,2,29379107,69762672,1663043,291671,70054343,32232247
29379107_291695,CM021101.1,2,29379107,69762672,1663043,291695,70054367,32232271
29380971_1987642,CM021101.1,2,29380971,68078446,10587983,1987642,70066088,32243992
29380971_1987648,CM021101.1,2,29380971,68078446,10587983,1987648,70066094,32243998
29380971_1989537,CM021101.1,2,29380971,68078446,10587983,1989537,70067983,32245887
29377609_320933,CM021101.1,2,29377609,69762671,7199949,320933,70083604,32261508
29379167_2006445,CM021101.1,2,29379167,68078444,2533469,2006445,70084889,32262793
29377614_327178,CM021101.1,2,29377614,69762672,2006507,327178,70089850,32267754
29379361_337931,CM021101.1,2,29379361,69765569,2934961,337931,70103500,32281404
29380971_2043901,CM021101.1,2,29380971,68078446,10587983,2043901,70122347,32300251
29381257_2056585,CM021101.1,2,29381257,68079506,5296250,2056585,70136091,32313995
29377614_390028,CM021101.1,2,29377614,69762672,2006507,390028,70152700,32330604
29377614_390112,CM021101.1,2,29377614,69762672,2006507,390112,70152784,32330688
29377614_390119,CM021101.1,2,29377614,69762672,2006507,390119,70152791,32330695
29377614_390366,CM021101.1,2,29377614,69762672,2006507,390366,70153038,32330942
29377614_392598,CM021101.1,2,29377614,69762672,2006507,392598,70155270,32333174
29380971_2083525,CM021101.1,2,29380971,68078446,10587983,2083525,70161971,32339875
29380971_2083578,CM021101.1,2,29380971,68078446,10587983,2083578,70162024,32339928
29380971_2092825,CM021101.1,2,29380971,68078446,10587983,2092825,70171271,32349175
29379107_436520,CM021101.1,2,29379107,69762672,1663043,436520,70199192,32377096
29379107_436632,CM021101.1,2,29379107,69762672,1663043,436632,70199304,32377208
29379107_458170,CM021101.1,2,29379107,69762672,1663043,458170,70220842,32398746
29379107_458246,CM021101.1,2,29379107,69762672,1663043,458246,70220918,32398822
29382409_2148773,CM021101.1,2,29382409,68078447,2974519,2148773,70227220,32405124
29382409_2148795,CM021101.1,2,29382409,68078447,2974519,2148795,70227242,32405146
29382409_2149728,CM021101.1,2,29382409,68078447,2974519,2149728,70228175,32406079
29382409_2150684,CM021101.1,2,29382409,68078447,2974519,2150684,70229131,32407035
29382409_2150685,CM021101.1,2,29382409,68078447,2974519,2150685,70229132,32407036
29377614_468580,CM021101.1,2,29377614,69762672,2006507,468580,70231252,32409156
29380392_469068,CM021101.1,2,29380392,69762669,3366885,469068,70231737,32409641
29380392_469095,CM021101.1,2,29380392,69762669,3366885,469095,70231764,32409668
29380392_469129,CM021101.1,2,29380392,69762669,3366885,469129,70231798,32409702
29380392_469238,CM021101.1,2,29380392,69762669,3366885,469238,70231907,32409811
29380392_469346,CM021101.1,2,29380392,69762669,3366885,469346,70232015,32409919
29382409_2158561,CM021101.1,2,29382409,68078447,2974519,2158561,70237008,32414912
29382409_2158594,CM021101.1,2,29382409,68078447,2974519,2158594,70237041,32414945
29382409_2158660,CM021101.1,2,29382409,68078447,2974519,2158660,70237107,32415011
29382409_2170826,CM021101.1,2,29382409,68078447,2974519,2170826,70249273,32427177
29382409_2170918,CM021101.1,2,29382409,68078447,2974519,2170918,70249365,32427269
29379107_522126,CM021101.1,2,29379107,69762672,1663043,522126,70284798,32462702
29379107_522130,CM021101.1,2,29379107,69762672,1663043,522130,70284802,32462706
29382099_2377019,CM021101.1,2,29382099,68078447,12025197,2377019,70455466,32633370
29379795_2377832,CM021101.1,2,29379795,68078447,4500773,2377832,70456279,32634183
29379795_2377938,CM021101.1,2,29379795,68078447,4500773,2377938,70456385,32634289
29379795_2490993,CM021101.1,2,29379795,68078447,4500773,2490993,70569440,32747344
29379795_2491095,CM021101.1,2,29379795,68078447,4500773,2491095,70569542,32747446
29379795_2491177,CM021101.1,2,29379795,68078447,4500773,2491177,70569624,32747528
29379795_2491443,CM021101.1,2,29379795,68078447,4500773,2491443,70569890,32747794
29379795_2491480,CM021101.1,2,29379795,68078447,4500773,2491480,70569927,32747831
29379795_2491506,CM021101.1,2,29379795,68078447,4500773,2491506,70569953,32747857
29379795_2491508,CM021101.1,2,29379795,68078447,4500773,2491508,70569955,32747859
29379795_2491522,CM021101.1,2,29379795,68078447,4500773,2491522,70569969,32747873
29379795_2491567,CM021101.1,2,29379795,68078447,4500773,2491567,70570014,32747918
29379167_2511995,CM021101.1,2,29379167,68078444,2533469,2511995,70590439,32768343
29379167_2512156,CM021101.1,2,29379167,68078444,2533469,2512156,70590600,32768504
29379167_2512160,CM021101.1,2,29379167,68078444,2533469,2512160,70590604,32768508
29379167_2512181,CM021101.1,2,29379167,68078444,2533469,2512181,70590625,32768529
29379167_2512205,CM021101.1,2,29379167,68078444,2533469,2512205,70590649,32768553
29377614_866292,CM021101.1,2,29377614,69762672,2006507,866292,70628964,32806868
29379810_931676,CM021101.1,2,29379810,69763855,2983394,931676,70695531,32873435
29380971_2639869,CM021101.1,2,29380971,68078446,10587983,2639869,70718315,32896219
29380971_2640001,CM021101.1,2,29380971,68078446,10587983,2640001,70718447,32896351
29377609_959872,CM021101.1,2,29377609,69762671,7199949,959872,70722543,32900447
29377464_2744871,CM021101.1,2,29377464,68078447,4816225,2744871,70823318,33001222
29377001_2749587,CM021101.1,2,29377001,68078447,5575874,2749587,70828034,33005938
29377464_2808136,CM021101.1,2,29377464,68078447,4816225,2808136,70886583,33064487
29377464_2808143,CM021101.1,2,29377464,68078447,4816225,2808143,70886590,33064494
29377464_2808146,CM021101.1,2,29377464,68078447,4816225,2808146,70886593,33064497
29377464_2808182,CM021101.1,2,29377464,68078447,4816225,2808182,70886629,33064533
29380392_1245900,CM021101.1,2,29380392,69762669,3366885,1245900,71008569,33186473
29378920_2959550,CM021101.1,2,29378920,68080236,3462836,2959550,71039786,33217690
29378920_2959553,CM021101.1,2,29378920,68080236,3462836,2959553,71039789,33217693
29377464_3015849,CM021101.1,2,29377464,68078447,4816225,3015849,71094296,33272200
29377464_3015911,CM021101.1,2,29377464,68078447,4816225,3015911,71094358,33272262
29377001_3055166,CM021101.1,2,29377001,68078447,5575874,3055166,71133613,33311517
29377001_3055229,CM021101.1,2,29377001,68078447,5575874,3055229,71133676,33311580
29377464_3122462,CM021101.1,2,29377464,68078447,4816225,3122462,71200909,33378813
29377464_3122539,CM021101.1,2,29377464,68078447,4816225,3122539,71200986,33378890
29379795_3131194,CM021101.1,2,29379795,68078447,4500773,3131194,71209641,33387545
29379795_3131236,CM021101.1,2,29379795,68078447,4500773,3131236,71209683,33387587
29377614_1460070,CM021101.1,2,29377614,69762672,2006507,1460070,71222742,33400646
29377464_3152828,CM021101.1,2,29377464,68078447,4816225,3152828,71231275,33409179
29377001_3190543,CM021101.1,2,29377001,68078447,5575874,3190543,71268990,33446894
29377614_1634318,CM021101.1,2,29377614,69762672,2006507,1634318,71396990,33574894
29377614_1634408,CM021101.1,2,29377614,69762672,2006507,1634408,71397080,33574984
29379810_1716371,CM021101.1,2,29379810,69763855,2983394,1716371,71480226,33658130
29379810_1719584,CM021101.1,2,29379810,69763855,2983394,1719584,71483439,33661343
29380392_1732100,CM021101.1,2,29380392,69762669,3366885,1732100,71494769,33672673
29380392_1732155,CM021101.1,2,29380392,69762669,3366885,1732155,71494824,33672728
29379810_1748138,CM021101.1,2,29379810,69763855,2983394,1748138,71511993,33689897
29378920_3440661,CM021101.1,2,29378920,68080236,3462836,3440661,71520897,33698801
29378920_3442005,CM021101.1,2,29378920,68080236,3462836,3442005,71522241,33700145
29379361_1805719,CM021101.1,2,29379361,69765569,2934961,1805719,71571288,33749192
29379361_1805804,CM021101.1,2,29379361,69765569,2934961,1805804,71571373,33749277
29377001_3554824,CM021101.1,2,29377001,68078447,5575874,3554824,71633271,33811175
29377001_3554997,CM021101.1,2,29377001,68078447,5575874,3554997,71633444,33811348
29377001_3555066,CM021101.1,2,29377001,68078447,5575874,3555066,71633513,33811417
29377001_3555090,CM021101.1,2,29377001,68078447,5575874,3555090,71633537,33811441
29377001_3555129,CM021101.1,2,29377001,68078447,5575874,3555129,71633576,33811480
29377001_3555132,CM021101.1,2,29377001,68078447,5575874,3555132,71633579,33811483
29377001_3556249,CM021101.1,2,29377001,68078447,5575874,3556249,71634696,33812600
29377001_3556395,CM021101.1,2,29377001,68078447,5575874,3556395,71634842,33812746
29377464_3604438,CM021101.1,2,29377464,68078447,4816225,3604438,71682885,33860789
29377464_3604526,CM021101.1,2,29377464,68078447,4816225,3604526,71682973,33860877
29377464_3642545,CM021101.1,2,29377464,68078447,4816225,3642545,71720992,33898896
29377464_3694158,CM021101.1,2,29377464,68078447,4816225,3694158,71772605,33950509
29377423_2030300,CM021101.1,2,29377423,69762671,2331012,2030300,71792971,33970875
29377464_3798574,CM021101.1,2,29377464,68078447,4816225,3798574,71877021,34054925
29377464_3883449,CM021101.1,2,29377464,68078447,4816225,3883449,71961896,34139800
29377464_3883491,CM021101.1,2,29377464,68078447,4816225,3883491,71961938,34139842
29377464_3883521,CM021101.1,2,29377464,68078447,4816225,3883521,71961968,34139872
29377464_3883544,CM021101.1,2,29377464,68078447,4816225,3883544,71961991,34139895
29377464_3883688,CM021101.1,2,29377464,68078447,4816225,3883688,71962135,34140039
29377464_3883696,CM021101.1,2,29377464,68078447,4816225,3883696,71962143,34140047
29377609_2255350,CM021101.1,2,29377609,69762671,7199949,2255350,72018021,34195925
29377609_2255379,CM021101.1,2,29377609,69762671,7199949,2255379,72018050,34195954
29377423_2266528,CM021101.1,2,29377423,69762671,2331012,2266528,72029199,34207103
29379939_3972441,CM021101.1,2,29379939,68078569,6140934,3972441,72051010,34228914
29379939_3972862,CM021101.1,2,29379939,68078569,6140934,3972862,72051431,34229335
29377464_4014131,CM021101.1,2,29377464,68078447,4816225,4014131,72092578,34270482
29377464_4014194,CM021101.1,2,29377464,68078447,4816225,4014194,72092641,34270545
29377464_4014239,CM021101.1,2,29377464,68078447,4816225,4014239,72092686,34270590
29377464_4063681,CM021101.1,2,29377464,68078447,4816225,4063681,72142128,34320032
29377001_4086666,CM021101.1,2,29377001,68078447,5575874,4086666,72165113,34343017
29377001_4086716,CM021101.1,2,29377001,68078447,5575874,4086716,72165163,34343067
29377001_4086844,CM021101.1,2,29377001,68078447,5575874,4086844,72165291,34343195
29377001_4086845,CM021101.1,2,29377001,68078447,5575874,4086845,72165292,34343196
29377001_4086893,CM021101.1,2,29377001,68078447,5575874,4086893,72165340,34343244
29377001_4087317,CM021101.1,2,29377001,68078447,5575874,4087317,72165764,34343668
29380971_4178636,CM021101.1,2,29380971,68078446,10587983,4178636,72257082,34434986
29377464_4214780,CM021101.1,2,29377464,68078447,4816225,4214780,72293227,34471131
29377464_4214812,CM021101.1,2,29377464,68078447,4816225,4214812,72293259,34471163
29377609_2578570,CM021101.1,2,29377609,69762671,7199949,2578570,72341241,34519145
29377609_2581011,CM021101.1,2,29377609,69762671,7199949,2581011,72343682,34521586
29377609_2610143,CM021101.1,2,29377609,69762671,7199949,2610143,72372814,34550718
29377464_4301350,CM021101.1,2,29377464,68078447,4816225,4301350,72379797,34557701
29379810_2671433,CM021101.1,2,29379810,69763855,2983394,2671433,72435288,34613192
29379810_2671471,CM021101.1,2,29379810,69763855,2983394,2671471,72435326,34613230
29377464_4425946,CM021101.1,2,29377464,68078447,4816225,4425946,72504393,34682297
29377464_4425947,CM021101.1,2,29377464,68078447,4816225,4425947,72504394,34682298
29377464_4425953,CM021101.1,2,29377464,68078447,4816225,4425953,72504400,34682304
29377464_4426021,CM021101.1,2,29377464,68078447,4816225,4426021,72504468,34682372
29378258_2815579,CM021101.1,2,29378258,69762663,4660680,2815579,72578242,34756146
29381257_4522360,CM021101.1,2,29381257,68079506,5296250,4522360,72601866,34779770
29378258_2873697,CM021101.1,2,29378258,69762663,4660680,2873697,72636360,34814264
29378258_2873739,CM021101.1,2,29378258,69762663,4660680,2873739,72636402,34814306
29379939_4568172,CM021101.1,2,29379939,68078569,6140934,4568172,72646741,34824645
29379939_4568215,CM021101.1,2,29379939,68078569,6140934,4568215,72646784,34824688
29379939_4568291,CM021101.1,2,29379939,68078569,6140934,4568291,72646860,34824764
29379939_4568331,CM021101.1,2,29379939,68078569,6140934,4568331,72646900,34824804
29379939_4568358,CM021101.1,2,29379939,68078569,6140934,4568358,72646927,34824831
29377464_4683294,CM021101.1,2,29377464,68078447,4816225,4683294,72761741,34939645
29377464_4683417,CM021101.1,2,29377464,68078447,4816225,4683417,72761864,34939768
29377464_4683491,CM021101.1,2,29377464,68078447,4816225,4683491,72761938,34939842
29379939_4757677,CM021101.1,2,29379939,68078569,6140934,4757677,72836246,35014150
29380971_5038722,CM021101.1,2,29380971,68078446,10587983,5038722,73117168,35295072
29381257_5042777,CM021101.1,2,29381257,68079506,5296250,5042777,73122283,35300187
29381257_5042818,CM021101.1,2,29381257,68079506,5296250,5042818,73122324,35300228
29381257_5042839,CM021101.1,2,29381257,68079506,5296250,5042839,73122345,35300249
29381257_5046331,CM021101.1,2,29381257,68079506,5296250,5046331,73125837,35303741
29378258_3368059,CM021101.1,2,29378258,69762663,4660680,3368059,73130722,35308626
29378258_3368062,CM021101.1,2,29378258,69762663,4660680,3368062,73130725,35308629
29378258_3368096,CM021101.1,2,29378258,69762663,4660680,3368096,73130759,35308663
29378258_3368134,CM021101.1,2,29378258,69762663,4660680,3368134,73130797,35308701
29378258_3368164,CM021101.1,2,29378258,69762663,4660680,3368164,73130827,35308731
29381257_5079056,CM021101.1,2,29381257,68079506,5296250,5079056,73158562,35336466
29381257_5079157,CM021101.1,2,29381257,68079506,5296250,5079157,73158663,35336567
29381257_5079183,CM021101.1,2,29381257,68079506,5296250,5079183,73158689,35336593
29379939_5206949,CM021101.1,2,29379939,68078569,6140934,5206949,73285518,35463422
29379939_5207017,CM021101.1,2,29379939,68078569,6140934,5207017,73285586,35463490
29379939_5207255,CM021101.1,2,29379939,68078569,6140934,5207255,73285824,35463728
29379939_5207472,CM021101.1,2,29379939,68078569,6140934,5207472,73286041,35463945
29380971_5245081,CM021101.1,2,29380971,68078446,10587983,5245081,73323527,35501431
29380971_5245263,CM021101.1,2,29380971,68078446,10587983,5245263,73323709,35501613
29380971_5245281,CM021101.1,2,29380971,68078446,10587983,5245281,73323727,35501631
29378258_3844442,CM021101.1,2,29378258,69762663,4660680,3844442,73607105,35785009
29377001_5541359,CM021101.1,2,29377001,68078447,5575874,5541359,73619806,35797710
29377001_5541376,CM021101.1,2,29377001,68078447,5575874,5541376,73619823,35797727
29377001_5541380,CM021101.1,2,29377001,68078447,5575874,5541380,73619827,35797731
29377001_5541382,CM021101.1,2,29377001,68078447,5575874,5541382,73619829,35797733
29377001_5541392,CM021101.1,2,29377001,68078447,5575874,5541392,73619839,35797743
29377001_5541416,CM021101.1,2,29377001,68078447,5575874,5541416,73619863,35797767
29379939_5579903,CM021101.1,2,29379939,68078569,6140934,5579903,73658472,35836376
29379939_5579945,CM021101.1,2,29379939,68078569,6140934,5579945,73658514,35836418
29379939_5580010,CM021101.1,2,29379939,68078569,6140934,5580010,73658579,35836483
29379939_5580011,CM021101.1,2,29379939,68078569,6140934,5580011,73658580,35836484
29379939_5580014,CM021101.1,2,29379939,68078569,6140934,5580014,73658583,35836487
29382099_5692296,CM021101.1,2,29382099,68078447,12025197,5692296,73770743,35948647
29378258_4058042,CM021101.1,2,29378258,69762663,4660680,4058042,73820705,35998609
29378258_4058053,CM021101.1,2,29378258,69762663,4660680,4058053,73820716,35998620
29378258_4058090,CM021101.1,2,29378258,69762663,4660680,4058090,73820753,35998657
29378258_4058092,CM021101.1,2,29378258,69762663,4660680,4058092,73820755,35998659
29378258_4058096,CM021101.1,2,29378258,69762663,4660680,4058096,73820759,35998663
29378258_4058237,CM021101.1,2,29378258,69762663,4660680,4058237,73820900,35998804
29378258_4058246,CM021101.1,2,29378258,69762663,4660680,4058246,73820909,35998813
29378258_4158030,CM021101.1,2,29378258,69762663,4660680,4158030,73920693,36098597
29378258_4158102,CM021101.1,2,29378258,69762663,4660680,4158102,73920765,36098669
29380971_5961359,CM021101.1,2,29380971,68078446,10587983,5961359,74039805,36217709
29378258_4285015,CM021101.1,2,29378258,69762663,4660680,4285015,74047678,36225582
29378258_4295550,CM021101.1,2,29378258,69762663,4660680,4295550,74058213,36236117
29378258_4295622,CM021101.1,2,29378258,69762663,4660680,4295622,74058285,36236189
29382099_5993785,CM021101.1,2,29382099,68078447,12025197,5993785,74072232,36250136
29382099_5993810,CM021101.1,2,29382099,68078447,12025197,5993810,74072257,36250161
29382099_5993862,CM021101.1,2,29382099,68078447,12025197,5993862,74072309,36250213
29382099_5993911,CM021101.1,2,29382099,68078447,12025197,5993911,74072358,36250262
29382099_6023888,CM021101.1,2,29382099,68078447,12025197,6023888,74102335,36280239
29382099_6023928,CM021101.1,2,29382099,68078447,12025197,6023928,74102375,36280279
29382099_6182519,CM021101.1,2,29382099,68078447,12025197,6182519,74260966,36438870
29382099_6182591,CM021101.1,2,29382099,68078447,12025197,6182591,74261038,36438942
29382099_6182609,CM021101.1,2,29382099,68078447,12025197,6182609,74261056,36438960
29382099_6777072,CM021101.1,2,29382099,68078447,12025197,6777072,74855519,37033423
29377609_5944463,CM021101.1,2,29377609,69762671,7199949,5944463,75707134,37885038
29377609_5944490,CM021101.1,2,29377609,69762671,7199949,5944490,75707161,37885065
29377609_6072293,CM021101.1,2,29377609,69762671,7199949,6072293,75834964,38012868
29377609_6072325,CM021101.1,2,29377609,69762671,7199949,6072325,75834996,38012900
29377609_6072342,CM021101.1,2,29377609,69762671,7199949,6072342,75835013,38012917
29377609_6072365,CM021101.1,2,29377609,69762671,7199949,6072365,75835036,38012940
29377609_6072367,CM021101.1,2,29377609,69762671,7199949,6072367,75835038,38012942
29377609_6072438,CM021101.1,2,29377609,69762671,7199949,6072438,75835109,38013013
29377609_6122307,CM021101.1,2,29377609,69762671,7199949,6122307,75884978,38062882
29377609_6178195,CM021101.1,2,29377609,69762671,7199949,6178195,75940866,38118770
29377609_6178693,CM021101.1,2,29377609,69762671,7199949,6178693,75941364,38119268
29380971_7954118,CM021101.1,2,29380971,68078446,10587983,7954118,76032564,38210468
29377609_6321440,CM021101.1,2,29377609,69762671,7199949,6321440,76084111,38262015
29377609_6321554,CM021101.1,2,29377609,69762671,7199949,6321554,76084225,38262129
29377609_6387325,CM021101.1,2,29377609,69762671,7199949,6387325,76149996,38327900
29377609_6387420,CM021101.1,2,29377609,69762671,7199949,6387420,76150091,38327995
29377609_6387478,CM021101.1,2,29377609,69762671,7199949,6387478,76150149,38328053
29377609_6387532,CM021101.1,2,29377609,69762671,7199949,6387532,76150203,38328107
29362083_28691,CM021101.1,2,29362083,76643318,82622,28691,76672009,38849913
29362083_60609,CM021101.1,2,29362083,76643318,82622,60609,76703927,38881831
29382099_8743965,CM021101.1,2,29382099,68078447,12025197,8743965,76822412,39000316
29351284_51619,CM021101.1,2,29351284,103976296,182560,51619,104027915,66205819
29351284_51634,CM021101.1,2,29351284,103976296,182560,51634,104027930,66205834
29351284_51651,CM021101.1,2,29351284,103976296,182560,51651,104027947,66205851
29351284_51661,CM021101.1,2,29351284,103976296,182560,51661,104027957,66205861
29351284_51663,CM021101.1,2,29351284,103976296,182560,51663,104027959,66205863
29351284_51672,CM021101.1,2,29351284,103976296,182560,51672,104027968,66205872
29351284_51673,CM021101.1,2,29351284,103976296,182560,51673,104027969,66205873
29351284_51694,CM021101.1,2,29351284,103976296,182560,51694,104027990,66205894
29380672_297381,CM021101.1,2,29380672,103976466,337807,297381,104273847,66451751
29380672_297382,CM021101.1,2,29380672,103976466,337807,297382,104273848,66451752
29380672_297391,CM021101.1,2,29380672,103976466,337807,297391,104273857,66451761
29380672_297397,CM021101.1,2,29380672,103976466,337807,297397,104273863,66451767
29380672_297406,CM021101.1,2,29380672,103976466,337807,297406,104273872,66451776
29380672_297437,CM021101.1,2,29380672,103976466,337807,297437,104273903,66451807
29380672_297466,CM021101.1,2,29380672,103976466,337807,297466,104273932,66451836
29381251_35727,CM021101.1,2,29381251,120577527,529964,35727,120613254,82791158
29381251_262215,CM021101.1,2,29381251,120577527,529964,262215,120839742,83017646
29379482_3477,CM021101.1,2,29379482,125728220,6288347,3477,125731697,87909601
29377078_61117,CM021101.1,2,29377078,125732214,1118929,61117,125793331,87971235
29377078_61245,CM021101.1,2,29377078,125732214,1118929,61245,125793459,87971363
29377078_61280,CM021101.1,2,29377078,125732214,1118929,61280,125793494,87971398
29377078_61291,CM021101.1,2,29377078,125732214,1118929,61291,125793505,87971409
29377078_61342,CM021101.1,2,29377078,125732214,1118929,61342,125793556,87971460
29379482_1000893,CM021101.1,2,29379482,125728220,6288347,1000893,126729113,88907017
29379482_1000922,CM021101.1,2,29379482,125728220,6288347,1000922,126729142,88907046
29379482_1000945,CM021101.1,2,29379482,125728220,6288347,1000945,126729165,88907069
29379482_1055178,CM021101.1,2,29379482,125728220,6288347,1055178,126783398,88961302
29379482_1055187,CM021101.1,2,29379482,125728220,6288347,1055187,126783407,88961311
29379482_1055205,CM021101.1,2,29379482,125728220,6288347,1055205,126783425,88961329
29379482_1055299,CM021101.1,2,29379482,125728220,6288347,1055299,126783519,88961423
29379482_1055609,CM021101.1,2,29379482,125728220,6288347,1055609,126783829,88961733
29379482_1055617,CM021101.1,2,29379482,125728220,6288347,1055617,126783837,88961741
29379482_1055622,CM021101.1,2,29379482,125728220,6288347,1055622,126783842,88961746
29379482_1187326,CM021101.1,2,29379482,125728220,6288347,1187326,126915546,89093450
29379482_1187339,CM021101.1,2,29379482,125728220,6288347,1187339,126915559,89093463
29379482_1204052,CM021101.1,2,29379482,125728220,6288347,1204052,126932272,89110176
29379482_1256419,CM021101.1,2,29379482,125728220,6288347,1256419,126984639,89162543
29379482_1257779,CM021101.1,2,29379482,125728220,6288347,1257779,126985999,89163903
29379482_1268105,CM021101.1,2,29379482,125728220,6288347,1268105,126996325,89174229
29379482_1272884,CM021101.1,2,29379482,125728220,6288347,1272884,127001104,89179008
29379482_1273369,CM021101.1,2,29379482,125728220,6288347,1273369,127001589,89179493
29379482_1705363,CM021101.1,2,29379482,125728220,6288347,1705363,127433583,89611487
29379482_1705422,CM021101.1,2,29379482,125728220,6288347,1705422,127433642,89611546
29379482_1705430,CM021101.1,2,29379482,125728220,6288347,1705430,127433650,89611554
29379482_1705450,CM021101.1,2,29379482,125728220,6288347,1705450,127433670,89611574
29379482_1705463,CM021101.1,2,29379482,125728220,6288347,1705463,127433683,89611587
29379482_1705501,CM021101.1,2,29379482,125728220,6288347,1705501,127433721,89611625
29379482_1972129,CM021101.1,2,29379482,125728220,6288347,1972129,127700349,89878253
29379482_1972336,CM021101.1,2,29379482,125728220,6288347,1972336,127700556,89878460
29379482_2279280,CM021101.1,2,29379482,125728220,6288347,2279280,128007500,90185404
29379482_2764723,CM021101.1,2,29379482,125728220,6288347,2764723,128492943,90670847
29379482_2764787,CM021101.1,2,29379482,125728220,6288347,2764787,128493007,90670911
29379482_2766136,CM021101.1,2,29379482,125728220,6288347,2766136,128494356,90672260
29379482_2766546,CM021101.1,2,29379482,125728220,6288347,2766546,128494766,90672670
29379482_2766618,CM021101.1,2,29379482,125728220,6288347,2766618,128494838,90672742
29379482_2767205,CM021101.1,2,29379482,125728220,6288347,2767205,128495425,90673329
29379482_2767248,CM021101.1,2,29379482,125728220,6288347,2767248,128495468,90673372
29379482_2924403,CM021101.1,2,29379482,125728220,6288347,2924403,128652623,90830527
29379482_2924488,CM021101.1,2,29379482,125728220,6288347,2924488,128652708,90830612
29379482_2924585,CM021101.1,2,29379482,125728220,6288347,2924585,128652805,90830709
29379482_3481561,CM021101.1,2,29379482,125728220,6288347,3481561,129209781,91387685
29379482_3926295,CM021101.1,2,29379482,125728220,6288347,3926295,129654515,91832419
29379482_3926377,CM021101.1,2,29379482,125728220,6288347,3926377,129654597,91832501
29379482_3926677,CM021101.1,2,29379482,125728220,6288347,3926677,129654897,91832801
29379482_4491053,CM021101.1,2,29379482,125728220,6288347,4491053,130219273,92397177
29379482_5121337,CM021101.1,2,29379482,125728220,6288347,5121337,130849557,93027461
29379482_5121356,CM021101.1,2,29379482,125728220,6288347,5121356,130849576,93027480
29379482_5121357,CM021101.1,2,29379482,125728220,6288347,5121357,130849577,93027481
29379482_5121373,CM021101.1,2,29379482,125728220,6288347,5121373,130849593,93027497
29379482_5121385,CM021101.1,2,29379482,125728220,6288347,5121385,130849605,93027509
29379482_5121447,CM021101.1,2,29379482,125728220,6288347,5121447,130849667,93027571
29379482_5496930,CM021101.1,2,29379482,125728220,6288347,5496930,131225150,93403054
29379482_6191064,CM021101.1,2,29379482,125728220,6288347,6191064,131919284,94097188
29379482_6204068,CM021101.1,2,29379482,125728220,6288347,6204068,131932288,94110192
29379482_6210584,CM021101.1,2,29379482,125728220,6288347,6210584,131938804,94116708
29379482_6211118,CM021101.1,2,29379482,125728220,6288347,6211118,131939338,94117242
29379482_6211181,CM021101.1,2,29379482,125728220,6288347,6211181,131939401,94117305
29379482_6216542,CM021101.1,2,29379482,125728220,6288347,6216542,131944762,94122666
29379482_6216733,CM021101.1,2,29379482,125728220,6288347,6216733,131944953,94122857
29379482_6217002,CM021101.1,2,29379482,125728220,6288347,6217002,131945222,94123126
29377616_927,CM021101.1,2,29377616,145700899,728027,927,145701826,107879730
29381471_18366,CM021101.1,2,29381471,145700800,2013222,18366,145719166,107897070
29379056_38325,CM021101.1,2,29379056,145699179,261476,38325,145737504,107915408
29382198_94418,CM021101.1,2,29382198,145700278,611693,94418,145794696,107972600
29380376_97060,CM021101.1,2,29380376,145701604,296358,97060,145798664,107976568
29380376_97085,CM021101.1,2,29380376,145701604,296358,97085,145798689,107976593
29380376_97112,CM021101.1,2,29380376,145701604,296358,97112,145798716,107976620
29380376_97167,CM021101.1,2,29380376,145701604,296358,97167,145798771,107976675
29380642_440230,CM021101.1,2,29380642,145413479,1230478,440230,145853709,108031613
29380642_440617,CM021101.1,2,29380642,145413479,1230478,440617,145854096,108032000
29380642_440631,CM021101.1,2,29380642,145413479,1230478,440631,145854110,108032014
29380642_444235,CM021101.1,2,29380642,145413479,1230478,444235,145857714,108035618
29380642_444281,CM021101.1,2,29380642,145413479,1230478,444281,145857760,108035664
29380642_444351,CM021101.1,2,29380642,145413479,1230478,444351,145857830,108035734
29380642_444383,CM021101.1,2,29380642,145413479,1230478,444383,145857862,108035766
29380642_444437,CM021101.1,2,29380642,145413479,1230478,444437,145857916,108035820
29380642_444445,CM021101.1,2,29380642,145413479,1230478,444445,145857924,108035828
29381972_173812,CM021101.1,2,29381972,145699176,641877,173812,145872988,108050892
29382198_238820,CM021101.1,2,29382198,145700278,611693,238820,145939098,108117002
29382198_238880,CM021101.1,2,29382198,145700278,611693,238880,145939158,108117062
29382198_238882,CM021101.1,2,29382198,145700278,611693,238882,145939160,108117064
29382198_238895,CM021101.1,2,29382198,145700278,611693,238895,145939173,108117077
29382198_238897,CM021101.1,2,29382198,145700278,611693,238897,145939175,108117079
29382198_238905,CM021101.1,2,29382198,145700278,611693,238905,145939183,108117087
29382198_238909,CM021101.1,2,29382198,145700278,611693,238909,145939187,108117091
29382198_238924,CM021101.1,2,29382198,145700278,611693,238924,145939202,108117106
29380903_271207,CM021101.1,2,29380903,145702127,1035856,271207,145973334,108151238
29377726_319179,CM021101.1,2,29377726,145700725,2669241,319179,146019904,108197808
29377726_319258,CM021101.1,2,29377726,145700725,2669241,319258,146019983,108197887
29377726_319269,CM021101.1,2,29377726,145700725,2669241,319269,146019994,108197898
29377726_319322,CM021101.1,2,29377726,145700725,2669241,319322,146020047,108197951
29380090_377749,CM021101.1,2,29380090,145702587,1945924,377749,146080336,108258240
29380090_377831,CM021101.1,2,29380090,145702587,1945924,377831,146080418,108258322
29380090_377838,CM021101.1,2,29380090,145702587,1945924,377838,146080425,108258329
29381471_422493,CM021101.1,2,29381471,145700800,2013222,422493,146123293,108301197
29381471_422571,CM021101.1,2,29381471,145700800,2013222,422571,146123371,108301275
29381471_426720,CM021101.1,2,29381471,145700800,2013222,426720,146127520,108305424
29380219_466825,CM021101.1,2,29380219,145701017,2147537,466825,146167842,108345746
29380219_466930,CM021101.1,2,29380219,145701017,2147537,466930,146167947,108345851
29377726_500589,CM021101.1,2,29377726,145700725,2669241,500589,146201314,108379218
29381471_517868,CM021101.1,2,29381471,145700800,2013222,517868,146218668,108396572
29381471_517872,CM021101.1,2,29381471,145700800,2013222,517872,146218672,108396576
29381471_517875,CM021101.1,2,29381471,145700800,2013222,517875,146218675,108396579
29381471_517878,CM021101.1,2,29381471,145700800,2013222,517878,146218678,108396582
29381471_517881,CM021101.1,2,29381471,145700800,2013222,517881,146218681,108396585
29381471_517904,CM021101.1,2,29381471,145700800,2013222,517904,146218704,108396608
29381471_517909,CM021101.1,2,29381471,145700800,2013222,517909,146218709,108396613
29381471_517917,CM021101.1,2,29381471,145700800,2013222,517917,146218717,108396621
29381471_517939,CM021101.1,2,29381471,145700800,2013222,517939,146218739,108396643
29381471_517948,CM021101.1,2,29381471,145700800,2013222,517948,146218748,108396652
29381471_518792,CM021101.1,2,29381471,145700800,2013222,518792,146219592,108397496
29381471_518822,CM021101.1,2,29381471,145700800,2013222,518822,146219622,108397526
29381471_518823,CM021101.1,2,29381471,145700800,2013222,518823,146219623,108397527
29381471_518853,CM021101.1,2,29381471,145700800,2013222,518853,146219653,108397557
29381471_518884,CM021101.1,2,29381471,145700800,2013222,518884,146219684,108397588
29381471_518892,CM021101.1,2,29381471,145700800,2013222,518892,146219692,108397596
29381471_518939,CM021101.1,2,29381471,145700800,2013222,518939,146219739,108397643
29378058_534130,CM021101.1,2,29378058,145699660,4277888,534130,146233790,108411694
29382152_552387,CM021101.1,2,29382152,145700804,1893740,552387,146253191,108431095
29382152_552405,CM021101.1,2,29382152,145700804,1893740,552405,146253209,108431113
29382152_552447,CM021101.1,2,29382152,145700804,1893740,552447,146253251,108431155
29382152_552450,CM021101.1,2,29382152,145700804,1893740,552450,146253254,108431158
29382152_552459,CM021101.1,2,29382152,145700804,1893740,552459,146253263,108431167
29382152_552488,CM021101.1,2,29382152,145700804,1893740,552488,146253292,108431196
29377726_565197,CM021101.1,2,29377726,145700725,2669241,565197,146265922,108443826
29377726_565245,CM021101.1,2,29377726,145700725,2669241,565245,146265970,108443874
29377726_565259,CM021101.1,2,29377726,145700725,2669241,565259,146265984,108443888
29377726_565302,CM021101.1,2,29377726,145700725,2669241,565302,146266027,108443931
29377726_565324,CM021101.1,2,29377726,145700725,2669241,565324,146266049,108443953
29377726_565325,CM021101.1,2,29377726,145700725,2669241,565325,146266050,108443954
29377726_565412,CM021101.1,2,29377726,145700725,2669241,565412,146266137,108444041
29382152_576552,CM021101.1,2,29382152,145700804,1893740,576552,146277356,108455260
29382152_576598,CM021101.1,2,29382152,145700804,1893740,576598,146277402,108455306
29377513_613944,CM021101.1,2,29377513,145701464,3846708,613944,146315408,108493312
29377513_613951,CM021101.1,2,29377513,145701464,3846708,613951,146315415,108493319
29377513_614528,CM021101.1,2,29377513,145701464,3846708,614528,146315992,108493896
29377513_614565,CM021101.1,2,29377513,145701464,3846708,614565,146316029,108493933
29377513_614591,CM021101.1,2,29377513,145701464,3846708,614591,146316055,108493959
29377513_614718,CM021101.1,2,29377513,145701464,3846708,614718,146316182,108494086
29380219_657817,CM021101.1,2,29380219,145701017,2147537,657817,146358834,108536738
29380903_659651,CM021101.1,2,29380903,145702127,1035856,659651,146361778,108539682
29379428_667912,CM021101.1,2,29379428,145700168,2125904,667912,146368080,108545984
29379428_668044,CM021101.1,2,29379428,145700168,2125904,668044,146368212,108546116
29379428_668045,CM021101.1,2,29379428,145700168,2125904,668045,146368213,108546117
29380903_687133,CM021101.1,2,29380903,145702127,1035856,687133,146389260,108567164
29380903_687181,CM021101.1,2,29380903,145702127,1035856,687181,146389308,108567212
29380903_687185,CM021101.1,2,29380903,145702127,1035856,687185,146389312,108567216
29380903_726494,CM021101.1,2,29380903,145702127,1035856,726494,146428621,108606525
29380903_726501,CM021101.1,2,29380903,145702127,1035856,726501,146428628,108606532
29380903_726523,CM021101.1,2,29380903,145702127,1035856,726523,146428650,108606554
29380903_726568,CM021101.1,2,29380903,145702127,1035856,726568,146428695,108606599
29380903_726577,CM021101.1,2,29380903,145702127,1035856,726577,146428704,108606608
29380903_726601,CM021101.1,2,29380903,145702127,1035856,726601,146428728,108606632
29380903_726635,CM021101.1,2,29380903,145702127,1035856,726635,146428762,108606666
29380903_726648,CM021101.1,2,29380903,145702127,1035856,726648,146428775,108606679
29380903_726722,CM021101.1,2,29380903,145702127,1035856,726722,146428849,108606753
29380903_726742,CM021101.1,2,29380903,145702127,1035856,726742,146428869,108606773
29380903_726918,CM021101.1,2,29380903,145702127,1035856,726918,146429045,108606949
29380903_726930,CM021101.1,2,29380903,145702127,1035856,726930,146429057,108606961
29380903_726964,CM021101.1,2,29380903,145702127,1035856,726964,146429091,108606995
29380903_727039,CM021101.1,2,29380903,145702127,1035856,727039,146429166,108607070
29380903_727042,CM021101.1,2,29380903,145702127,1035856,727042,146429169,108607073
29380903_727044,CM021101.1,2,29380903,145702127,1035856,727044,146429171,108607075
29380903_727054,CM021101.1,2,29380903,145702127,1035856,727054,146429181,108607085
29380903_727060,CM021101.1,2,29380903,145702127,1035856,727060,146429187,108607091
29380903_727140,CM021101.1,2,29380903,145702127,1035856,727140,146429267,108607171
29380903_727164,CM021101.1,2,29380903,145702127,1035856,727164,146429291,108607195
29380903_727179,CM021101.1,2,29380903,145702127,1035856,727179,146429306,108607210
29380903_727204,CM021101.1,2,29380903,145702127,1035856,727204,146429331,108607235
29380903_727222,CM021101.1,2,29380903,145702127,1035856,727222,146429349,108607253
29380903_727238,CM021101.1,2,29380903,145702127,1035856,727238,146429365,108607269
29380903_727240,CM021101.1,2,29380903,145702127,1035856,727240,146429367,108607271
29380903_727279,CM021101.1,2,29380903,145702127,1035856,727279,146429406,108607310
29380903_727306,CM021101.1,2,29380903,145702127,1035856,727306,146429433,108607337
29380642_1030092,CM021101.1,2,29380642,145413479,1230478,1030092,146443571,108621475
29377488_782784,CM021101.1,2,29377488,145700519,2185196,782784,146483303,108661207
29377488_782843,CM021101.1,2,29377488,145700519,2185196,782843,146483362,108661266
29381454_790669,CM021101.1,2,29381454,145700075,2527386,790669,146490744,108668648
29381454_790701,CM021101.1,2,29381454,145700075,2527386,790701,146490776,108668680
29381454_790707,CM021101.1,2,29381454,145700075,2527386,790707,146490782,108668686
29382152_862185,CM021101.1,2,29382152,145700804,1893740,862185,146562989,108740893
29382152_862201,CM021101.1,2,29382152,145700804,1893740,862201,146563005,108740909
29382152_862231,CM021101.1,2,29382152,145700804,1893740,862231,146563035,108740939
29377513_892666,CM021101.1,2,29377513,145701464,3846708,892666,146594130,108772034
29382152_921211,CM021101.1,2,29382152,145700804,1893740,921211,146622015,108799919
29382152_921290,CM021101.1,2,29382152,145700804,1893740,921290,146622094,108799998
29377488_922462,CM021101.1,2,29377488,145700519,2185196,922462,146622981,108800885
29380090_938521,CM021101.1,2,29380090,145702587,1945924,938521,146641108,108819012
29382152_985928,CM021101.1,2,29382152,145700804,1893740,985928,146686732,108864636
29380090_1084464,CM021101.1,2,29380090,145702587,1945924,1084464,146787051,108964955
29382152_1138690,CM021101.1,2,29382152,145700804,1893740,1138690,146839494,109017398
29382152_1163003,CM021101.1,2,29382152,145700804,1893740,1163003,146863807,109041711
29382152_1163030,CM021101.1,2,29382152,145700804,1893740,1163030,146863834,109041738
29382152_1163492,CM021101.1,2,29382152,145700804,1893740,1163492,146864296,109042200
29382038_1182717,CM021101.1,2,29382038,145699179,3974797,1182717,146881896,109059800
29382152_1204856,CM021101.1,2,29382152,145700804,1893740,1204856,146905660,109083564
29382152_1205243,CM021101.1,2,29382152,145700804,1893740,1205243,146906047,109083951
29377513_1249295,CM021101.1,2,29377513,145701464,3846708,1249295,146950759,109128663
29377513_1249431,CM021101.1,2,29377513,145701464,3846708,1249431,146950895,109128799
29377513_1249449,CM021101.1,2,29377513,145701464,3846708,1249449,146950913,109128817
29378176_1251871,CM021101.1,2,29378176,145699180,1785609,1251871,146951051,109128955
29378176_1252549,CM021101.1,2,29378176,145699180,1785609,1252549,146951729,109129633
29378176_1284691,CM021101.1,2,29378176,145699180,1785609,1284691,146983871,109161775
29378176_1332958,CM021101.1,2,29378176,145699180,1785609,1332958,147032138,109210042
29382152_1336100,CM021101.1,2,29382152,145700804,1893740,1336100,147036904,109214808
29382152_1336174,CM021101.1,2,29382152,145700804,1893740,1336174,147036978,109214882
29382152_1336177,CM021101.1,2,29382152,145700804,1893740,1336177,147036981,109214885
29382152_1336180,CM021101.1,2,29382152,145700804,1893740,1336180,147036984,109214888
29382152_1336214,CM021101.1,2,29382152,145700804,1893740,1336214,147037018,109214922
29380995_1351300,CM021101.1,2,29380995,145699183,2524148,1351300,147050483,109228387
29381471_1361699,CM021101.1,2,29381471,145700800,2013222,1361699,147062499,109240403
29381471_1361773,CM021101.1,2,29381471,145700800,2013222,1361773,147062573,109240477
29377726_1369218,CM021101.1,2,29377726,145700725,2669241,1369218,147069943,109247847
29378176_1381394,CM021101.1,2,29378176,145699180,1785609,1381394,147080574,109258478
29378058_1384834,CM021101.1,2,29378058,145699660,4277888,1384834,147084494,109262398
29378058_1384841,CM021101.1,2,29378058,145699660,4277888,1384841,147084501,109262405
29378058_1384844,CM021101.1,2,29378058,145699660,4277888,1384844,147084504,109262408
29378058_1384895,CM021101.1,2,29378058,145699660,4277888,1384895,147084555,109262459
29377513_1428423,CM021101.1,2,29377513,145701464,3846708,1428423,147129887,109307791
29377513_1428426,CM021101.1,2,29377513,145701464,3846708,1428426,147129890,109307794
29377513_1428577,CM021101.1,2,29377513,145701464,3846708,1428577,147130041,109307945
29377513_1428625,CM021101.1,2,29377513,145701464,3846708,1428625,147130089,109307993
29380219_1438248,CM021101.1,2,29380219,145701017,2147537,1438248,147139265,109317169
29380219_1438326,CM021101.1,2,29380219,145701017,2147537,1438326,147139343,109317247
29380219_1438344,CM021101.1,2,29380219,145701017,2147537,1438344,147139361,109317265
29380219_1438401,CM021101.1,2,29380219,145701017,2147537,1438401,147139418,109317322
29380090_1452004,CM021101.1,2,29380090,145702587,1945924,1452004,147154591,109332495
29380090_1452008,CM021101.1,2,29380090,145702587,1945924,1452008,147154595,109332499
29380090_1452022,CM021101.1,2,29380090,145702587,1945924,1452022,147154609,109332513
29380090_1452157,CM021101.1,2,29380090,145702587,1945924,1452157,147154744,109332648
29381471_1460189,CM021101.1,2,29381471,145700800,2013222,1460189,147160989,109338893
29377726_1470058,CM021101.1,2,29377726,145700725,2669241,1470058,147170783,109348687
29382152_1479505,CM021101.1,2,29382152,145700804,1893740,1479505,147180309,109358213
29382152_1479526,CM021101.1,2,29382152,145700804,1893740,1479526,147180330,109358234
29382152_1479574,CM021101.1,2,29382152,145700804,1893740,1479574,147180378,109358282
29378058_1496824,CM021101.1,2,29378058,145699660,4277888,1496824,147196484,109374388
29380219_1513836,CM021101.1,2,29380219,145701017,2147537,1513836,147214853,109392757
29380219_1533688,CM021101.1,2,29380219,145701017,2147537,1533688,147234705,109412609
29377726_1568124,CM021101.1,2,29377726,145700725,2669241,1568124,147268849,109446753
29377726_1568720,CM021101.1,2,29377726,145700725,2669241,1568720,147269445,109447349
29379428_1616876,CM021101.1,2,29379428,145700168,2125904,1616876,147317044,109494948
29379428_1616907,CM021101.1,2,29379428,145700168,2125904,1616907,147317075,109494979
29377726_1647629,CM021101.1,2,29377726,145700725,2669241,1647629,147348354,109526258
29379428_1670668,CM021101.1,2,29379428,145700168,2125904,1670668,147370836,109548740
29381454_1676894,CM021101.1,2,29381454,145700075,2527386,1676894,147376969,109554873
29381454_1676933,CM021101.1,2,29381454,145700075,2527386,1676933,147377008,109554912
29381454_1676993,CM021101.1,2,29381454,145700075,2527386,1676993,147377068,109554972
29379428_1677397,CM021101.1,2,29379428,145700168,2125904,1677397,147377565,109555469
29378176_1711897,CM021101.1,2,29378176,145699180,1785609,1711897,147411077,109588981
29378176_1711928,CM021101.1,2,29378176,145699180,1785609,1711928,147411108,109589012
29378176_1711929,CM021101.1,2,29378176,145699180,1785609,1711929,147411109,109589013
29378058_1807134,CM021101.1,2,29378058,145699660,4277888,1807134,147506794,109684698
29378058_1807182,CM021101.1,2,29378058,145699660,4277888,1807182,147506842,109684746
29380995_1812802,CM021101.1,2,29380995,145699183,2524148,1812802,147511985,109689889
29377513_1853532,CM021101.1,2,29377513,145701464,3846708,1853532,147554996,109732900
29377513_1853539,CM021101.1,2,29377513,145701464,3846708,1853539,147555003,109732907
29377513_1888253,CM021101.1,2,29377513,145701464,3846708,1888253,147589717,109767621
29380995_1940903,CM021101.1,2,29380995,145699183,2524148,1940903,147640086,109817990
29381635_1976179,CM021101.1,2,29381635,145700219,3826958,1976179,147676398,109854302
29381635_1976251,CM021101.1,2,29381635,145700219,3826958,1976251,147676470,109854374
29381635_1976265,CM021101.1,2,29381635,145700219,3826958,1976265,147676484,109854388
29381635_1976379,CM021101.1,2,29381635,145700219,3826958,1976379,147676598,109854502
29381635_2013939,CM021101.1,2,29381635,145700219,3826958,2013939,147714158,109892062
29380306_2031243,CM021101.1,2,29380306,145699179,4035874,2031243,147730422,109908326
29381472_2128064,CM021101.1,2,29381472,145699785,7979260,2128064,147827849,110005753
29381472_2128703,CM021101.1,2,29381472,145699785,7979260,2128703,147828488,110006392
29381454_2155912,CM021101.1,2,29381454,145700075,2527386,2155912,147855987,110033891
29381454_2155964,CM021101.1,2,29381454,145700075,2527386,2155964,147856039,110033943
29381454_2156027,CM021101.1,2,29381454,145700075,2527386,2156027,147856102,110034006
29381454_2156070,CM021101.1,2,29381454,145700075,2527386,2156070,147856145,110034049
29381454_2158005,CM021101.1,2,29381454,145700075,2527386,2158005,147858080,110035984
29377513_2158094,CM021101.1,2,29377513,145701464,3846708,2158094,147859558,110037462
29377513_2158159,CM021101.1,2,29377513,145701464,3846708,2158159,147859623,110037527
29377513_2158536,CM021101.1,2,29377513,145701464,3846708,2158536,147860000,110037904
29380306_2320243,CM021101.1,2,29380306,145699179,4035874,2320243,148019422,110197326
29380306_2320271,CM021101.1,2,29380306,145699179,4035874,2320271,148019450,110197354
29378058_2339202,CM021101.1,2,29378058,145699660,4277888,2339202,148038862,110216766
29377942_2394075,CM021101.1,2,29377942,145701974,3193440,2394075,148096049,110273953
29377942_2394092,CM021101.1,2,29377942,145701974,3193440,2394092,148096066,110273970
29381635_2538555,CM021101.1,2,29381635,145700219,3826958,2538555,148238774,110416678
29381635_2538575,CM021101.1,2,29381635,145700219,3826958,2538575,148238794,110416698
29381635_2538647,CM021101.1,2,29381635,145700219,3826958,2538647,148238866,110416770
29381635_2538653,CM021101.1,2,29381635,145700219,3826958,2538653,148238872,110416776
29381635_2538657,CM021101.1,2,29381635,145700219,3826958,2538657,148238876,110416780
29381635_2538661,CM021101.1,2,29381635,145700219,3826958,2538661,148238880,110416784
29377513_2560374,CM021101.1,2,29377513,145701464,3846708,2560374,148261838,110439742
29381635_2588941,CM021101.1,2,29381635,145700219,3826958,2588941,148289160,110467064
29381635_2588949,CM021101.1,2,29381635,145700219,3826958,2588949,148289168,110467072
29381635_2588958,CM021101.1,2,29381635,145700219,3826958,2588958,148289177,110467081
29381635_2589010,CM021101.1,2,29381635,145700219,3826958,2589010,148289229,110467133
29381635_2589036,CM021101.1,2,29381635,145700219,3826958,2589036,148289255,110467159
29381635_2589047,CM021101.1,2,29381635,145700219,3826958,2589047,148289266,110467170
29380306_2662228,CM021101.1,2,29380306,145699179,4035874,2662228,148361407,110539311
29380306_2711736,CM021101.1,2,29380306,145699179,4035874,2711736,148410915,110588819
29377513_2825738,CM021101.1,2,29377513,145701464,3846708,2825738,148527202,110705106
29377513_2825808,CM021101.1,2,29377513,145701464,3846708,2825808,148527272,110705176
29380306_2836750,CM021101.1,2,29380306,145699179,4035874,2836750,148535929,110713833
29380306_2836772,CM021101.1,2,29380306,145699179,4035874,2836772,148535951,110713855
29381635_2860751,CM021101.1,2,29381635,145700219,3826958,2860751,148560970,110738874
29381635_2860827,CM021101.1,2,29381635,145700219,3826958,2860827,148561046,110738950
29381635_2860972,CM021101.1,2,29381635,145700219,3826958,2860972,148561191,110739095
29377513_2910768,CM021101.1,2,29377513,145701464,3846708,2910768,148612232,110790136
29381376_3248314,CM021101.1,2,29381376,145699643,3540314,3248314,148947957,111125861
29381376_3269105,CM021101.1,2,29381376,145699643,3540314,3269105,148968748,111146652
29381376_3276341,CM021101.1,2,29381376,145699643,3540314,3276341,148975984,111153888
29382038_3488308,CM021101.1,2,29382038,145699179,3974797,3488308,149187487,111365391
29382038_3488309,CM021101.1,2,29382038,145699179,3974797,3488309,149187488,111365392
29382038_3488380,CM021101.1,2,29382038,145699179,3974797,3488380,149187559,111365463
29378058_3601758,CM021101.1,2,29378058,145699660,4277888,3601758,149301418,111479322
29378058_3601877,CM021101.1,2,29378058,145699660,4277888,3601877,149301537,111479441
29381472_3606299,CM021101.1,2,29381472,145699785,7979260,3606299,149306084,111483988
29381635_3652797,CM021101.1,2,29381635,145700219,3826958,3652797,149353016,111530920
29381635_3654227,CM021101.1,2,29381635,145700219,3826958,3654227,149354446,111532350
29378224_3676808,CM021101.1,2,29378224,145699811,5919315,3676808,149376619,111554523
29378224_3676842,CM021101.1,2,29378224,145699811,5919315,3676842,149376653,111554557
29378224_3676881,CM021101.1,2,29378224,145699811,5919315,3676881,149376692,111554596
29381472_3803341,CM021101.1,2,29381472,145699785,7979260,3803341,149503126,111681030
29377513_3833876,CM021101.1,2,29377513,145701464,3846708,3833876,149535340,111713244
29382038_3972036,CM021101.1,2,29382038,145699179,3974797,3972036,149671215,111849119
29382038_3972039,CM021101.1,2,29382038,145699179,3974797,3972039,149671218,111849122
29382038_3972046,CM021101.1,2,29382038,145699179,3974797,3972046,149671225,111849129
29381603_4286319,CM021101.1,2,29381603,145699179,7313729,4286319,149985498,112163402
29381603_4286475,CM021101.1,2,29381603,145699179,7313729,4286475,149985654,112163558
29381603_4286485,CM021101.1,2,29381603,145699179,7313729,4286485,149985664,112163568
29381603_4286492,CM021101.1,2,29381603,145699179,7313729,4286492,149985671,112163575
29381603_4286535,CM021101.1,2,29381603,145699179,7313729,4286535,149985714,112163618
29381603_4286537,CM021101.1,2,29381603,145699179,7313729,4286537,149985716,112163620
29381603_4286558,CM021101.1,2,29381603,145699179,7313729,4286558,149985737,112163641
29381603_5803435,CM021101.1,2,29381603,145699179,7313729,5803435,151502614,113680518
28219388_1377,CM021101.1,2,28219388,155140338,2528,1377,155141715,117319619
28219388_1476,CM021101.1,2,28219388,155140338,2528,1476,155141814,117319718
29380350_254616,CM021101.1,2,29380350,173577074,896333,254616,173831690,136009594
29380350_254717,CM021101.1,2,29380350,173577074,896333,254717,173831791,136009695
29380350_254778,CM021101.1,2,29380350,173577074,896333,254778,173831852,136009756
29382425_366531,CM021101.1,2,29382425,173577315,2154597,366531,173943846,136121750
29382425_373058,CM021101.1,2,29382425,173577315,2154597,373058,173950373,136128277
29382425_378590,CM021101.1,2,29382425,173577315,2154597,378590,173955905,136133809
29382425_380558,CM021101.1,2,29382425,173577315,2154597,380558,173957873,136135777
29382425_391517,CM021101.1,2,29382425,173577315,2154597,391517,173968832,136146736
29382425_391531,CM021101.1,2,29382425,173577315,2154597,391531,173968846,136146750
29380350_488726,CM021101.1,2,29380350,173577074,896333,488726,174065800,136243704
29380350_488759,CM021101.1,2,29380350,173577074,896333,488759,174065833,136243737
29380350_488804,CM021101.1,2,29380350,173577074,896333,488804,174065878,136243782
29380350_488821,CM021101.1,2,29380350,173577074,896333,488821,174065895,136243799
29380350_488938,CM021101.1,2,29380350,173577074,896333,488938,174066012,136243916
29380350_488970,CM021101.1,2,29380350,173577074,896333,488970,174066044,136243948
29380350_512082,CM021101.1,2,29380350,173577074,896333,512082,174089156,136267060
29380350_513652,CM021101.1,2,29380350,173577074,896333,513652,174090726,136268630
29380350_513873,CM021101.1,2,29380350,173577074,896333,513873,174090947,136268851
29380350_514017,CM021101.1,2,29380350,173577074,896333,514017,174091091,136268995
29380350_534812,CM021101.1,2,29380350,173577074,896333,534812,174111886,136289790
29380350_534816,CM021101.1,2,29380350,173577074,896333,534816,174111890,136289794
29380350_534844,CM021101.1,2,29380350,173577074,896333,534844,174111918,136289822
29380350_534856,CM021101.1,2,29380350,173577074,896333,534856,174111930,136289834
29380350_534858,CM021101.1,2,29380350,173577074,896333,534858,174111932,136289836
29380350_556444,CM021101.1,2,29380350,173577074,896333,556444,174133518,136311422
29380466_560748,CM021101.1,2,29380466,173577557,1048565,560748,174138305,136316209
29380466_560799,CM021101.1,2,29380466,173577557,1048565,560799,174138356,136316260
29380466_560896,CM021101.1,2,29380466,173577557,1048565,560896,174138453,136316357
29380466_560928,CM021101.1,2,29380466,173577557,1048565,560928,174138485,136316389
29380466_576726,CM021101.1,2,29380466,173577557,1048565,576726,174154283,136332187
29380466_576848,CM021101.1,2,29380466,173577557,1048565,576848,174154405,136332309
29380466_576909,CM021101.1,2,29380466,173577557,1048565,576909,174154466,136332370
29380466_576964,CM021101.1,2,29380466,173577557,1048565,576964,174154521,136332425
29380466_577054,CM021101.1,2,29380466,173577557,1048565,577054,174154611,136332515
29380350_609102,CM021101.1,2,29380350,173577074,896333,609102,174186176,136364080
29380466_796476,CM021101.1,2,29380466,173577557,1048565,796476,174374033,136551937
29380466_796655,CM021101.1,2,29380466,173577557,1048565,796655,174374212,136552116
29380466_796729,CM021101.1,2,29380466,173577557,1048565,796729,174374286,136552190
29380466_796934,CM021101.1,2,29380466,173577557,1048565,796934,174374491,136552395
29380466_796982,CM021101.1,2,29380466,173577557,1048565,796982,174374539,136552443
29382425_834575,CM021101.1,2,29382425,173577315,2154597,834575,174411890,136589794
29382425_834611,CM021101.1,2,29382425,173577315,2154597,834611,174411926,136589830
29382425_834632,CM021101.1,2,29382425,173577315,2154597,834632,174411947,136589851
29382425_835914,CM021101.1,2,29382425,173577315,2154597,835914,174413229,136591133
29382425_836463,CM021101.1,2,29382425,173577315,2154597,836463,174413778,136591682
29382425_872633,CM021101.1,2,29382425,173577315,2154597,872633,174449948,136627852
29382425_872702,CM021101.1,2,29382425,173577315,2154597,872702,174450017,136627921
29382425_985442,CM021101.1,2,29382425,173577315,2154597,985442,174562757,136740661
29382425_985466,CM021101.1,2,29382425,173577315,2154597,985466,174562781,136740685
29382425_985470,CM021101.1,2,29382425,173577315,2154597,985470,174562785,136740689
29382425_985512,CM021101.1,2,29382425,173577315,2154597,985512,174562827,136740731
29382425_1544129,CM021101.1,2,29382425,173577315,2154597,1544129,175121444,137299348
29382425_1924603,CM021101.1,2,29382425,173577315,2154597,1924603,175501918,137679822
29351386_705,CM021101.1,2,29351386,180650453,169582,705,180651158,142829062
29380501_99669,CM021101.1,2,29380501,211932197,3338445,99669,212031866,174209770
29344226_118194,CM021101.1,2,29344226,211945421,291296,118194,212063615,174241519
29344226_118210,CM021101.1,2,29344226,211945421,291296,118210,212063631,174241535
29382433_177284,CM021101.1,2,29382433,211946120,1290404,177284,212123404,174301308
29378896_225863,CM021101.1,2,29378896,211945573,18429520,225863,212171436,174349340
29381545_258274,CM021101.1,2,29381545,211932198,2883801,258274,212190472,174368376
29381545_302751,CM021101.1,2,29381545,211932198,2883801,302751,212234949,174412853
29381545_302754,CM021101.1,2,29381545,211932198,2883801,302754,212234952,174412856
29379944_345130,CM021101.1,2,29379944,211932199,2518289,345130,212277329,174455233
29380313_393020,CM021101.1,2,29380313,211948336,571179,393020,212341356,174519260
29378318_480111,CM021101.1,2,29378318,211932198,3790593,480111,212412309,174590213
29380501_498072,CM021101.1,2,29380501,211932197,3338445,498072,212430269,174608173
29380501_498123,CM021101.1,2,29380501,211932197,3338445,498123,212430320,174608224
29380501_498133,CM021101.1,2,29380501,211932197,3338445,498133,212430330,174608234
29380501_502182,CM021101.1,2,29380501,211932197,3338445,502182,212434379,174612283
29380501_502332,CM021101.1,2,29380501,211932197,3338445,502332,212434529,174612433
29380501_503930,CM021101.1,2,29380501,211932197,3338445,503930,212436127,174614031
29380501_503953,CM021101.1,2,29380501,211932197,3338445,503953,212436150,174614054
29378896_506421,CM021101.1,2,29378896,211945573,18429520,506421,212451994,174629898
29380501_521868,CM021101.1,2,29380501,211932197,3338445,521868,212454065,174631969
29380501_521887,CM021101.1,2,29380501,211932197,3338445,521887,212454084,174631988
29380501_521913,CM021101.1,2,29380501,211932197,3338445,521913,212454110,174632014
29380501_521918,CM021101.1,2,29380501,211932197,3338445,521918,212454115,174632019
29381726_563452,CM021101.1,2,29381726,211932199,2027003,563452,212495651,174673555
29380446_583142,CM021101.1,2,29380446,211946693,2676039,583142,212529835,174707739
29380446_620775,CM021101.1,2,29380446,211946693,2676039,620775,212567468,174745372
29380446_620847,CM021101.1,2,29380446,211946693,2676039,620847,212567540,174745444
29380446_620859,CM021101.1,2,29380446,211946693,2676039,620859,212567552,174745456
29381280_657046,CM021101.1,2,29381280,211932199,2455318,657046,212589245,174767149
29380490_707538,CM021101.1,2,29380490,211932199,2167635,707538,212639737,174817641
29380490_707566,CM021101.1,2,29380490,211932199,2167635,707566,212639765,174817669
29381726_728858,CM021101.1,2,29381726,211932199,2027003,728858,212661057,174838961
29381726_728959,CM021101.1,2,29381726,211932199,2027003,728959,212661158,174839062
29381726_766160,CM021101.1,2,29381726,211932199,2027003,766160,212698359,174876263
29380490_780683,CM021101.1,2,29380490,211932199,2167635,780683,212712882,174890786
29380490_780704,CM021101.1,2,29380490,211932199,2167635,780704,212712903,174890807
29380490_780705,CM021101.1,2,29380490,211932199,2167635,780705,212712904,174890808
29380490_780708,CM021101.1,2,29380490,211932199,2167635,780708,212712907,174890811
29381949_857508,CM021101.1,2,29381949,211932198,1053202,857508,212789706,174967610
29380446_919713,CM021101.1,2,29380446,211946693,2676039,919713,212866406,175044310
29380446_919714,CM021101.1,2,29380446,211946693,2676039,919714,212866407,175044311
29380446_919787,CM021101.1,2,29380446,211946693,2676039,919787,212866480,175044384
29378386_975021,CM021101.1,2,29378386,211932198,1310385,975021,212907219,175085123
29377415_1010743,CM021101.1,2,29377415,211932198,1159617,1010743,212942941,175120845
29377415_1010745,CM021101.1,2,29377415,211932198,1159617,1010745,212942943,175120847
29377415_1011800,CM021101.1,2,29377415,211932198,1159617,1011800,212943998,175121902
29379944_1112537,CM021101.1,2,29379944,211932199,2518289,1112537,213044736,175222640
29379944_1112637,CM021101.1,2,29379944,211932199,2518289,1112637,213044836,175222740
29381280_1198665,CM021101.1,2,29381280,211932199,2455318,1198665,213130864,175308768
29381280_1208394,CM021101.1,2,29381280,211932199,2455318,1208394,213140593,175318497
29381280_1208430,CM021101.1,2,29381280,211932199,2455318,1208430,213140629,175318533
29381644_1249819,CM021101.1,2,29381644,211932199,4444843,1249819,213182018,175359922
29377795_1268803,CM021101.1,2,29377795,211932199,2023449,1268803,213201002,175378906
29377795_1268804,CM021101.1,2,29377795,211932199,2023449,1268804,213201003,175378907
29378386_1284986,CM021101.1,2,29378386,211932198,1310385,1284986,213217184,175395088
29380446_1292551,CM021101.1,2,29380446,211946693,2676039,1292551,213239244,175417148
29380446_1292665,CM021101.1,2,29380446,211946693,2676039,1292665,213239358,175417262
29382388_1398831,CM021101.1,2,29382388,211945054,3226024,1398831,213343885,175521789
29378740_1547574,CM021101.1,2,29378740,211932199,5073734,1547574,213479773,175657677
29377795_1570288,CM021101.1,2,29377795,211932199,2023449,1570288,213502487,175680391
29377795_1571470,CM021101.1,2,29377795,211932199,2023449,1571470,213503669,175681573
29378740_1576642,CM021101.1,2,29378740,211932199,5073734,1576642,213508841,175686745
29381280_1695638,CM021101.1,2,29381280,211932199,2455318,1695638,213627837,175805741
29381280_1695795,CM021101.1,2,29381280,211932199,2455318,1695795,213627994,175805898
29381280_1695892,CM021101.1,2,29381280,211932199,2455318,1695892,213628091,175805995
29377795_1853607,CM021101.1,2,29377795,211932199,2023449,1853607,213785806,175963710
29378740_1881824,CM021101.1,2,29378740,211932199,5073734,1881824,213814023,175991927
29378740_1881919,CM021101.1,2,29378740,211932199,5073734,1881919,213814118,175992022
29378318_1943230,CM021101.1,2,29378318,211932198,3790593,1943230,213875428,176053332
29378318_1943231,CM021101.1,2,29378318,211932198,3790593,1943231,213875429,176053333
29379015_2044219,CM021101.1,2,29379015,211932199,2244250,2044219,213976418,176154322
29379015_2044264,CM021101.1,2,29379015,211932199,2244250,2044264,213976463,176154367
29379015_2044286,CM021101.1,2,29379015,211932199,2244250,2044286,213976485,176154389
29379015_2044449,CM021101.1,2,29379015,211932199,2244250,2044449,213976648,176154552
29379015_2065263,CM021101.1,2,29379015,211932199,2244250,2065263,213997462,176175366
29379015_2065308,CM021101.1,2,29379015,211932199,2244250,2065308,213997507,176175411
29379015_2065384,CM021101.1,2,29379015,211932199,2244250,2065384,213997583,176175487
29379015_2065412,CM021101.1,2,29379015,211932199,2244250,2065412,213997611,176175515
29379015_2065506,CM021101.1,2,29379015,211932199,2244250,2065506,213997705,176175609
29379015_2065529,CM021101.1,2,29379015,211932199,2244250,2065529,213997728,176175632
29381545_2195890,CM021101.1,2,29381545,211932198,2883801,2195890,214128088,176305992
29381545_2195946,CM021101.1,2,29381545,211932198,2883801,2195946,214128144,176306048
29381545_2195984,CM021101.1,2,29381545,211932198,2883801,2195984,214128182,176306086
29381545_2195996,CM021101.1,2,29381545,211932198,2883801,2195996,214128194,176306098
29381545_2339022,CM021101.1,2,29381545,211932198,2883801,2339022,214271220,176449124
29381545_2339024,CM021101.1,2,29381545,211932198,2883801,2339024,214271222,176449126
29381545_2339027,CM021101.1,2,29381545,211932198,2883801,2339027,214271225,176449129
29381545_2339041,CM021101.1,2,29381545,211932198,2883801,2339041,214271239,176449143
29381545_2339078,CM021101.1,2,29381545,211932198,2883801,2339078,214271276,176449180
29381545_2339166,CM021101.1,2,29381545,211932198,2883801,2339166,214271364,176449268
29381545_2339191,CM021101.1,2,29381545,211932198,2883801,2339191,214271389,176449293
29381545_2339215,CM021101.1,2,29381545,211932198,2883801,2339215,214271413,176449317
29378896_2332936,CM021101.1,2,29378896,211945573,18429520,2332936,214278509,176456413
29377277_2370712,CM021101.1,2,29377277,211932199,6900595,2370712,214302911,176480815
29378318_2665867,CM021101.1,2,29378318,211932198,3790593,2665867,214598065,176775969
29378318_2666337,CM021101.1,2,29378318,211932198,3790593,2666337,214598535,176776439
29379413_22418,CM021101.1,2,29379413,214622837,1301038,22418,214645255,176823159
29377853_306844,CM021101.1,2,29377853,214618249,3595953,306844,214925093,177102997
29381100_314682,CM021101.1,2,29381100,214621925,691682,314682,214936607,177114511
29379861_333819,CM021101.1,2,29379861,214618248,4061270,333819,214952067,177129971
29377277_3054193,CM021101.1,2,29377277,211932199,6900595,3054193,214986392,177164296
29377277_3054219,CM021101.1,2,29377277,211932199,6900595,3054219,214986418,177164322
29377277_3073710,CM021101.1,2,29377277,211932199,6900595,3073710,215005909,177183813
29377277_3073778,CM021101.1,2,29377277,211932199,6900595,3073778,215005977,177183881
29378987_416575,CM021101.1,2,29378987,214618247,3536671,416575,215034822,177212726
29378987_416668,CM021101.1,2,29378987,214618247,3536671,416668,215034915,177212819
29377009_411536,CM021101.1,2,29377009,214623382,907188,411536,215034918,177212822
29377277_3105694,CM021101.1,2,29377277,211932199,6900595,3105694,215037893,177215797
29377277_3105789,CM021101.1,2,29377277,211932199,6900595,3105789,215037988,177215892
29377277_3135041,CM021101.1,2,29377277,211932199,6900595,3135041,215067240,177245144
29381811_504390,CM021101.1,2,29381811,214618248,2462153,504390,215122638,177300542
29381811_504401,CM021101.1,2,29381811,214618248,2462153,504401,215122649,177300553
29379044_509964,CM021101.1,2,29379044,214622180,5979096,509964,215132144,177310048
29379044_509976,CM021101.1,2,29379044,214622180,5979096,509976,215132156,177310060
29379044_509980,CM021101.1,2,29379044,214622180,5979096,509980,215132160,177310064
29379044_510023,CM021101.1,2,29379044,214622180,5979096,510023,215132203,177310107
29379044_510034,CM021101.1,2,29379044,214622180,5979096,510034,215132214,177310118
29379044_510157,CM021101.1,2,29379044,214622180,5979096,510157,215132337,177310241
29379044_510219,CM021101.1,2,29379044,214622180,5979096,510219,215132399,177310303
29380299_614726,CM021101.1,2,29380299,214623119,3495521,614726,215237845,177415749
29380299_614750,CM021101.1,2,29380299,214623119,3495521,614750,215237869,177415773
29378318_3448780,CM021101.1,2,29378318,211932198,3790593,3448780,215380978,177558882
29378220_781866,CM021101.1,2,29378220,214618250,3976846,781866,215400116,177578020
29378220_781927,CM021101.1,2,29378220,214618250,3976846,781927,215400177,177578081
29378220_782010,CM021101.1,2,29378220,214618250,3976846,782010,215400260,177578164
29379293_795250,CM021101.1,2,29379293,214622880,3511125,795250,215418130,177596034
29379293_795252,CM021101.1,2,29379293,214622880,3511125,795252,215418132,177596036
29378318_3569643,CM021101.1,2,29378318,211932198,3790593,3569643,215501841,177679745
29378318_3569666,CM021101.1,2,29378318,211932198,3790593,3569666,215501864,177679768
29378318_3570130,CM021101.1,2,29378318,211932198,3790593,3570130,215502328,177680232
29378318_3691707,CM021101.1,2,29378318,211932198,3790593,3691707,215623905,177801809
29378987_1075843,CM021101.1,2,29378987,214618247,3536671,1075843,215694090,177871994
29378987_1076906,CM021101.1,2,29378987,214618247,3536671,1076906,215695153,177873057
29378987_1103223,CM021101.1,2,29378987,214618247,3536671,1103223,215721470,177899374
29378987_1103244,CM021101.1,2,29378987,214618247,3536671,1103244,215721491,177899395
29378987_1103245,CM021101.1,2,29378987,214618247,3536671,1103245,215721492,177899396
29378220_1268482,CM021101.1,2,29378220,214618250,3976846,1268482,215886732,178064636
29378220_1268563,CM021101.1,2,29378220,214618250,3976846,1268563,215886813,178064717
29377853_1280563,CM021101.1,2,29377853,214618249,3595953,1280563,215898812,178076716
29378220_1289495,CM021101.1,2,29378220,214618250,3976846,1289495,215907745,178085649
29378220_1289504,CM021101.1,2,29378220,214618250,3976846,1289504,215907754,178085658
29378220_1293298,CM021101.1,2,29378220,214618250,3976846,1293298,215911548,178089452
29381811_1387443,CM021101.1,2,29381811,214618248,2462153,1387443,216005691,178183595
29381811_1394289,CM021101.1,2,29381811,214618248,2462153,1394289,216012537,178190441
29381811_1394314,CM021101.1,2,29381811,214618248,2462153,1394314,216012562,178190466
29381811_1396394,CM021101.1,2,29381811,214618248,2462153,1396394,216014642,178192546
29381811_1396818,CM021101.1,2,29381811,214618248,2462153,1396818,216015066,178192970
29381811_1396937,CM021101.1,2,29381811,214618248,2462153,1396937,216015185,178193089
29381811_1396978,CM021101.1,2,29381811,214618248,2462153,1396978,216015226,178193130
29379044_1401978,CM021101.1,2,29379044,214622180,5979096,1401978,216024158,178202062
29378741_1432210,CM021101.1,2,29378741,214618247,2636469,1432210,216050457,178228361
29380065_1498791,CM021101.1,2,29380065,214621651,1878803,1498791,216120442,178298346
29381644_4294698,CM021101.1,2,29381644,211932199,4444843,4294698,216226897,178404801
29381644_4294840,CM021101.1,2,29381644,211932199,4444843,4294840,216227039,178404943
29381811_1682615,CM021101.1,2,29381811,214618248,2462153,1682615,216300863,178478767
29381811_1682630,CM021101.1,2,29381811,214618248,2462153,1682630,216300878,178478782
29378896_4400100,CM021101.1,2,29378896,211945573,18429520,4400100,216345673,178523577
29378896_4400116,CM021101.1,2,29378896,211945573,18429520,4400116,216345689,178523593
29381811_1752081,CM021101.1,2,29381811,214618248,2462153,1752081,216370329,178548233
29378896_4446971,CM021101.1,2,29378896,211945573,18429520,4446971,216392544,178570448
29378896_4502446,CM021101.1,2,29378896,211945573,18429520,4502446,216448019,178625923
29380299_1851063,CM021101.1,2,29380299,214623119,3495521,1851063,216474182,178652086
29380299_1851293,CM021101.1,2,29380299,214623119,3495521,1851293,216474412,178652316
29380299_1852519,CM021101.1,2,29380299,214623119,3495521,1852519,216475638,178653542
29380299_1853349,CM021101.1,2,29380299,214623119,3495521,1853349,216476468,178654372
29380299_1853415,CM021101.1,2,29380299,214623119,3495521,1853415,216476534,178654438
29380299_1853518,CM021101.1,2,29380299,214623119,3495521,1853518,216476637,178654541
29378896_4603878,CM021101.1,2,29378896,211945573,18429520,4603878,216549451,178727355
29378896_4603882,CM021101.1,2,29378896,211945573,18429520,4603882,216549455,178727359
29378896_4603980,CM021101.1,2,29378896,211945573,18429520,4603980,216549553,178727457
29378896_4604041,CM021101.1,2,29378896,211945573,18429520,4604041,216549614,178727518
29381811_1997599,CM021101.1,2,29381811,214618248,2462153,1997599,216615847,178793751
29381811_1997715,CM021101.1,2,29381811,214618248,2462153,1997715,216615963,178793867
29378896_4826601,CM021101.1,2,29378896,211945573,18429520,4826601,216772174,178950078
29377853_2266698,CM021101.1,2,29377853,214618249,3595953,2266698,216884947,179062851
29378896_4967825,CM021101.1,2,29378896,211945573,18429520,4967825,216913398,179091302
29378740_5032816,CM021101.1,2,29378740,211932199,5073734,5032816,216965015,179142919
29378896_5414466,CM021101.1,2,29378896,211945573,18429520,5414466,217360039,179537943
29378987_2967194,CM021101.1,2,29378987,214618247,3536671,2967194,217585441,179763345
29378987_3041312,CM021101.1,2,29378987,214618247,3536671,3041312,217659559,179837463
29378987_3041367,CM021101.1,2,29378987,214618247,3536671,3041367,217659614,179837518
29378987_3057959,CM021101.1,2,29378987,214618247,3536671,3057959,217676206,179854110
29378987_3058004,CM021101.1,2,29378987,214618247,3536671,3058004,217676251,179854155
29379861_3101786,CM021101.1,2,29379861,214618248,4061270,3101786,217720034,179897938
29379861_3106880,CM021101.1,2,29379861,214618248,4061270,3106880,217725128,179903032
29379861_3109715,CM021101.1,2,29379861,214618248,4061270,3109715,217727963,179905867
29379861_3109717,CM021101.1,2,29379861,214618248,4061270,3109717,217727965,179905869
29380299_3130357,CM021101.1,2,29380299,214623119,3495521,3130357,217753476,179931380
29380299_3130359,CM021101.1,2,29380299,214623119,3495521,3130359,217753478,179931382
29380299_3130379,CM021101.1,2,29380299,214623119,3495521,3130379,217753498,179931402
29378896_5973122,CM021101.1,2,29378896,211945573,18429520,5973122,217918695,180096599
29378896_5973126,CM021101.1,2,29378896,211945573,18429520,5973126,217918699,180096603
29378896_5973137,CM021101.1,2,29378896,211945573,18429520,5973137,217918710,180096614
29378896_5973158,CM021101.1,2,29378896,211945573,18429520,5973158,217918731,180096635
29378896_5973260,CM021101.1,2,29378896,211945573,18429520,5973260,217918833,180096737
29378896_5973288,CM021101.1,2,29378896,211945573,18429520,5973288,217918861,180096765
29378896_6044024,CM021101.1,2,29378896,211945573,18429520,6044024,217989597,180167501
29378896_6044136,CM021101.1,2,29378896,211945573,18429520,6044136,217989709,180167613
29378896_6044207,CM021101.1,2,29378896,211945573,18429520,6044207,217989780,180167684
29378896_6044211,CM021101.1,2,29378896,211945573,18429520,6044211,217989784,180167688
29377853_3396347,CM021101.1,2,29377853,214618249,3595953,3396347,218014596,180192500
29378896_6179522,CM021101.1,2,29378896,211945573,18429520,6179522,218125095,180302999
29379861_3646122,CM021101.1,2,29379861,214618248,4061270,3646122,218264370,180442274
29378896_6381608,CM021101.1,2,29378896,211945573,18429520,6381608,218327181,180505085
29378896_6381623,CM021101.1,2,29378896,211945573,18429520,6381623,218327196,180505100
29378896_6381657,CM021101.1,2,29378896,211945573,18429520,6381657,218327230,180505134
29378896_6381659,CM021101.1,2,29378896,211945573,18429520,6381659,218327232,180505136
29378896_6381673,CM021101.1,2,29378896,211945573,18429520,6381673,218327246,180505150
29378896_6381765,CM021101.1,2,29378896,211945573,18429520,6381765,218327338,180505242
29378896_6381867,CM021101.1,2,29378896,211945573,18429520,6381867,218327440,180505344
29378896_6381926,CM021101.1,2,29378896,211945573,18429520,6381926,218327499,180505403
29378896_6386483,CM021101.1,2,29378896,211945573,18429520,6386483,218332056,180509960
29378896_6386501,CM021101.1,2,29378896,211945573,18429520,6386501,218332074,180509978
29378896_6386526,CM021101.1,2,29378896,211945573,18429520,6386526,218332099,180510003
29378896_6386528,CM021101.1,2,29378896,211945573,18429520,6386528,218332101,180510005
29378896_6386540,CM021101.1,2,29378896,211945573,18429520,6386540,218332113,180510017
29378896_6386697,CM021101.1,2,29378896,211945573,18429520,6386697,218332270,180510174
29378896_6386752,CM021101.1,2,29378896,211945573,18429520,6386752,218332325,180510229
29378896_6386789,CM021101.1,2,29378896,211945573,18429520,6386789,218332362,180510266
29378896_6386792,CM021101.1,2,29378896,211945573,18429520,6386792,218332365,180510269
29378896_6401219,CM021101.1,2,29378896,211945573,18429520,6401219,218346792,180524696
29378896_6403365,CM021101.1,2,29378896,211945573,18429520,6403365,218348938,180526842
29378896_6403412,CM021101.1,2,29378896,211945573,18429520,6403412,218348985,180526889
29378085_6452727,CM021101.1,2,29378085,211932199,11238873,6452727,218384926,180562830
29378085_6452739,CM021101.1,2,29378085,211932199,11238873,6452739,218384938,180562842
29378085_6452754,CM021101.1,2,29378085,211932199,11238873,6452754,218384953,180562857
29378085_6452766,CM021101.1,2,29378085,211932199,11238873,6452766,218384965,180562869
29378085_6452768,CM021101.1,2,29378085,211932199,11238873,6452768,218384967,180562871
29378085_6452794,CM021101.1,2,29378085,211932199,11238873,6452794,218384993,180562897
29378085_6452798,CM021101.1,2,29378085,211932199,11238873,6452798,218384997,180562901
29378085_6452806,CM021101.1,2,29378085,211932199,11238873,6452806,218385005,180562909
29378085_6452809,CM021101.1,2,29378085,211932199,11238873,6452809,218385008,180562912
29378085_6452812,CM021101.1,2,29378085,211932199,11238873,6452812,218385011,180562915
29378085_6452829,CM021101.1,2,29378085,211932199,11238873,6452829,218385028,180562932
29378085_6452875,CM021101.1,2,29378085,211932199,11238873,6452875,218385074,180562978
29379044_3916544,CM021101.1,2,29379044,214622180,5979096,3916544,218538724,180716628
29379044_3945133,CM021101.1,2,29379044,214622180,5979096,3945133,218567313,180745217
29378896_6796234,CM021101.1,2,29378896,211945573,18429520,6796234,218741807,180919711
29377277_6817417,CM021101.1,2,29377277,211932199,6900595,6817417,218749616,180927520
29378896_6807973,CM021101.1,2,29378896,211945573,18429520,6807973,218753546,180931450
29378396_4721051,CM021101.1,2,29378396,214618249,4854628,4721051,219339300,181517204
29378396_4721316,CM021101.1,2,29378396,214618249,4854628,4721316,219339565,181517469
29378396_4721376,CM021101.1,2,29378396,214618249,4854628,4721376,219339625,181517529
29378396_4721398,CM021101.1,2,29378396,214618249,4854628,4721398,219339647,181517551
29378396_4721399,CM021101.1,2,29378396,214618249,4854628,4721399,219339648,181517552
29379044_4833731,CM021101.1,2,29379044,214622180,5979096,4833731,219455911,181633815
29379044_4833763,CM021101.1,2,29379044,214622180,5979096,4833763,219455943,181633847
29378896_8706114,CM021101.1,2,29378896,211945573,18429520,8706114,220651687,182829591
29378896_8710966,CM021101.1,2,29378896,211945573,18429520,8710966,220656539,182834443
29378896_8892746,CM021101.1,2,29378896,211945573,18429520,8892746,220838319,183016223
29378085_9756909,CM021101.1,2,29378085,211932199,11238873,9756909,221689108,183867012
29378085_9756944,CM021101.1,2,29378085,211932199,11238873,9756944,221689143,183867047
29378085_9756949,CM021101.1,2,29378085,211932199,11238873,9756949,221689148,183867052
29378085_11048619,CM021101.1,2,29378085,211932199,11238873,11048619,222980818,185158722
29378085_11128431,CM021101.1,2,29378085,211932199,11238873,11128431,223060630,185238534
29378896_14809486,CM021101.1,2,29378896,211945573,18429520,14809486,226755059,188932963
29378896_14809649,CM021101.1,2,29378896,211945573,18429520,14809649,226755222,188933126
29378896_15078820,CM021101.1,2,29378896,211945573,18429520,15078820,227024393,189202297
29378896_16754480,CM021101.1,2,29378896,211945573,18429520,16754480,228700053,190877957
29378896_16756718,CM021101.1,2,29378896,211945573,18429520,16756718,228702291,190880195
29378896_16822681,CM021101.1,2,29378896,211945573,18429520,16822681,228768254,190946158
29378896_17158189,CM021101.1,2,29378896,211945573,18429520,17158189,229103762,191281666
29378896_17158199,CM021101.1,2,29378896,211945573,18429520,17158199,229103772,191281676
29378896_17160829,CM021101.1,2,29378896,211945573,18429520,17160829,229106402,191284306
29378896_17160851,CM021101.1,2,29378896,211945573,18429520,17160851,229106424,191284328
29378896_17160864,CM021101.1,2,29378896,211945573,18429520,17160864,229106437,191284341
29378896_17160940,CM021101.1,2,29378896,211945573,18429520,17160940,229106513,191284417
29379343_12279,CM021101.1,2,29379343,230913255,1244618,12279,230925534,193103438
29381153_38339,CM021101.1,2,29381153,230898424,4097973,38339,230936763,193114667
29380630_42348,CM021101.1,2,29380630,230898423,383468,42348,230940771,193118675
29377763_47590,CM021101.1,2,29377763,230898425,6188281,47590,230946015,193123919
29377763_47660,CM021101.1,2,29377763,230898425,6188281,47660,230946085,193123989
29348791_36458,CM021101.1,2,29348791,230911581,556473,36458,230948039,193125943
29348791_36466,CM021101.1,2,29348791,230911581,556473,36466,230948047,193125951
29362368_55272,CM021101.1,2,29362368,230898424,167359,55272,230953696,193131600
29362368_55385,CM021101.1,2,29362368,230898424,167359,55385,230953809,193131713
29362368_55435,CM021101.1,2,29362368,230898424,167359,55435,230953859,193131763
29362368_55825,CM021101.1,2,29362368,230898424,167359,55825,230954249,193132153
29362368_55878,CM021101.1,2,29362368,230898424,167359,55878,230954302,193132206
29362368_55917,CM021101.1,2,29362368,230898424,167359,55917,230954341,193132245
29377763_59325,CM021101.1,2,29377763,230898425,6188281,59325,230957750,193135654
29380345_104474,CM021101.1,2,29380345,230911610,14989931,104474,231016084,193193988
29379046_139753,CM021101.1,2,29379046,230898425,4449467,139753,231038178,193216082
29376896_158535,CM021101.1,2,29376896,230898419,242324,158535,231056954,193234858
29381580_175150,CM021101.1,2,29381580,230898424,581061,175150,231073574,193251478
29381580_175164,CM021101.1,2,29381580,230898424,581061,175164,231073588,193251492
29381580_175232,CM021101.1,2,29381580,230898424,581061,175232,231073656,193251560
29381580_175338,CM021101.1,2,29381580,230898424,581061,175338,231073762,193251666
29380345_171360,CM021101.1,2,29380345,230911610,14989931,171360,231082970,193260874
29380345_171382,CM021101.1,2,29380345,230911610,14989931,171382,231082992,193260896
29376896_195091,CM021101.1,2,29376896,230898419,242324,195091,231093510,193271414
29376896_195839,CM021101.1,2,29376896,230898419,242324,195839,231094258,193272162
29378505_191567,CM021101.1,2,29378505,230911887,1500192,191567,231103454,193281358
29380712_224084,CM021101.1,2,29380712,230912139,3038604,224084,231136223,193314127
29380712_224096,CM021101.1,2,29380712,230912139,3038604,224096,231136235,193314139
29377711_292713,CM021101.1,2,29377711,230898425,355326,292713,231191138,193369042
29377711_294783,CM021101.1,2,29377711,230898425,355326,294783,231193208,193371112
29377711_294801,CM021101.1,2,29377711,230898425,355326,294801,231193226,193371130
29377711_294803,CM021101.1,2,29377711,230898425,355326,294803,231193228,193371132
29377711_294851,CM021101.1,2,29377711,230898425,355326,294851,231193276,193371180
29377711_295022,CM021101.1,2,29377711,230898425,355326,295022,231193447,193371351
29377542_331659,CM021101.1,2,29377542,230898425,2231663,331659,231230084,193407988
29377763_339063,CM021101.1,2,29377763,230898425,6188281,339063,231237488,193415392
29377763_339151,CM021101.1,2,29377763,230898425,6188281,339151,231237576,193415480
29378823_336491,CM021101.1,2,29378823,230911691,1486888,336491,231248182,193426086
29378823_336519,CM021101.1,2,29378823,230911691,1486888,336519,231248210,193426114
29378823_336540,CM021101.1,2,29378823,230911691,1486888,336540,231248231,193426135
29378823_336571,CM021101.1,2,29378823,230911691,1486888,336571,231248262,193426166
29381153_361564,CM021101.1,2,29381153,230898424,4097973,361564,231259988,193437892
29381153_361595,CM021101.1,2,29381153,230898424,4097973,361595,231260019,193437923
29381153_361609,CM021101.1,2,29381153,230898424,4097973,361609,231260033,193437937
29381153_361611,CM021101.1,2,29381153,230898424,4097973,361611,231260035,193437939
29381153_361628,CM021101.1,2,29381153,230898424,4097973,361628,231260052,193437956
29381153_361662,CM021101.1,2,29381153,230898424,4097973,361662,231260086,193437990
29381153_361768,CM021101.1,2,29381153,230898424,4097973,361768,231260192,193438096
29381153_361780,CM021101.1,2,29381153,230898424,4097973,361780,231260204,193438108
29381153_361871,CM021101.1,2,29381153,230898424,4097973,361871,231260295,193438199
29378365_392940,CM021101.1,2,29378365,230901381,1402081,392940,231294321,193472225
29381580_433271,CM021101.1,2,29381580,230898424,581061,433271,231331695,193509599
29381580_433376,CM021101.1,2,29381580,230898424,581061,433376,231331800,193509704
29378613_474320,CM021101.1,2,29378613,230898424,1507978,474320,231372744,193550648
29378613_478615,CM021101.1,2,29378613,230898424,1507978,478615,231377039,193554943
29378613_478678,CM021101.1,2,29378613,230898424,1507978,478678,231377102,193555006
29360291_513225,CM021101.1,2,29360291,230911699,971702,513225,231424924,193602828
29378365_538084,CM021101.1,2,29378365,230901381,1402081,538084,231439465,193617369
29378365_538131,CM021101.1,2,29378365,230901381,1402081,538131,231439512,193617416
29381580_546218,CM021101.1,2,29381580,230898424,581061,546218,231444642,193622546
29381580_554383,CM021101.1,2,29381580,230898424,581061,554383,231452807,193630711
29381580_555122,CM021101.1,2,29381580,230898424,581061,555122,231453546,193631450
29380712_552804,CM021101.1,2,29380712,230912139,3038604,552804,231464943,193642847
29378660_592779,CM021101.1,2,29378660,230912195,1500424,592779,231504974,193682878
29379343_623502,CM021101.1,2,29379343,230913255,1244618,623502,231536757,193714661
29379343_623585,CM021101.1,2,29379343,230913255,1244618,623585,231536840,193714744
29379343_735372,CM021101.1,2,29379343,230913255,1244618,735372,231648627,193826531
29379343_735412,CM021101.1,2,29379343,230913255,1244618,735412,231648667,193826571
29379343_735473,CM021101.1,2,29379343,230913255,1244618,735473,231648728,193826632
29379343_735475,CM021101.1,2,29379343,230913255,1244618,735475,231648730,193826634
29377763_755394,CM021101.1,2,29377763,230898425,6188281,755394,231653819,193831723
29377763_755419,CM021101.1,2,29377763,230898425,6188281,755419,231653844,193831748
29377763_755491,CM021101.1,2,29377763,230898425,6188281,755491,231653916,193831820
29377763_755513,CM021101.1,2,29377763,230898425,6188281,755513,231653938,193831842
29379343_748270,CM021101.1,2,29379343,230913255,1244618,748270,231661525,193839429
29379343_748356,CM021101.1,2,29379343,230913255,1244618,748356,231661611,193839515
29379343_748405,CM021101.1,2,29379343,230913255,1244618,748405,231661660,193839564
29379343_751007,CM021101.1,2,29379343,230913255,1244618,751007,231664262,193842166
29379343_753895,CM021101.1,2,29379343,230913255,1244618,753895,231667150,193845054
29379343_753960,CM021101.1,2,29379343,230913255,1244618,753960,231667215,193845119
29379343_753966,CM021101.1,2,29379343,230913255,1244618,753966,231667221,193845125
29380712_773424,CM021101.1,2,29380712,230912139,3038604,773424,231685563,193863467
29381153_806819,CM021101.1,2,29381153,230898424,4097973,806819,231705243,193883147
29381153_806824,CM021101.1,2,29381153,230898424,4097973,806824,231705248,193883152
29360291_797964,CM021101.1,2,29360291,230911699,971702,797964,231709663,193887567
29360291_798021,CM021101.1,2,29360291,230911699,971702,798021,231709720,193887624
29360291_798059,CM021101.1,2,29360291,230911699,971702,798059,231709758,193887662
29360291_798109,CM021101.1,2,29360291,230911699,971702,798109,231709808,193887712
29360291_798154,CM021101.1,2,29360291,230911699,971702,798154,231709853,193887757
29378823_848910,CM021101.1,2,29378823,230911691,1486888,848910,231760601,193938505
29378823_849001,CM021101.1,2,29378823,230911691,1486888,849001,231760692,193938596
29378823_857244,CM021101.1,2,29378823,230911691,1486888,857244,231768935,193946839
29378365_883601,CM021101.1,2,29378365,230901381,1402081,883601,231784982,193962886
29378365_883675,CM021101.1,2,29378365,230901381,1402081,883675,231785056,193962960
29378365_883679,CM021101.1,2,29378365,230901381,1402081,883679,231785060,193962964
29378365_883698,CM021101.1,2,29378365,230901381,1402081,883698,231785079,193962983
29377485_920157,CM021101.1,2,29377485,230898416,3054942,920157,231818573,193996477
29377485_920185,CM021101.1,2,29377485,230898416,3054942,920185,231818601,193996505
29381153_983656,CM021101.1,2,29381153,230898424,4097973,983656,231882080,194059984
29381153_983669,CM021101.1,2,29381153,230898424,4097973,983669,231882093,194059997
29378823_986408,CM021101.1,2,29378823,230911691,1486888,986408,231898099,194076003
29378823_1002499,CM021101.1,2,29378823,230911691,1486888,1002499,231914190,194092094
29378823_1025088,CM021101.1,2,29378823,230911691,1486888,1025088,231936779,194114683
29378823_1025095,CM021101.1,2,29378823,230911691,1486888,1025095,231936786,194114690
29378823_1026173,CM021101.1,2,29378823,230911691,1486888,1026173,231937864,194115768
29378823_1026278,CM021101.1,2,29378823,230911691,1486888,1026278,231937969,194115873
29380345_1028415,CM021101.1,2,29380345,230911610,14989931,1028415,231940025,194117929
29380345_1028519,CM021101.1,2,29380345,230911610,14989931,1028519,231940129,194118033
29377375_1027012,CM021101.1,2,29377375,230914560,2101881,1027012,231941572,194119476
29377375_1027027,CM021101.1,2,29377375,230914560,2101881,1027027,231941587,194119491
29377375_1027028,CM021101.1,2,29377375,230914560,2101881,1027028,231941588,194119492
29377375_1027055,CM021101.1,2,29377375,230914560,2101881,1027055,231941615,194119519
29377375_1027058,CM021101.1,2,29377375,230914560,2101881,1027058,231941618,194119522
29377375_1027847,CM021101.1,2,29377375,230914560,2101881,1027847,231942407,194120311
29377375_1056890,CM021101.1,2,29377375,230914560,2101881,1056890,231971450,194149354
29377375_1066557,CM021101.1,2,29377375,230914560,2101881,1066557,231981117,194159021
29377375_1066601,CM021101.1,2,29377375,230914560,2101881,1066601,231981161,194159065
29377375_1066611,CM021101.1,2,29377375,230914560,2101881,1066611,231981171,194159075
29377375_1066842,CM021101.1,2,29377375,230914560,2101881,1066842,231981402,194159306
29377375_1066844,CM021101.1,2,29377375,230914560,2101881,1066844,231981404,194159308
29378823_1072184,CM021101.1,2,29378823,230911691,1486888,1072184,231983875,194161779
29378823_1072211,CM021101.1,2,29378823,230911691,1486888,1072211,231983902,194161806
29377763_1088982,CM021101.1,2,29377763,230898425,6188281,1088982,231987407,194165311
29377763_1088990,CM021101.1,2,29377763,230898425,6188281,1088990,231987415,194165319
29377763_1088991,CM021101.1,2,29377763,230898425,6188281,1088991,231987416,194165320
29377763_1088994,CM021101.1,2,29377763,230898425,6188281,1088994,231987419,194165323
29377763_1089024,CM021101.1,2,29377763,230898425,6188281,1089024,231987449,194165353
29377763_1089040,CM021101.1,2,29377763,230898425,6188281,1089040,231987465,194165369
29377763_1089089,CM021101.1,2,29377763,230898425,6188281,1089089,231987514,194165418
29377763_1089091,CM021101.1,2,29377763,230898425,6188281,1089091,231987516,194165420
29377763_1089121,CM021101.1,2,29377763,230898425,6188281,1089121,231987546,194165450
29381153_1096650,CM021101.1,2,29381153,230898424,4097973,1096650,231995074,194172978
29379343_1098621,CM021101.1,2,29379343,230913255,1244618,1098621,232011876,194189780
29377375_1097797,CM021101.1,2,29377375,230914560,2101881,1097797,232012357,194190261
29377375_1123112,CM021101.1,2,29377375,230914560,2101881,1123112,232037672,194215576
29377375_1123134,CM021101.1,2,29377375,230914560,2101881,1123134,232037694,194215598
29377375_1123202,CM021101.1,2,29377375,230914560,2101881,1123202,232037762,194215666
29377375_1123923,CM021101.1,2,29377375,230914560,2101881,1123923,232038483,194216387
29377375_1123931,CM021101.1,2,29377375,230914560,2101881,1123931,232038491,194216395
29377375_1123955,CM021101.1,2,29377375,230914560,2101881,1123955,232038515,194216419
29377375_1128723,CM021101.1,2,29377375,230914560,2101881,1128723,232043283,194221187
29377375_1128742,CM021101.1,2,29377375,230914560,2101881,1128742,232043302,194221206
29377542_1308444,CM021101.1,2,29377542,230898425,2231663,1308444,232206869,194384773
29379524_1378211,CM021101.1,2,29379524,230898423,3960678,1378211,232276634,194454538
29379524_1378239,CM021101.1,2,29379524,230898423,3960678,1378239,232276662,194454566
29379524_1378241,CM021101.1,2,29379524,230898423,3960678,1378241,232276664,194454568
29379524_1378246,CM021101.1,2,29379524,230898423,3960678,1378246,232276669,194454573
29379524_1378268,CM021101.1,2,29379524,230898423,3960678,1378268,232276691,194454595
29379524_1378269,CM021101.1,2,29379524,230898423,3960678,1378269,232276692,194454596
29379524_1378278,CM021101.1,2,29379524,230898423,3960678,1378278,232276701,194454605
29379524_1378284,CM021101.1,2,29379524,230898423,3960678,1378284,232276707,194454611
29379524_1378343,CM021101.1,2,29379524,230898423,3960678,1378343,232276766,194454670
29379524_1378377,CM021101.1,2,29379524,230898423,3960678,1378377,232276800,194454704
29379524_1378382,CM021101.1,2,29379524,230898423,3960678,1378382,232276805,194454709
29379524_1378418,CM021101.1,2,29379524,230898423,3960678,1378418,232276841,194454745
29379524_1378453,CM021101.1,2,29379524,230898423,3960678,1378453,232276876,194454780
29381477_1425272,CM021101.1,2,29381477,230898424,1609918,1425272,232323696,194501600
29377896_1476181,CM021101.1,2,29377896,230898425,5124000,1476181,232374606,194552510
29377542_1555010,CM021101.1,2,29377542,230898425,2231663,1555010,232453435,194631339
29377375_1599617,CM021101.1,2,29377375,230914560,2101881,1599617,232514177,194692081
29377763_1628956,CM021101.1,2,29377763,230898425,6188281,1628956,232527381,194705285
29377763_1629011,CM021101.1,2,29377763,230898425,6188281,1629011,232527436,194705340
29377763_1629121,CM021101.1,2,29377763,230898425,6188281,1629121,232527546,194705450
29381153_1634295,CM021101.1,2,29381153,230898424,4097973,1634295,232532719,194710623
29381153_1634301,CM021101.1,2,29381153,230898424,4097973,1634301,232532725,194710629
29381153_1634339,CM021101.1,2,29381153,230898424,4097973,1634339,232532763,194710667
29381153_1634344,CM021101.1,2,29381153,230898424,4097973,1634344,232532768,194710672
29381153_1634353,CM021101.1,2,29381153,230898424,4097973,1634353,232532777,194710681
29381153_1634363,CM021101.1,2,29381153,230898424,4097973,1634363,232532787,194710691
29381153_1634371,CM021101.1,2,29381153,230898424,4097973,1634371,232532795,194710699
29381153_1634377,CM021101.1,2,29381153,230898424,4097973,1634377,232532801,194710705
29381153_1634389,CM021101.1,2,29381153,230898424,4097973,1634389,232532813,194710717
29377105_1647396,CM021101.1,2,29377105,230898425,4022459,1647396,232545821,194723725
29377105_1647409,CM021101.1,2,29377105,230898425,4022459,1647409,232545834,194723738
29377105_1647414,CM021101.1,2,29377105,230898425,4022459,1647414,232545839,194723743
29377105_1647417,CM021101.1,2,29377105,230898425,4022459,1647417,232545842,194723746
29377105_1647418,CM021101.1,2,29377105,230898425,4022459,1647418,232545843,194723747
29377105_1647425,CM021101.1,2,29377105,230898425,4022459,1647425,232545850,194723754
29377105_1647426,CM021101.1,2,29377105,230898425,4022459,1647426,232545851,194723755
29377105_1647547,CM021101.1,2,29377105,230898425,4022459,1647547,232545972,194723876
29377105_1692665,CM021101.1,2,29377105,230898425,4022459,1692665,232591090,194768994
29377105_1692673,CM021101.1,2,29377105,230898425,4022459,1692673,232591098,194769002
29377105_1692706,CM021101.1,2,29377105,230898425,4022459,1692706,232591131,194769035
29377105_1692731,CM021101.1,2,29377105,230898425,4022459,1692731,232591156,194769060
29377105_1692739,CM021101.1,2,29377105,230898425,4022459,1692739,232591164,194769068
29377105_1692745,CM021101.1,2,29377105,230898425,4022459,1692745,232591170,194769074
29377105_1692746,CM021101.1,2,29377105,230898425,4022459,1692746,232591171,194769075
29377105_1692753,CM021101.1,2,29377105,230898425,4022459,1692753,232591178,194769082
29377105_1692778,CM021101.1,2,29377105,230898425,4022459,1692778,232591203,194769107
29377105_1692785,CM021101.1,2,29377105,230898425,4022459,1692785,232591210,194769114
29377105_1692788,CM021101.1,2,29377105,230898425,4022459,1692788,232591213,194769117
29377105_1692872,CM021101.1,2,29377105,230898425,4022459,1692872,232591297,194769201
29377375_1738342,CM021101.1,2,29377375,230914560,2101881,1738342,232652902,194830806
29377375_1738390,CM021101.1,2,29377375,230914560,2101881,1738390,232652950,194830854
29377375_1738429,CM021101.1,2,29377375,230914560,2101881,1738429,232652989,194830893
29377375_1738446,CM021101.1,2,29377375,230914560,2101881,1738446,232653006,194830910
29381153_1779180,CM021101.1,2,29381153,230898424,4097973,1779180,232677604,194855508
29381153_1779247,CM021101.1,2,29381153,230898424,4097973,1779247,232677671,194855575
29377485_1792068,CM021101.1,2,29377485,230898416,3054942,1792068,232690484,194868388
29377485_1792075,CM021101.1,2,29377485,230898416,3054942,1792075,232690491,194868395
29377485_1792104,CM021101.1,2,29377485,230898416,3054942,1792104,232690520,194868424
29377485_1792107,CM021101.1,2,29377485,230898416,3054942,1792107,232690523,194868427
29377485_1792143,CM021101.1,2,29377485,230898416,3054942,1792143,232690559,194868463
29377485_1792210,CM021101.1,2,29377485,230898416,3054942,1792210,232690626,194868530
29377485_1792220,CM021101.1,2,29377485,230898416,3054942,1792220,232690636,194868540
29377485_1792242,CM021101.1,2,29377485,230898416,3054942,1792242,232690658,194868562
29381153_1816763,CM021101.1,2,29381153,230898424,4097973,1816763,232715187,194893091
29381153_1816865,CM021101.1,2,29381153,230898424,4097973,1816865,232715289,194893193
29377105_1944518,CM021101.1,2,29377105,230898425,4022459,1944518,232842943,195020847
29377105_1944595,CM021101.1,2,29377105,230898425,4022459,1944595,232843020,195020924
29377485_1980418,CM021101.1,2,29377485,230898416,3054942,1980418,232878834,195056738
29377105_1996146,CM021101.1,2,29377105,230898425,4022459,1996146,232894571,195072475
29377105_1996251,CM021101.1,2,29377105,230898425,4022459,1996251,232894676,195072580
29377105_2054382,CM021101.1,2,29377105,230898425,4022459,2054382,232952807,195130711
29377105_2054385,CM021101.1,2,29377105,230898425,4022459,2054385,232952810,195130714
29377105_2054575,CM021101.1,2,29377105,230898425,4022459,2054575,232953000,195130904
29377105_2054580,CM021101.1,2,29377105,230898425,4022459,2054580,232953005,195130909
29377105_2073789,CM021101.1,2,29377105,230898425,4022459,2073789,232972214,195150118
29377105_2073839,CM021101.1,2,29377105,230898425,4022459,2073839,232972264,195150168
29380712_2104114,CM021101.1,2,29380712,230912139,3038604,2104114,233016253,195194157
29380712_2104160,CM021101.1,2,29380712,230912139,3038604,2104160,233016299,195194203
29380712_2104251,CM021101.1,2,29380712,230912139,3038604,2104251,233016390,195194294
29380712_2104313,CM021101.1,2,29380712,230912139,3038604,2104313,233016452,195194356
29380712_2104397,CM021101.1,2,29380712,230912139,3038604,2104397,233016536,195194440
29377406_2139007,CM021101.1,2,29377406,230903050,3899389,2139007,233042057,195219961
29349469_10629,CM021101.1,2,29349469,233163625,31611,10629,233174254,195352158
29349469_10645,CM021101.1,2,29349469,233163625,31611,10645,233174270,195352174
29380712_2285338,CM021101.1,2,29380712,230912139,3038604,2285338,233197477,195375381
29380712_2285523,CM021101.1,2,29380712,230912139,3038604,2285523,233197662,195375566
29377406_2347225,CM021101.1,2,29377406,230903050,3899389,2347225,233250275,195428179
29380712_2373085,CM021101.1,2,29380712,230912139,3038604,2373085,233285224,195463128
29380712_2373115,CM021101.1,2,29380712,230912139,3038604,2373115,233285254,195463158
29380712_2373119,CM021101.1,2,29380712,230912139,3038604,2373119,233285258,195463162
29381153_2440302,CM021101.1,2,29381153,230898424,4097973,2440302,233338726,195516630
29377896_2552094,CM021101.1,2,29377896,230898425,5124000,2552094,233450519,195628423
29380712_2580859,CM021101.1,2,29380712,230912139,3038604,2580859,233492998,195670902
29377105_2636799,CM021101.1,2,29377105,230898425,4022459,2636799,233535224,195713128
29377105_2636819,CM021101.1,2,29377105,230898425,4022459,2636819,233535244,195713148
29377105_2636920,CM021101.1,2,29377105,230898425,4022459,2636920,233535345,195713249
29380712_2670376,CM021101.1,2,29380712,230912139,3038604,2670376,233582515,195760419
29380712_2670384,CM021101.1,2,29380712,230912139,3038604,2670384,233582523,195760427
29380712_2670477,CM021101.1,2,29380712,230912139,3038604,2670477,233582616,195760520
29380345_2676842,CM021101.1,2,29380345,230911610,14989931,2676842,233588452,195766356
29380712_2818315,CM021101.1,2,29380712,230912139,3038604,2818315,233730454,195908358
29380712_2818955,CM021101.1,2,29380712,230912139,3038604,2818955,233731094,195908998
29380712_2837298,CM021101.1,2,29380712,230912139,3038604,2837298,233749437,195927341
29380712_2837301,CM021101.1,2,29380712,230912139,3038604,2837301,233749440,195927344
29380712_2837306,CM021101.1,2,29380712,230912139,3038604,2837306,233749445,195927349
29380712_2837326,CM021101.1,2,29380712,230912139,3038604,2837326,233749465,195927369
29380712_2837338,CM021101.1,2,29380712,230912139,3038604,2837338,233749477,195927381
29380712_2837351,CM021101.1,2,29380712,230912139,3038604,2837351,233749490,195927394
29380712_2837362,CM021101.1,2,29380712,230912139,3038604,2837362,233749501,195927405
29380712_2837364,CM021101.1,2,29380712,230912139,3038604,2837364,233749503,195927407
29380712_2837379,CM021101.1,2,29380712,230912139,3038604,2837379,233749518,195927422
29380712_2837380,CM021101.1,2,29380712,230912139,3038604,2837380,233749519,195927423
29380712_2837387,CM021101.1,2,29380712,230912139,3038604,2837387,233749526,195927430
29380712_2837397,CM021101.1,2,29380712,230912139,3038604,2837397,233749536,195927440
29380712_2837414,CM021101.1,2,29380712,230912139,3038604,2837414,233749553,195927457
29380345_3114682,CM021101.1,2,29380345,230911610,14989931,3114682,234026292,196204196
29380345_3114700,CM021101.1,2,29380345,230911610,14989931,3114700,234026310,196204214
29377691_3144810,CM021101.1,2,29377691,230898424,5190009,3144810,234043234,196221138
29377763_3148736,CM021101.1,2,29377763,230898425,6188281,3148736,234047161,196225065
29379524_3160979,CM021101.1,2,29379524,230898423,3960678,3160979,234059402,196237306
29379524_3161056,CM021101.1,2,29379524,230898423,3960678,3161056,234059479,196237383
29379046_3259062,CM021101.1,2,29379046,230898425,4449467,3259062,234157487,196335391
29379046_3259125,CM021101.1,2,29379046,230898425,4449467,3259125,234157550,196335454
29379046_3259194,CM021101.1,2,29379046,230898425,4449467,3259194,234157619,196335523
29379046_3262403,CM021101.1,2,29379046,230898425,4449467,3262403,234160828,196338732
29379046_3459542,CM021101.1,2,29379046,230898425,4449467,3459542,234357967,196535871
29379046_3459924,CM021101.1,2,29379046,230898425,4449467,3459924,234358349,196536253
29377763_3647136,CM021101.1,2,29377763,230898425,6188281,3647136,234545561,196723465
29377763_3647141,CM021101.1,2,29377763,230898425,6188281,3647141,234545566,196723470
29377763_3647244,CM021101.1,2,29377763,230898425,6188281,3647244,234545669,196723573
29377763_3704576,CM021101.1,2,29377763,230898425,6188281,3704576,234603001,196780905
29377406_3704935,CM021101.1,2,29377406,230903050,3899389,3704935,234607985,196785889
29377406_3705019,CM021101.1,2,29377406,230903050,3899389,3705019,234608069,196785973
29377406_3706159,CM021101.1,2,29377406,230903050,3899389,3706159,234609209,196787113
29379046_3940730,CM021101.1,2,29379046,230898425,4449467,3940730,234839155,197017059
29377896_3971267,CM021101.1,2,29377896,230898425,5124000,3971267,234869692,197047596
29377896_3971332,CM021101.1,2,29377896,230898425,5124000,3971332,234869757,197047661
29377896_4226369,CM021101.1,2,29377896,230898425,5124000,4226369,235124794,197302698
29377896_4226381,CM021101.1,2,29377896,230898425,5124000,4226381,235124806,197302710
29377896_4227066,CM021101.1,2,29377896,230898425,5124000,4227066,235125491,197303395
29377896_4227327,CM021101.1,2,29377896,230898425,5124000,4227327,235125752,197303656
29377896_4239378,CM021101.1,2,29377896,230898425,5124000,4239378,235137803,197315707
29377896_4239577,CM021101.1,2,29377896,230898425,5124000,4239577,235138002,197315906
29377896_4239580,CM021101.1,2,29377896,230898425,5124000,4239580,235138005,197315909
29377896_4267325,CM021101.1,2,29377896,230898425,5124000,4267325,235165750,197343654
29377896_4267349,CM021101.1,2,29377896,230898425,5124000,4267349,235165774,197343678
29377896_4267408,CM021101.1,2,29377896,230898425,5124000,4267408,235165833,197343737
29377896_4267425,CM021101.1,2,29377896,230898425,5124000,4267425,235165850,197343754
29377896_4267568,CM021101.1,2,29377896,230898425,5124000,4267568,235165993,197343897
29377896_4267618,CM021101.1,2,29377896,230898425,5124000,4267618,235166043,197343947
29377896_4267669,CM021101.1,2,29377896,230898425,5124000,4267669,235166094,197343998
29377896_4267674,CM021101.1,2,29377896,230898425,5124000,4267674,235166099,197344003
29377896_4267698,CM021101.1,2,29377896,230898425,5124000,4267698,235166123,197344027
29377896_4267798,CM021101.1,2,29377896,230898425,5124000,4267798,235166223,197344127
29377896_4267901,CM021101.1,2,29377896,230898425,5124000,4267901,235166326,197344230
29377896_4267950,CM021101.1,2,29377896,230898425,5124000,4267950,235166375,197344279
29377896_4268040,CM021101.1,2,29377896,230898425,5124000,4268040,235166465,197344369
29380579_4432731,CM021101.1,2,29380579,230911742,5499254,4432731,235344473,197522377
29380579_4560596,CM021101.1,2,29380579,230911742,5499254,4560596,235472338,197650242
29380579_4563199,CM021101.1,2,29380579,230911742,5499254,4563199,235474941,197652845
29380579_4563290,CM021101.1,2,29380579,230911742,5499254,4563290,235475032,197652936
29380579_4955330,CM021101.1,2,29380579,230911742,5499254,4955330,235867072,198044976
29380579_4963622,CM021101.1,2,29380579,230911742,5499254,4963622,235875364,198053268
29380579_4963682,CM021101.1,2,29380579,230911742,5499254,4963682,235875424,198053328
29380579_4970721,CM021101.1,2,29380579,230911742,5499254,4970721,235882463,198060367
29380579_4970760,CM021101.1,2,29380579,230911742,5499254,4970760,235882502,198060406
29380579_4972220,CM021101.1,2,29380579,230911742,5499254,4972220,235883962,198061866
29380579_4975538,CM021101.1,2,29380579,230911742,5499254,4975538,235887280,198065184
29380345_5375323,CM021101.1,2,29380345,230911610,14989931,5375323,236286933,198464837
29380345_6573421,CM021101.1,2,29380345,230911610,14989931,6573421,237485031,199662935
29380345_6573449,CM021101.1,2,29380345,230911610,14989931,6573449,237485059,199662963
29380345_6573483,CM021101.1,2,29380345,230911610,14989931,6573483,237485093,199662997
29380345_6573557,CM021101.1,2,29380345,230911610,14989931,6573557,237485167,199663071
29380345_6573712,CM021101.1,2,29380345,230911610,14989931,6573712,237485322,199663226
29380345_7366910,CM021101.1,2,29380345,230911610,14989931,7366910,238278520,200456424
29380345_8785852,CM021101.1,2,29380345,230911610,14989931,8785852,239697462,201875366
29380345_10296635,CM021101.1,2,29380345,230911610,14989931,10296635,241208245,203386149
29381921_55770,CM021101.1,2,29381921,241241027,1439170,55770,241296797,203474701
29379471_122402,CM021101.1,2,29379471,241222417,5439607,122402,241344819,203522723
29379471_122465,CM021101.1,2,29379471,241222417,5439607,122465,241344882,203522786
29379471_224885,CM021101.1,2,29379471,241222417,5439607,224885,241447302,203625206
29377760_226962,CM021101.1,2,29377760,241222417,4312873,226962,241449379,203627283
29379471_265466,CM021101.1,2,29379471,241222417,5439607,265466,241487883,203665787
29379471_265499,CM021101.1,2,29379471,241222417,5439607,265499,241487916,203665820
29377760_312201,CM021101.1,2,29377760,241222417,4312873,312201,241534618,203712522
29377714_327907,CM021101.1,2,29377714,241222416,4654899,327907,241550323,203728227
29377714_327916,CM021101.1,2,29377714,241222416,4654899,327916,241550332,203728236
29377714_327959,CM021101.1,2,29377714,241222416,4654899,327959,241550375,203728279
29377714_327972,CM021101.1,2,29377714,241222416,4654899,327972,241550388,203728292
29377714_328015,CM021101.1,2,29377714,241222416,4654899,328015,241550431,203728335
29377714_328027,CM021101.1,2,29377714,241222416,4654899,328027,241550443,203728347
29377944_347626,CM021101.1,2,29377944,241222416,1661984,347626,241570042,203747946
29377944_347681,CM021101.1,2,29377944,241222416,1661984,347681,241570097,203748001
29377944_347702,CM021101.1,2,29377944,241222416,1661984,347702,241570118,203748022
29377923_349716,CM021101.1,2,29377923,241222417,376200,349716,241572133,203750037
29377890_330339,CM021101.1,2,29377890,241243847,404212,330339,241574186,203752090
29377890_330356,CM021101.1,2,29377890,241243847,404212,330356,241574203,203752107
29377890_330359,CM021101.1,2,29377890,241243847,404212,330359,241574206,203752110
29380514_345241,CM021101.1,2,29380514,241232381,1482735,345241,241577622,203755526
29380514_404328,CM021101.1,2,29380514,241232381,1482735,404328,241636709,203814613
29380739_424473,CM021101.1,2,29380739,241222414,1934692,424473,241646887,203824791
29381221_486916,CM021101.1,2,29381221,241222418,3793750,486916,241709334,203887238
29381221_486957,CM021101.1,2,29381221,241222418,3793750,486957,241709375,203887279
29381221_487016,CM021101.1,2,29381221,241222418,3793750,487016,241709434,203887338
29381513_504427,CM021101.1,2,29381513,241222409,3465844,504427,241726836,203904740
29381942_517125,CM021101.1,2,29381942,241222416,625680,517125,241739541,203917445
29377752_561581,CM021101.1,2,29377752,241222419,1319127,561581,241784000,203961904
29377752_561644,CM021101.1,2,29377752,241222419,1319127,561644,241784063,203961967
29377752_561667,CM021101.1,2,29377752,241222419,1319127,561667,241784086,203961990
29377752_561715,CM021101.1,2,29377752,241222419,1319127,561715,241784134,203962038
29381942_577036,CM021101.1,2,29381942,241222416,625680,577036,241799452,203977356
29381942_577055,CM021101.1,2,29381942,241222416,625680,577055,241799471,203977375
29381942_577156,CM021101.1,2,29381942,241222416,625680,577156,241799572,203977476
29381718_581949,CM021101.1,2,29381718,241222417,839657,581949,241804366,203982270
29379471_610282,CM021101.1,2,29379471,241222417,5439607,610282,241832699,204010603
29379471_610315,CM021101.1,2,29379471,241222417,5439607,610315,241832732,204010636
29379471_610451,CM021101.1,2,29379471,241222417,5439607,610451,241832868,204010772
29379471_610460,CM021101.1,2,29379471,241222417,5439607,610460,241832877,204010781
29379471_610482,CM021101.1,2,29379471,241222417,5439607,610482,241832899,204010803
29379471_610486,CM021101.1,2,29379471,241222417,5439607,610486,241832903,204010807
29382126_617112,CM021101.1,2,29382126,241222416,831574,617112,241839528,204017432
29382126_617205,CM021101.1,2,29382126,241222416,831574,617205,241839621,204017525
29381221_654214,CM021101.1,2,29381221,241222418,3793750,654214,241876632,204054536
29381221_654249,CM021101.1,2,29381221,241222418,3793750,654249,241876667,204054571
29378839_661836,CM021101.1,2,29378839,241222416,3856956,661836,241884252,204062156
29377944_674230,CM021101.1,2,29377944,241222416,1661984,674230,241896646,204074550
29377944_674261,CM021101.1,2,29377944,241222416,1661984,674261,241896677,204074581
29377944_674310,CM021101.1,2,29377944,241222416,1661984,674310,241896726,204074630
29379534_681666,CM021101.1,2,29379534,241222417,1518514,681666,241904083,204081987
29380960_691467,CM021101.1,2,29380960,241222417,1494692,691467,241913884,204091788
29380068_696572,CM021101.1,2,29380068,241222418,1542503,696572,241918990,204096894
29380068_696606,CM021101.1,2,29380068,241222418,1542503,696606,241919024,204096928
29377944_699489,CM021101.1,2,29377944,241222416,1661984,699489,241921905,204099809
29377944_782802,CM021101.1,2,29377944,241222416,1661984,782802,242005218,204183122
29377944_782907,CM021101.1,2,29377944,241222416,1661984,782907,242005323,204183227
29377944_782919,CM021101.1,2,29377944,241222416,1661984,782919,242005335,204183239
29380365_769153,CM021101.1,2,29380365,241242777,1005213,769153,242011930,204189834
29377714_854260,CM021101.1,2,29377714,241222416,4654899,854260,242076676,204254580
29377714_855262,CM021101.1,2,29377714,241222416,4654899,855262,242077678,204255582
29379471_886812,CM021101.1,2,29379471,241222417,5439607,886812,242109229,204287133
29379471_886865,CM021101.1,2,29379471,241222417,5439607,886865,242109282,204287186
29379471_887188,CM021101.1,2,29379471,241222417,5439607,887188,242109605,204287509
29379471_887201,CM021101.1,2,29379471,241222417,5439607,887201,242109618,204287522
29379471_887217,CM021101.1,2,29379471,241222417,5439607,887217,242109634,204287538
29380068_887951,CM021101.1,2,29380068,241222418,1542503,887951,242110369,204288273
29379534_950804,CM021101.1,2,29379534,241222417,1518514,950804,242173221,204351125
29379534_950842,CM021101.1,2,29379534,241222417,1518514,950842,242173259,204351163
29379534_958748,CM021101.1,2,29379534,241222417,1518514,958748,242181165,204359069
29382381_953638,CM021101.1,2,29382381,241234682,3811591,953638,242188320,204366224
29382381_954133,CM021101.1,2,29382381,241234682,3811591,954133,242188815,204366719
29382381_959406,CM021101.1,2,29382381,241234682,3811591,959406,242194088,204371992
29377944_988279,CM021101.1,2,29377944,241222416,1661984,988279,242210695,204388599
29378839_994240,CM021101.1,2,29378839,241222416,3856956,994240,242216656,204394560
29381221_1025193,CM021101.1,2,29381221,241222418,3793750,1025193,242247611,204425515
29381921_1023125,CM021101.1,2,29381921,241241027,1439170,1023125,242264152,204442056
29377760_1042799,CM021101.1,2,29377760,241222417,4312873,1042799,242265216,204443120
29377760_1043008,CM021101.1,2,29377760,241222417,4312873,1043008,242265425,204443329
29381921_1025964,CM021101.1,2,29381921,241241027,1439170,1025964,242266991,204444895
29377081_1054706,CM021101.1,2,29377081,241222416,7370404,1054706,242277122,204455026
29377081_1054710,CM021101.1,2,29377081,241222416,7370404,1054710,242277126,204455030
29379471_1205749,CM021101.1,2,29379471,241222417,5439607,1205749,242428166,204606070
29381221_1206984,CM021101.1,2,29381221,241222418,3793750,1206984,242429402,204607306
29381221_1207206,CM021101.1,2,29381221,241222418,3793750,1207206,242429624,204607528
29381221_1207266,CM021101.1,2,29381221,241222418,3793750,1207266,242429684,204607588
29381221_1207269,CM021101.1,2,29381221,241222418,3793750,1207269,242429687,204607591
29382119_1207442,CM021101.1,2,29382119,241222416,1890665,1207442,242429858,204607762
29381221_1207443,CM021101.1,2,29381221,241222418,3793750,1207443,242429861,204607765
29381221_1207508,CM021101.1,2,29381221,241222418,3793750,1207508,242429926,204607830
29381221_1207544,CM021101.1,2,29381221,241222418,3793750,1207544,242429962,204607866
29382119_1207630,CM021101.1,2,29382119,241222416,1890665,1207630,242430046,204607950
29382119_1265495,CM021101.1,2,29382119,241222416,1890665,1265495,242487911,204665815
29377081_1316535,CM021101.1,2,29377081,241222416,7370404,1316535,242538951,204716855
29377081_1316561,CM021101.1,2,29377081,241222416,7370404,1316561,242538977,204716881
29378839_1405157,CM021101.1,2,29378839,241222416,3856956,1405157,242627573,204805477
29378839_1405270,CM021101.1,2,29378839,241222416,3856956,1405270,242627686,204805590
29379471_1407264,CM021101.1,2,29379471,241222417,5439607,1407264,242629681,204807585
29379471_1407326,CM021101.1,2,29379471,241222417,5439607,1407326,242629743,204807647
29379471_1407334,CM021101.1,2,29379471,241222417,5439607,1407334,242629751,204807655
29379471_1407335,CM021101.1,2,29379471,241222417,5439607,1407335,242629752,204807656
29379471_1407365,CM021101.1,2,29379471,241222417,5439607,1407365,242629782,204807686
29379471_1407403,CM021101.1,2,29379471,241222417,5439607,1407403,242629820,204807724
29379471_1407413,CM021101.1,2,29379471,241222417,5439607,1407413,242629830,204807734
29379534_1411376,CM021101.1,2,29379534,241222417,1518514,1411376,242633793,204811697
29377420_1418528,CM021101.1,2,29377420,241222417,7179040,1418528,242640945,204818849
29379534_1465805,CM021101.1,2,29379534,241222417,1518514,1465805,242688222,204866126
29382119_1477911,CM021101.1,2,29382119,241222416,1890665,1477911,242700327,204878231
29379912_1505564,CM021101.1,2,29379912,241222416,3772552,1505564,242727980,204905884
29377081_1524548,CM021101.1,2,29377081,241222416,7370404,1524548,242746964,204924868
29377081_1524886,CM021101.1,2,29377081,241222416,7370404,1524886,242747302,204925206
29377081_1524968,CM021101.1,2,29377081,241222416,7370404,1524968,242747384,204925288
29382387_1555552,CM021101.1,2,29382387,241222417,2310921,1555552,242777969,204955873
29382387_1555740,CM021101.1,2,29382387,241222417,2310921,1555740,242778157,204956061
29382387_1555759,CM021101.1,2,29382387,241222417,2310921,1555759,242778176,204956080
29382119_1668746,CM021101.1,2,29382119,241222416,1890665,1668746,242891162,205069066
29382119_1668784,CM021101.1,2,29382119,241222416,1890665,1668784,242891200,205069104
29379101_1679497,CM021101.1,2,29379101,241222416,1918889,1679497,242901913,205079817
29382119_1714365,CM021101.1,2,29382119,241222416,1890665,1714365,242936781,205114685
29382119_1714865,CM021101.1,2,29382119,241222416,1890665,1714865,242937281,205115185
29382119_1714919,CM021101.1,2,29382119,241222416,1890665,1714919,242937335,205115239
29382119_1714944,CM021101.1,2,29382119,241222416,1890665,1714944,242937360,205115264
29382119_1714958,CM021101.1,2,29382119,241222416,1890665,1714958,242937374,205115278
29382119_1714959,CM021101.1,2,29382119,241222416,1890665,1714959,242937375,205115279
29382119_1714981,CM021101.1,2,29382119,241222416,1890665,1714981,242937397,205115301
29378839_1894016,CM021101.1,2,29378839,241222416,3856956,1894016,243116432,205294336
29378839_1894019,CM021101.1,2,29378839,241222416,3856956,1894019,243116435,205294339
29379101_1896546,CM021101.1,2,29379101,241222416,1918889,1896546,243118962,205296866
29379101_1896677,CM021101.1,2,29379101,241222416,1918889,1896677,243119093,205296997
29378839_1910893,CM021101.1,2,29378839,241222416,3856956,1910893,243133309,205311213
29378839_1910894,CM021101.1,2,29378839,241222416,3856956,1910894,243133310,205311214
29378839_1910916,CM021101.1,2,29378839,241222416,3856956,1910916,243133332,205311236
29378839_1959111,CM021101.1,2,29378839,241222416,3856956,1959111,243181527,205359431
29377760_1966863,CM021101.1,2,29377760,241222417,4312873,1966863,243189280,205367184
29378382_1959692,CM021101.1,2,29378382,241237801,8319329,1959692,243197493,205375397
29382387_2026786,CM021101.1,2,29382387,241222417,2310921,2026786,243249203,205427107
29382387_2026804,CM021101.1,2,29382387,241222417,2310921,2026804,243249221,205427125
29382387_2026811,CM021101.1,2,29382387,241222417,2310921,2026811,243249228,205427132
29382387_2026820,CM021101.1,2,29382387,241222417,2310921,2026820,243249237,205427141
29382387_2026846,CM021101.1,2,29382387,241222417,2310921,2026846,243249263,205427167
29382387_2026851,CM021101.1,2,29382387,241222417,2310921,2026851,243249268,205427172
29378839_2029929,CM021101.1,2,29378839,241222416,3856956,2029929,243252345,205430249
29378839_2029945,CM021101.1,2,29378839,241222416,3856956,2029945,243252361,205430265
29382387_2108839,CM021101.1,2,29382387,241222417,2310921,2108839,243331256,205509160
29378314_2152895,CM021101.1,2,29378314,241236885,2276873,2152895,243389780,205567684
29377081_2192068,CM021101.1,2,29377081,241222416,7370404,2192068,243414484,205592388
29378314_2180849,CM021101.1,2,29378314,241236885,2276873,2180849,243417734,205595638
29377760_2253428,CM021101.1,2,29377760,241222417,4312873,2253428,243475845,205653749
29377760_2253438,CM021101.1,2,29377760,241222417,4312873,2253438,243475855,205653759
29377760_2254271,CM021101.1,2,29377760,241222417,4312873,2254271,243476688,205654592
29377760_2254328,CM021101.1,2,29377760,241222417,4312873,2254328,243476745,205654649
29377081_2338638,CM021101.1,2,29377081,241222416,7370404,2338638,243561054,205738958
29377081_2338711,CM021101.1,2,29377081,241222416,7370404,2338711,243561127,205739031
29377081_2338712,CM021101.1,2,29377081,241222416,7370404,2338712,243561128,205739032
29377081_2338732,CM021101.1,2,29377081,241222416,7370404,2338732,243561148,205739052
29377081_2338766,CM021101.1,2,29377081,241222416,7370404,2338766,243561182,205739086
29377420_2388040,CM021101.1,2,29377420,241222417,7179040,2388040,243610457,205788361
29377420_2388096,CM021101.1,2,29377420,241222417,7179040,2388096,243610513,205788417
29377420_2388215,CM021101.1,2,29377420,241222417,7179040,2388215,243610632,205788536
29378839_2412660,CM021101.1,2,29378839,241222416,3856956,2412660,243635076,205812980
29378839_2412710,CM021101.1,2,29378839,241222416,3856956,2412710,243635126,205813030
29379912_2459201,CM021101.1,2,29379912,241222416,3772552,2459201,243681617,205859521
29377714_2461050,CM021101.1,2,29377714,241222416,4654899,2461050,243683466,205861370
29377714_2463396,CM021101.1,2,29377714,241222416,4654899,2463396,243685812,205863716
29378839_2474869,CM021101.1,2,29378839,241222416,3856956,2474869,243697285,205875189
29378839_2475107,CM021101.1,2,29378839,241222416,3856956,2475107,243697523,205875427
29377760_2489173,CM021101.1,2,29377760,241222417,4312873,2489173,243711590,205889494
29377760_2489180,CM021101.1,2,29377760,241222417,4312873,2489180,243711597,205889501
29377760_2489182,CM021101.1,2,29377760,241222417,4312873,2489182,243711599,205889503
29377760_2489189,CM021101.1,2,29377760,241222417,4312873,2489189,243711606,205889510
29378839_2505808,CM021101.1,2,29378839,241222416,3856956,2505808,243728224,205906128
29378839_2554905,CM021101.1,2,29378839,241222416,3856956,2554905,243777321,205955225
29377760_2768956,CM021101.1,2,29377760,241222417,4312873,2768956,243991373,206169277
29377760_3073867,CM021101.1,2,29377760,241222417,4312873,3073867,244296284,206474188
29379912_3261451,CM021101.1,2,29379912,241222416,3772552,3261451,244483867,206661771
29379912_3261462,CM021101.1,2,29379912,241222416,3772552,3261462,244483878,206661782
29379912_3261493,CM021101.1,2,29379912,241222416,3772552,3261493,244483909,206661813
29379912_3261511,CM021101.1,2,29379912,241222416,3772552,3261511,244483927,206661831
29379912_3261520,CM021101.1,2,29379912,241222416,3772552,3261520,244483936,206661840
29377760_3269812,CM021101.1,2,29377760,241222417,4312873,3269812,244492229,206670133
29381513_3298716,CM021101.1,2,29381513,241222409,3465844,3298716,244521125,206699029
29381513_3298977,CM021101.1,2,29381513,241222409,3465844,3298977,244521386,206699290
29377760_3389984,CM021101.1,2,29377760,241222417,4312873,3389984,244612401,206790305
29377760_3389997,CM021101.1,2,29377760,241222417,4312873,3389997,244612414,206790318
29377760_3390109,CM021101.1,2,29377760,241222417,4312873,3390109,244612526,206790430
29382381_3457401,CM021101.1,2,29382381,241234682,3811591,3457401,244692083,206869987
29382381_3457479,CM021101.1,2,29382381,241234682,3811591,3457479,244692161,206870065
29382381_3457558,CM021101.1,2,29382381,241234682,3811591,3457558,244692240,206870144
29380345_13906606,CM021101.1,2,29380345,230911610,14989931,13906606,244818216,206996120
29380345_13932940,CM021101.1,2,29380345,230911610,14989931,13932940,244844550,207022454
29380345_13933100,CM021101.1,2,29380345,230911610,14989931,13933100,244844710,207022614
29380345_13933682,CM021101.1,2,29380345,230911610,14989931,13933682,244845292,207023196
29380345_13933732,CM021101.1,2,29380345,230911610,14989931,13933732,244845342,207023246
29380345_13933788,CM021101.1,2,29380345,230911610,14989931,13933788,244845398,207023302
29377714_3814504,CM021101.1,2,29377714,241222416,4654899,3814504,245036920,207214824
29377714_3816179,CM021101.1,2,29377714,241222416,4654899,3816179,245038595,207216499
29377714_3816218,CM021101.1,2,29377714,241222416,4654899,3816218,245038634,207216538
29377714_3817789,CM021101.1,2,29377714,241222416,4654899,3817789,245040205,207218109
29377714_3817806,CM021101.1,2,29377714,241222416,4654899,3817806,245040222,207218126
29377714_3817822,CM021101.1,2,29377714,241222416,4654899,3817822,245040238,207218142
29377420_5005958,CM021101.1,2,29377420,241222417,7179040,5005958,246228375,208406279
29377420_5231973,CM021101.1,2,29377420,241222417,7179040,5231973,246454390,208632294
29377081_5670529,CM021101.1,2,29377081,241222416,7370404,5670529,246892945,209070849
29210785_513,CM021101.1,2,29210785,248983932,7201,513,248984445,211162349
29210785_573,CM021101.1,2,29210785,248983932,7201,573,248984505,211162409
29381725_179111,CM021101.1,2,29381725,253657801,1384339,179111,253836912,216014816
29378051_245288,CM021101.1,2,29378051,253659086,289017,245288,253904374,216082278
29378051_245340,CM021101.1,2,29378051,253659086,289017,245340,253904426,216082330
29378051_245351,CM021101.1,2,29378051,253659086,289017,245351,253904437,216082341
29378051_245443,CM021101.1,2,29378051,253659086,289017,245443,253904529,216082433
29371694_317860,CM021101.1,2,29371694,253658183,491240,317860,253976043,216153947
29371694_317868,CM021101.1,2,29371694,253658183,491240,317868,253976051,216153955
29378647_340983,CM021101.1,2,29378647,253659924,1131763,340983,254000907,216178811
29378647_342412,CM021101.1,2,29378647,253659924,1131763,342412,254002336,216180240
29378647_402348,CM021101.1,2,29378647,253659924,1131763,402348,254062272,216240176
29379518_434944,CM021101.1,2,29379518,253658117,2295376,434944,254093061,216270965
29379757_617747,CM021101.1,2,29379757,253657812,1250917,617747,254275559,216453463
29379757_620973,CM021101.1,2,29379757,253657812,1250917,620973,254278785,216456689
29379757_621767,CM021101.1,2,29379757,253657812,1250917,621767,254279579,216457483
29379757_645552,CM021101.1,2,29379757,253657812,1250917,645552,254303364,216481268
29378321_692522,CM021101.1,2,29378321,253657812,696865,692522,254350334,216528238
29379757_732861,CM021101.1,2,29379757,253657812,1250917,732861,254390673,216568577
29379757_732881,CM021101.1,2,29379757,253657812,1250917,732881,254390693,216568597
29379757_732926,CM021101.1,2,29379757,253657812,1250917,732926,254390738,216568642
29379250_834719,CM021101.1,2,29379250,253660195,989402,834719,254494914,216672818
29379250_835140,CM021101.1,2,29379250,253660195,989402,835140,254495335,216673239
29379250_835141,CM021101.1,2,29379250,253660195,989402,835141,254495336,216673240
29379250_849799,CM021101.1,2,29379250,253660195,989402,849799,254509994,216687898
29381725_1299622,CM021101.1,2,29381725,253657801,1384339,1299622,254957423,217135327
29377745_1570117,CM021101.1,2,29377745,253657809,2012539,1570117,255227926,217405830
29380562_1617170,CM021101.1,2,29380562,253657812,1637727,1617170,255274982,217452886
29380562_1617254,CM021101.1,2,29380562,253657812,1637727,1617254,255275066,217452970
29379518_1628280,CM021101.1,2,29379518,253658117,2295376,1628280,255286397,217464301
29379518_1628294,CM021101.1,2,29379518,253658117,2295376,1628294,255286411,217464315
29379518_1628380,CM021101.1,2,29379518,253658117,2295376,1628380,255286497,217464401
29378765_1980739,CM021101.1,2,29378765,253657894,3838578,1980739,255638633,217816537
29378765_1983135,CM021101.1,2,29378765,253657894,3838578,1983135,255641029,217818933
29380437_2409951,CM021101.1,2,29380437,253657812,3694400,2409951,256067763,218245667
29380437_2409960,CM021101.1,2,29380437,253657812,3694400,2409960,256067772,218245676
29380437_2409975,CM021101.1,2,29380437,253657812,3694400,2409975,256067787,218245691
29380437_2409977,CM021101.1,2,29380437,253657812,3694400,2409977,256067789,218245693
29380437_2409984,CM021101.1,2,29380437,253657812,3694400,2409984,256067796,218245700
29380437_2410020,CM021101.1,2,29380437,253657812,3694400,2410020,256067832,218245736
29380437_2410032,CM021101.1,2,29380437,253657812,3694400,2410032,256067844,218245748
29380437_2410037,CM021101.1,2,29380437,253657812,3694400,2410037,256067849,218245753
29380437_2410047,CM021101.1,2,29380437,253657812,3694400,2410047,256067859,218245763
29381134_2545926,CM021101.1,2,29381134,253657812,3133954,2545926,256203738,218381642
29381134_2545987,CM021101.1,2,29381134,253657812,3133954,2545987,256203799,218381703
29381134_2545988,CM021101.1,2,29381134,253657812,3133954,2545988,256203800,218381704
29381134_2546008,CM021101.1,2,29381134,253657812,3133954,2546008,256203820,218381724
29381134_2546014,CM021101.1,2,29381134,253657812,3133954,2546014,256203826,218381730
29381134_2546031,CM021101.1,2,29381134,253657812,3133954,2546031,256203843,218381747
29381134_2546058,CM021101.1,2,29381134,253657812,3133954,2546058,256203870,218381774
29381134_2546066,CM021101.1,2,29381134,253657812,3133954,2546066,256203878,218381782
29381134_2546128,CM021101.1,2,29381134,253657812,3133954,2546128,256203940,218381844
29381134_2546143,CM021101.1,2,29381134,253657812,3133954,2546143,256203955,218381859
29380437_2720404,CM021101.1,2,29380437,253657812,3694400,2720404,256378216,218556120
29378765_2775702,CM021101.1,2,29378765,253657894,3838578,2775702,256433596,218611500
29378765_2775704,CM021101.1,2,29378765,253657894,3838578,2775704,256433598,218611502
29378765_2775717,CM021101.1,2,29378765,253657894,3838578,2775717,256433611,218611515
29378765_2775969,CM021101.1,2,29378765,253657894,3838578,2775969,256433863,218611767
29378765_2775972,CM021101.1,2,29378765,253657894,3838578,2775972,256433866,218611770
29378765_2776010,CM021101.1,2,29378765,253657894,3838578,2776010,256433904,218611808
29380437_2806129,CM021101.1,2,29380437,253657812,3694400,2806129,256463941,218641845
29378765_3518641,CM021101.1,2,29378765,253657894,3838578,3518641,257176535,219354439
29378765_3518810,CM021101.1,2,29378765,253657894,3838578,3518810,257176704,219354608
29378765_3518862,CM021101.1,2,29378765,253657894,3838578,3518862,257176756,219354660
29379125_146882,CM021101.1,2,29379125,273034381,1852806,146882,273181263,235359167
29379125_146903,CM021101.1,2,29379125,273034381,1852806,146903,273181284,235359188
29379125_146996,CM021101.1,2,29379125,273034381,1852806,146996,273181377,235359281
29379125_312783,CM021101.1,2,29379125,273034381,1852806,312783,273347164,235525068
29379125_312837,CM021101.1,2,29379125,273034381,1852806,312837,273347218,235525122
29380302_314515,CM021101.1,2,29380302,273034384,609862,314515,273348899,235526803
29380302_314516,CM021101.1,2,29380302,273034384,609862,314516,273348900,235526804
29380302_314530,CM021101.1,2,29380302,273034384,609862,314530,273348914,235526818
29380302_314546,CM021101.1,2,29380302,273034384,609862,314546,273348930,235526834
29380302_314560,CM021101.1,2,29380302,273034384,609862,314560,273348944,235526848
29380302_314573,CM021101.1,2,29380302,273034384,609862,314573,273348957,235526861
29380302_314609,CM021101.1,2,29380302,273034384,609862,314609,273348993,235526897
29380302_314632,CM021101.1,2,29380302,273034384,609862,314632,273349016,235526920
29380302_427161,CM021101.1,2,29380302,273034384,609862,427161,273461545,235639449
29379125_1322646,CM021101.1,2,29379125,273034381,1852806,1322646,274357027,236534931
29382202_8857,CM021101.1,2,29382202,280924695,657152,8857,280933552,243111456
29382202_8863,CM021101.1,2,29382202,280924695,657152,8863,280933558,243111462
29380258_26198,CM021101.1,2,29380258,280926149,529324,26198,280952347,243130251
29378020_39051,CM021101.1,2,29378020,280924708,1216462,39051,280963759,243141663
29378020_39137,CM021101.1,2,29378020,280924708,1216462,39137,280963845,243141749
29380954_41091,CM021101.1,2,29380954,280924708,1108584,41091,280965799,243143703
29380954_41535,CM021101.1,2,29380954,280924708,1108584,41535,280966243,243144147
29377937_55968,CM021101.1,2,29377937,280924700,2682646,55968,280980668,243158572
29380258_65773,CM021101.1,2,29380258,280926149,529324,65773,280991922,243169826
29380258_65817,CM021101.1,2,29380258,280926149,529324,65817,280991966,243169870
29380258_65865,CM021101.1,2,29380258,280926149,529324,65865,280992014,243169918
29380258_66302,CM021101.1,2,29380258,280926149,529324,66302,280992451,243170355
29380258_66322,CM021101.1,2,29380258,280926149,529324,66322,280992471,243170375
29380258_66364,CM021101.1,2,29380258,280926149,529324,66364,280992513,243170417
29379945_105950,CM021101.1,2,29379945,280924706,4817195,105950,281030656,243208560
29381500_124942,CM021101.1,2,29381500,280924706,5993774,124942,281049648,243227552
29381500_125528,CM021101.1,2,29381500,280924706,5993774,125528,281050234,243228138
29381500_127974,CM021101.1,2,29381500,280924706,5993774,127974,281052680,243230584
29381500_127991,CM021101.1,2,29381500,280924706,5993774,127991,281052697,243230601
29380954_130875,CM021101.1,2,29380954,280924708,1108584,130875,281055583,243233487
29380148_134895,CM021101.1,2,29380148,280924719,4406371,134895,281059614,243237518
29381044_158185,CM021101.1,2,29381044,280924708,3867714,158185,281082893,243260797
29381044_158542,CM021101.1,2,29381044,280924708,3867714,158542,281083250,243261154
29378467_170639,CM021101.1,2,29378467,280924708,5488748,170639,281095347,243273251
29380495_202849,CM021101.1,2,29380495,280943248,431821,202849,281146097,243324001
29379945_243053,CM021101.1,2,29379945,280924706,4817195,243053,281167759,243345663
29379945_243183,CM021101.1,2,29379945,280924706,4817195,243183,281167889,243345793
29379945_243263,CM021101.1,2,29379945,280924706,4817195,243263,281167969,243345873
29381051_244177,CM021101.1,2,29381051,280925106,1338840,244177,281169283,243347187
29378852_316458,CM021101.1,2,29378852,280924706,2374350,316458,281241164,243419068
29378852_316480,CM021101.1,2,29378852,280924706,2374350,316480,281241186,243419090
29378852_316487,CM021101.1,2,29378852,280924706,2374350,316487,281241193,243419097
29378852_316546,CM021101.1,2,29378852,280924706,2374350,316546,281241252,243419156
29378852_348831,CM021101.1,2,29378852,280924706,2374350,348831,281273537,243451441
29378852_349679,CM021101.1,2,29378852,280924706,2374350,349679,281274385,243452289
29381183_388754,CM021101.1,2,29381183,280924697,1863435,388754,281313451,243491355
29378852_391695,CM021101.1,2,29378852,280924706,2374350,391695,281316401,243494305
29381040_403982,CM021101.1,2,29381040,280924705,1214314,403982,281328687,243506591
29381040_404438,CM021101.1,2,29381040,280924705,1214314,404438,281329143,243507047
29381040_404472,CM021101.1,2,29381040,280924705,1214314,404472,281329177,243507081
29381040_404945,CM021101.1,2,29381040,280924705,1214314,404945,281329650,243507554
29381040_405053,CM021101.1,2,29381040,280924705,1214314,405053,281329758,243507662
29381040_405058,CM021101.1,2,29381040,280924705,1214314,405058,281329763,243507667
29381040_405114,CM021101.1,2,29381040,280924705,1214314,405114,281329819,243507723
29381040_405126,CM021101.1,2,29381040,280924705,1214314,405126,281329831,243507735
29378852_408549,CM021101.1,2,29378852,280924706,2374350,408549,281333255,243511159
29378852_408571,CM021101.1,2,29378852,280924706,2374350,408571,281333277,243511181
29378467_492810,CM021101.1,2,29378467,280924708,5488748,492810,281417518,243595422
29378467_532476,CM021101.1,2,29378467,280924708,5488748,532476,281457184,243635088
29378467_532493,CM021101.1,2,29378467,280924708,5488748,532493,281457201,243635105
29378467_532549,CM021101.1,2,29378467,280924708,5488748,532549,281457257,243635161
29381458_566328,CM021101.1,2,29381458,280924706,7112375,566328,281491034,243668938
29378467_580031,CM021101.1,2,29378467,280924708,5488748,580031,281504739,243682643
29378467_580036,CM021101.1,2,29378467,280924708,5488748,580036,281504744,243682648
29378467_580064,CM021101.1,2,29378467,280924708,5488748,580064,281504772,243682676
29379961_594873,CM021101.1,2,29379961,280926409,1014489,594873,281521282,243699186
29380954_605590,CM021101.1,2,29380954,280924708,1108584,605590,281530298,243708202
29378852_624726,CM021101.1,2,29378852,280924706,2374350,624726,281549432,243727336
29381183_648180,CM021101.1,2,29381183,280924697,1863435,648180,281572877,243750781
29378467_655972,CM021101.1,2,29378467,280924708,5488748,655972,281580680,243758584
29378467_656034,CM021101.1,2,29378467,280924708,5488748,656034,281580742,243758646
29380118_705384,CM021101.1,2,29380118,280924910,3765323,705384,281630294,243808198
29380118_705471,CM021101.1,2,29380118,280924910,3765323,705471,281630381,243808285
29378531_719789,CM021101.1,2,29378531,280925436,1118267,719789,281645225,243823129
29380118_736867,CM021101.1,2,29380118,280924910,3765323,736867,281661777,243839681
29379895_741556,CM021101.1,2,29379895,280924704,1720482,741556,281666260,243844164
29382234_745062,CM021101.1,2,29382234,280924708,985238,745062,281669770,243847674
29382234_745089,CM021101.1,2,29382234,280924708,985238,745089,281669797,243847701
29382234_745101,CM021101.1,2,29382234,280924708,985238,745101,281669809,243847713
29382234_745102,CM021101.1,2,29382234,280924708,985238,745102,281669810,243847714
29382234_745127,CM021101.1,2,29382234,280924708,985238,745127,281669835,243847739
29382234_745131,CM021101.1,2,29382234,280924708,985238,745131,281669839,243847743
29382234_745143,CM021101.1,2,29382234,280924708,985238,745143,281669851,243847755
29382234_745151,CM021101.1,2,29382234,280924708,985238,745151,281669859,243847763
29382234_745169,CM021101.1,2,29382234,280924708,985238,745169,281669877,243847781
29381183_783861,CM021101.1,2,29381183,280924697,1863435,783861,281708558,243886462
29381044_791211,CM021101.1,2,29381044,280924708,3867714,791211,281715919,243893823
29381044_791260,CM021101.1,2,29381044,280924708,3867714,791260,281715968,243893872
29381044_791329,CM021101.1,2,29381044,280924708,3867714,791329,281716037,243893941
29381044_794781,CM021101.1,2,29381044,280924708,3867714,794781,281719489,243897393
29381044_794837,CM021101.1,2,29381044,280924708,3867714,794837,281719545,243897449
29381044_794838,CM021101.1,2,29381044,280924708,3867714,794838,281719546,243897450
29381044_795004,CM021101.1,2,29381044,280924708,3867714,795004,281719712,243897616
29380148_806903,CM021101.1,2,29380148,280924719,4406371,806903,281731622,243909526
29380148_807043,CM021101.1,2,29380148,280924719,4406371,807043,281731762,243909666
29380148_807082,CM021101.1,2,29380148,280924719,4406371,807082,281731801,243909705
29381044_809654,CM021101.1,2,29381044,280924708,3867714,809654,281734362,243912266
29381044_840666,CM021101.1,2,29381044,280924708,3867714,840666,281765374,243943278
29381044_846359,CM021101.1,2,29381044,280924708,3867714,846359,281771067,243948971
29381044_846392,CM021101.1,2,29381044,280924708,3867714,846392,281771100,243949004
29378549_847266,CM021101.1,2,29378549,280926208,1647582,847266,281773474,243951378
29381183_860505,CM021101.1,2,29381183,280924697,1863435,860505,281785202,243963106
29378313_935812,CM021101.1,2,29378313,280924705,2816201,935812,281860517,244038421
29378313_952757,CM021101.1,2,29378313,280924705,2816201,952757,281877462,244055366
29382339_963924,CM021101.1,2,29382339,280926112,1019356,963924,281890036,244067940
29380836_969387,CM021101.1,2,29380836,280925471,2389887,969387,281894858,244072762
29378467_973898,CM021101.1,2,29378467,280924708,5488748,973898,281898606,244076510
29378467_973899,CM021101.1,2,29378467,280924708,5488748,973899,281898607,244076511
29378467_973900,CM021101.1,2,29378467,280924708,5488748,973900,281898608,244076512
29377937_1039182,CM021101.1,2,29377937,280924700,2682646,1039182,281963882,244141786
29377937_1039191,CM021101.1,2,29377937,280924700,2682646,1039191,281963891,244141795
29378313_1100366,CM021101.1,2,29378313,280924705,2816201,1100366,282025071,244202975
29379797_1212928,CM021101.1,2,29379797,280925996,3109731,1212928,282138924,244316828
29379797_1212951,CM021101.1,2,29379797,280925996,3109731,1212951,282138947,244316851
29379797_1212961,CM021101.1,2,29379797,280925996,3109731,1212961,282138957,244316861
29379797_1212972,CM021101.1,2,29379797,280925996,3109731,1212972,282138968,244316872
29379797_1213035,CM021101.1,2,29379797,280925996,3109731,1213035,282139031,244316935
29379797_1213082,CM021101.1,2,29379797,280925996,3109731,1213082,282139078,244316982
29380148_1265664,CM021101.1,2,29380148,280924719,4406371,1265664,282190383,244368287
29380148_1268321,CM021101.1,2,29380148,280924719,4406371,1268321,282193040,244370944
29380148_1269370,CM021101.1,2,29380148,280924719,4406371,1269370,282194089,244371993
29380148_1335597,CM021101.1,2,29380148,280924719,4406371,1335597,282260316,244438220
29380148_1369054,CM021101.1,2,29380148,280924719,4406371,1369054,282293773,244471677
29380148_1404185,CM021101.1,2,29380148,280924719,4406371,1404185,282328904,244506808
29379797_1482652,CM021101.1,2,29379797,280925996,3109731,1482652,282408648,244586552
29379797_1500141,CM021101.1,2,29379797,280925996,3109731,1500141,282426137,244604041
29379797_1500338,CM021101.1,2,29379797,280925996,3109731,1500338,282426334,244604238
29379797_1506677,CM021101.1,2,29379797,280925996,3109731,1506677,282432673,244610577
29379945_1510785,CM021101.1,2,29379945,280924706,4817195,1510785,282435491,244613395
29379945_1521101,CM021101.1,2,29379945,280924706,4817195,1521101,282445807,244623711
29379945_1534433,CM021101.1,2,29379945,280924706,4817195,1534433,282459139,244637043
29379945_1534937,CM021101.1,2,29379945,280924706,4817195,1534937,282459643,244637547
29379945_1536048,CM021101.1,2,29379945,280924706,4817195,1536048,282460754,244638658
29379945_1537942,CM021101.1,2,29379945,280924706,4817195,1537942,282462648,244640552
29378313_1551415,CM021101.1,2,29378313,280924705,2816201,1551415,282476120,244654024
29378313_1551451,CM021101.1,2,29378313,280924705,2816201,1551451,282476156,244654060
29378313_1551489,CM021101.1,2,29378313,280924705,2816201,1551489,282476194,244654098
29378313_1551585,CM021101.1,2,29378313,280924705,2816201,1551585,282476290,244654194
29378313_1551849,CM021101.1,2,29378313,280924705,2816201,1551849,282476554,244654458
29378852_1608832,CM021101.1,2,29378852,280924706,2374350,1608832,282533538,244711442
29381500_1726596,CM021101.1,2,29381500,280924706,5993774,1726596,282651302,244829206
29380148_1759409,CM021101.1,2,29380148,280924719,4406371,1759409,282684128,244862032
29380148_1759452,CM021101.1,2,29380148,280924719,4406371,1759452,282684171,244862075
29380148_1771332,CM021101.1,2,29380148,280924719,4406371,1771332,282696051,244873955
29380148_1771333,CM021101.1,2,29380148,280924719,4406371,1771333,282696052,244873956
29381500_1956981,CM021101.1,2,29381500,280924706,5993774,1956981,282881687,245059591
29381500_2010727,CM021101.1,2,29381500,280924706,5993774,2010727,282935433,245113337
29378467_2024855,CM021101.1,2,29378467,280924708,5488748,2024855,282949563,245127467
29379797_2056080,CM021101.1,2,29379797,280925996,3109731,2056080,282982076,245159980
29378852_2134619,CM021101.1,2,29378852,280924706,2374350,2134619,283059325,245237229
29379945_2216261,CM021101.1,2,29379945,280924706,4817195,2216261,283140967,245318871
29380148_2223731,CM021101.1,2,29380148,280924719,4406371,2223731,283148450,245326354
29380148_2223746,CM021101.1,2,29380148,280924719,4406371,2223746,283148465,245326369
29380148_2335197,CM021101.1,2,29380148,280924719,4406371,2335197,283259916,245437820
29380148_2335271,CM021101.1,2,29380148,280924719,4406371,2335271,283259990,245437894
29381044_2377881,CM021101.1,2,29381044,280924708,3867714,2377881,283302589,245480493
29377110_2458750,CM021101.1,2,29377110,280924706,5438894,2458750,283383456,245561360
29377110_2461399,CM021101.1,2,29377110,280924706,5438894,2461399,283386105,245564009
29377110_2461508,CM021101.1,2,29377110,280924706,5438894,2461508,283386214,245564118
29380148_2507835,CM021101.1,2,29380148,280924719,4406371,2507835,283432554,245610458
29380148_2508046,CM021101.1,2,29380148,280924719,4406371,2508046,283432765,245610669
29378313_2564935,CM021101.1,2,29378313,280924705,2816201,2564935,283489640,245667544
29378313_2564949,CM021101.1,2,29378313,280924705,2816201,2564949,283489654,245667558
29378313_2564959,CM021101.1,2,29378313,280924705,2816201,2564959,283489664,245667568
29378313_2565054,CM021101.1,2,29378313,280924705,2816201,2565054,283489759,245667663
29378313_2565073,CM021101.1,2,29378313,280924705,2816201,2565073,283489778,245667682
29378313_2565080,CM021101.1,2,29378313,280924705,2816201,2565080,283489785,245667689
29378313_2565103,CM021101.1,2,29378313,280924705,2816201,2565103,283489808,245667712
29378313_2565111,CM021101.1,2,29378313,280924705,2816201,2565111,283489816,245667720
29378313_2565115,CM021101.1,2,29378313,280924705,2816201,2565115,283489820,245667724
29378313_2565127,CM021101.1,2,29378313,280924705,2816201,2565127,283489832,245667736
29378313_2565136,CM021101.1,2,29378313,280924705,2816201,2565136,283489841,245667745
29378313_2565152,CM021101.1,2,29378313,280924705,2816201,2565152,283489857,245667761
29378313_2565184,CM021101.1,2,29378313,280924705,2816201,2565184,283489889,245667793
29378313_2565196,CM021101.1,2,29378313,280924705,2816201,2565196,283489901,245667805
29378313_2565213,CM021101.1,2,29378313,280924705,2816201,2565213,283489918,245667822
29378313_2565229,CM021101.1,2,29378313,280924705,2816201,2565229,283489934,245667838
29378467_2579014,CM021101.1,2,29378467,280924708,5488748,2579014,283503722,245681626
29380118_2618411,CM021101.1,2,29380118,280924910,3765323,2618411,283543321,245721225
29380118_2618544,CM021101.1,2,29380118,280924910,3765323,2618544,283543454,245721358
29380118_2637955,CM021101.1,2,29380118,280924910,3765323,2637955,283562865,245740769
29380148_2647104,CM021101.1,2,29380148,280924719,4406371,2647104,283571823,245749727
29380148_2647110,CM021101.1,2,29380148,280924719,4406371,2647110,283571829,245749733
29380148_2647126,CM021101.1,2,29380148,280924719,4406371,2647126,283571845,245749749
29381500_2651943,CM021101.1,2,29381500,280924706,5993774,2651943,283576649,245754553
29381500_2652205,CM021101.1,2,29381500,280924706,5993774,2652205,283576911,245754815
29377110_3160984,CM021101.1,2,29377110,280924706,5438894,3160984,284085690,246263594
29377110_3161042,CM021101.1,2,29377110,280924706,5438894,3161042,284085748,246263652
29381500_3170693,CM021101.1,2,29381500,280924706,5993774,3170693,284095399,246273303
29380118_3319389,CM021101.1,2,29380118,280924910,3765323,3319389,284244299,246422203
29380148_3481780,CM021101.1,2,29380148,280924719,4406371,3481780,284406499,246584403
29378467_3881603,CM021101.1,2,29378467,280924708,5488748,3881603,284806311,246984215
29381458_4072600,CM021101.1,2,29381458,280924706,7112375,4072600,284997306,247175210
29381458_4072676,CM021101.1,2,29381458,280924706,7112375,4072676,284997382,247175286
29381458_4105813,CM021101.1,2,29381458,280924706,7112375,4105813,285030519,247208423
29380148_4117252,CM021101.1,2,29380148,280924719,4406371,4117252,285041971,247219875
29380148_4122735,CM021101.1,2,29380148,280924719,4406371,4122735,285047454,247225358
29380148_4172144,CM021101.1,2,29380148,280924719,4406371,4172144,285096863,247274767
29380148_4267765,CM021101.1,2,29380148,280924719,4406371,4267765,285192484,247370388
29380148_4267819,CM021101.1,2,29380148,280924719,4406371,4267819,285192538,247370442
29380148_4267834,CM021101.1,2,29380148,280924719,4406371,4267834,285192553,247370457
29381500_4851977,CM021101.1,2,29381500,280924706,5993774,4851977,285776683,247954587
29381500_4852095,CM021101.1,2,29381500,280924706,5993774,4852095,285776801,247954705
29381500_4852273,CM021101.1,2,29381500,280924706,5993774,4852273,285776979,247954883
29381500_4880481,CM021101.1,2,29381500,280924706,5993774,4880481,285805187,247983091
29381500_5041127,CM021101.1,2,29381500,280924706,5993774,5041127,285965833,248143737
29342717_9331,CM021101.1,2,29342717,310706627,9869,9331,310715958,272893862
29342717_9333,CM021101.1,2,29342717,310706627,9869,9333,310715960,272893864
29342717_9368,CM021101.1,2,29342717,310706627,9869,9368,310715995,272893899
29342717_9387,CM021101.1,2,29342717,310706627,9869,9387,310716014,272893918
29342717_9425,CM021101.1,2,29342717,310706627,9869,9425,310716052,272893956
29381684_2641,CM021101.1,2,29381684,311213097,226638,2641,311215738,273393642
29371847_17958,CM021101.1,2,29371847,311214913,151178,17958,311232871,273410775
29371847_17959,CM021101.1,2,29371847,311214913,151178,17959,311232872,273410776
29371847_17969,CM021101.1,2,29371847,311214913,151178,17969,311232882,273410786
29371847_17974,CM021101.1,2,29371847,311214913,151178,17974,311232887,273410791
29371847_17990,CM021101.1,2,29371847,311214913,151178,17990,311232903,273410807
29344736_43111,CM021101.1,2,29344736,311204674,48717,43111,311247785,273425689
29344736_43126,CM021101.1,2,29344736,311204674,48717,43126,311247800,273425704
29344736_43127,CM021101.1,2,29344736,311204674,48717,43127,311247801,273425705
29344736_43185,CM021101.1,2,29344736,311204674,48717,43185,311247859,273425763
29344736_43210,CM021101.1,2,29344736,311204674,48717,43210,311247884,273425788
29344736_43214,CM021101.1,2,29344736,311204674,48717,43214,311247888,273425792
29344736_43265,CM021101.1,2,29344736,311204674,48717,43265,311247939,273425843
29380492_59122,CM021101.1,2,29380492,311211191,10238861,59122,311270313,273448217
29339431_61062,CM021101.1,2,29339431,311211369,873785,61062,311272431,273450335
29339431_61152,CM021101.1,2,29339431,311211369,873785,61152,311272521,273450425
29379785_78408,CM021101.1,2,29379785,311204670,1336687,78408,311283078,273460982
29379785_78458,CM021101.1,2,29379785,311204670,1336687,78458,311283128,273461032
29379785_78480,CM021101.1,2,29379785,311204670,1336687,78480,311283150,273461054
29379785_78630,CM021101.1,2,29379785,311204670,1336687,78630,311283300,273461204
29381684_73665,CM021101.1,2,29381684,311213097,226638,73665,311286762,273464666
29381684_73682,CM021101.1,2,29381684,311213097,226638,73682,311286779,273464683
29379785_178358,CM021101.1,2,29379785,311204670,1336687,178358,311383028,273560932
29379785_178384,CM021101.1,2,29379785,311204670,1336687,178384,311383054,273560958
29379785_178390,CM021101.1,2,29379785,311204670,1336687,178390,311383060,273560964
29380567_194366,CM021101.1,2,29380567,311204670,358084,194366,311399036,273576940
29378483_219175,CM021101.1,2,29378483,311204669,6323571,219175,311423844,273601748
29378483_219199,CM021101.1,2,29378483,311204669,6323571,219199,311423868,273601772
29378483_219209,CM021101.1,2,29378483,311204669,6323571,219209,311423878,273601782
29378483_219252,CM021101.1,2,29378483,311204669,6323571,219252,311423921,273601825
29378483_220213,CM021101.1,2,29378483,311204669,6323571,220213,311424882,273602786
29377501_492687,CM021101.1,2,29377501,311204671,3453910,492687,311697358,273875262
29377501_492763,CM021101.1,2,29377501,311204671,3453910,492763,311697434,273875338
29380492_549549,CM021101.1,2,29380492,311211191,10238861,549549,311760740,273938644
29380492_549551,CM021101.1,2,29380492,311211191,10238861,549551,311760742,273938646
29380492_549678,CM021101.1,2,29380492,311211191,10238861,549678,311760869,273938773
29381310_574047,CM021101.1,2,29381310,311204670,5409816,574047,311778717,273956621
29378651_656494,CM021101.1,2,29378651,311205369,796160,656494,311861863,274039767
29378651_656604,CM021101.1,2,29378651,311205369,796160,656604,311861973,274039877
29378651_656638,CM021101.1,2,29378651,311205369,796160,656638,311862007,274039911
29378651_656721,CM021101.1,2,29378651,311205369,796160,656721,311862090,274039994
29379272_687362,CM021101.1,2,29379272,311204672,4131809,687362,311892034,274069938
29378651_717109,CM021101.1,2,29378651,311205369,796160,717109,311922478,274100382
29378651_717209,CM021101.1,2,29378651,311205369,796160,717209,311922578,274100482
29378651_717239,CM021101.1,2,29378651,311205369,796160,717239,311922608,274100512
29378651_717275,CM021101.1,2,29378651,311205369,796160,717275,311922644,274100548
29381310_955442,CM021101.1,2,29381310,311204670,5409816,955442,312160112,274338016
29381310_955444,CM021101.1,2,29381310,311204670,5409816,955444,312160114,274338018
29381310_955446,CM021101.1,2,29381310,311204670,5409816,955446,312160116,274338020
29379272_1019026,CM021101.1,2,29379272,311204672,4131809,1019026,312223698,274401602
29379272_1020047,CM021101.1,2,29379272,311204672,4131809,1020047,312224719,274402623
29379272_1060616,CM021101.1,2,29379272,311204672,4131809,1060616,312265288,274443192
29379272_1060725,CM021101.1,2,29379272,311204672,4131809,1060725,312265397,274443301
29379272_1332873,CM021101.1,2,29379272,311204672,4131809,1332873,312537545,274715449
29379272_1332884,CM021101.1,2,29379272,311204672,4131809,1332884,312537556,274715460
29379272_1333040,CM021101.1,2,29379272,311204672,4131809,1333040,312537712,274715616
29379272_1333048,CM021101.1,2,29379272,311204672,4131809,1333048,312537720,274715624
29379272_1361858,CM021101.1,2,29379272,311204672,4131809,1361858,312566530,274744434
29379272_1361938,CM021101.1,2,29379272,311204672,4131809,1361938,312566610,274744514
29379272_1361943,CM021101.1,2,29379272,311204672,4131809,1361943,312566615,274744519
29381310_1403300,CM021101.1,2,29381310,311204670,5409816,1403300,312607970,274785874
29381310_1403316,CM021101.1,2,29381310,311204670,5409816,1403316,312607986,274785890
29381310_1403519,CM021101.1,2,29381310,311204670,5409816,1403519,312608189,274786093
29381924_1614906,CM021101.1,2,29381924,311204674,4438665,1614906,312819580,274997484
29379272_1779849,CM021101.1,2,29379272,311204672,4131809,1779849,312984521,275162425
29379272_1779858,CM021101.1,2,29379272,311204672,4131809,1779858,312984530,275162434
29379272_1779901,CM021101.1,2,29379272,311204672,4131809,1779901,312984573,275162477
29379272_1779903,CM021101.1,2,29379272,311204672,4131809,1779903,312984575,275162479
29378483_1832126,CM021101.1,2,29378483,311204669,6323571,1832126,313036795,275214699
29379272_1858792,CM021101.1,2,29379272,311204672,4131809,1858792,313063464,275241368
29379272_1858815,CM021101.1,2,29379272,311204672,4131809,1858815,313063487,275241391
29379272_1859249,CM021101.1,2,29379272,311204672,4131809,1859249,313063921,275241825
29379272_1859279,CM021101.1,2,29379272,311204672,4131809,1859279,313063951,275241855
29379201_1941130,CM021101.1,2,29379201,311204673,15703367,1941130,313145803,275323707
29380492_1967431,CM021101.1,2,29380492,311211191,10238861,1967431,313178622,275356526
29381924_2031558,CM021101.1,2,29381924,311204674,4438665,2031558,313236232,275414136
29381924_2031713,CM021101.1,2,29381924,311204674,4438665,2031713,313236387,275414291
29380492_2370824,CM021101.1,2,29380492,311211191,10238861,2370824,313582015,275759919
29380492_2370835,CM021101.1,2,29380492,311211191,10238861,2370835,313582026,275759930
29380492_2370924,CM021101.1,2,29380492,311211191,10238861,2370924,313582115,275760019
29380492_2379493,CM021101.1,2,29380492,311211191,10238861,2379493,313590684,275768588
29381924_2586718,CM021101.1,2,29381924,311204674,4438665,2586718,313791392,275969296
29381924_2992321,CM021101.1,2,29381924,311204674,4438665,2992321,314196995,276374899
29380492_3564191,CM021101.1,2,29380492,311211191,10238861,3564191,314775382,276953286
29380492_3801524,CM021101.1,2,29380492,311211191,10238861,3801524,315012715,277190619
29380492_3801721,CM021101.1,2,29380492,311211191,10238861,3801721,315012912,277190816
29380492_3801734,CM021101.1,2,29380492,311211191,10238861,3801734,315012925,277190829
29380492_3877287,CM021101.1,2,29380492,311211191,10238861,3877287,315088478,277266382
29381924_4094273,CM021101.1,2,29381924,311204674,4438665,4094273,315298947,277476851
29381924_4097663,CM021101.1,2,29381924,311204674,4438665,4097663,315302337,277480241
29381924_4097672,CM021101.1,2,29381924,311204674,4438665,4097672,315302346,277480250
29381924_4097692,CM021101.1,2,29381924,311204674,4438665,4097692,315302366,277480270
29380492_4110808,CM021101.1,2,29380492,311211191,10238861,4110808,315321999,277499903
29380492_4110823,CM021101.1,2,29380492,311211191,10238861,4110823,315322014,277499918
29380492_4180019,CM021101.1,2,29380492,311211191,10238861,4180019,315391210,277569114
29381924_4334923,CM021101.1,2,29381924,311204674,4438665,4334923,315539597,277717501
29381924_4334972,CM021101.1,2,29381924,311204674,4438665,4334972,315539646,277717550
29381924_4336964,CM021101.1,2,29381924,311204674,4438665,4336964,315541638,277719542
29381924_4337062,CM021101.1,2,29381924,311204674,4438665,4337062,315541736,277719640
29381924_4337093,CM021101.1,2,29381924,311204674,4438665,4337093,315541767,277719671
29381924_4350239,CM021101.1,2,29381924,311204674,4438665,4350239,315554913,277732817
29381924_4422124,CM021101.1,2,29381924,311204674,4438665,4422124,315626798,277804702
29381924_4422184,CM021101.1,2,29381924,311204674,4438665,4422184,315626858,277804762
29381924_4422205,CM021101.1,2,29381924,311204674,4438665,4422205,315626879,277804783
29381924_4422472,CM021101.1,2,29381924,311204674,4438665,4422472,315627146,277805050
29381924_4422496,CM021101.1,2,29381924,311204674,4438665,4422496,315627170,277805074
29380492_4418677,CM021101.1,2,29380492,311211191,10238861,4418677,315629868,277807772
29380492_4418783,CM021101.1,2,29380492,311211191,10238861,4418783,315629974,277807878
29380492_4418819,CM021101.1,2,29380492,311211191,10238861,4418819,315630010,277807914
29380492_4418824,CM021101.1,2,29380492,311211191,10238861,4418824,315630015,277807919
29380492_4602048,CM021101.1,2,29380492,311211191,10238861,4602048,315813239,277991143
29380492_4674571,CM021101.1,2,29380492,311211191,10238861,4674571,315885762,278063666
29378483_4802610,CM021101.1,2,29378483,311204669,6323571,4802610,316007279,278185183
29378483_5011099,CM021101.1,2,29378483,311204669,6323571,5011099,316215768,278393672
29378483_5011145,CM021101.1,2,29378483,311204669,6323571,5011145,316215814,278393718
29380492_5290502,CM021101.1,2,29380492,311211191,10238861,5290502,316501693,278679597
29380492_5290578,CM021101.1,2,29380492,311211191,10238861,5290578,316501769,278679673
29378483_5962670,CM021101.1,2,29378483,311204669,6323571,5962670,317167339,279345243
29379201_7510867,CM021101.1,2,29379201,311204673,15703367,7510867,318715540,280893444
29379201_7510907,CM021101.1,2,29379201,311204673,15703367,7510907,318715580,280893484
29379201_7511322,CM021101.1,2,29379201,311204673,15703367,7511322,318715995,280893899
29379201_7511333,CM021101.1,2,29379201,311204673,15703367,7511333,318716006,280893910
29379201_7511418,CM021101.1,2,29379201,311204673,15703367,7511418,318716091,280893995
29379201_7668580,CM021101.1,2,29379201,311204673,15703367,7668580,318873253,281051157
29380492_7983718,CM021101.1,2,29380492,311211191,10238861,7983718,319194909,281372813
29380492_8618273,CM021101.1,2,29380492,311211191,10238861,8618273,319829464,282007368
29379201_8642675,CM021101.1,2,29379201,311204673,15703367,8642675,319847348,282025252
29379201_8642793,CM021101.1,2,29379201,311204673,15703367,8642793,319847466,282025370
29379201_8642820,CM021101.1,2,29379201,311204673,15703367,8642820,319847493,282025397
29379201_8642844,CM021101.1,2,29379201,311204673,15703367,8642844,319847517,282025421
29379201_8642872,CM021101.1,2,29379201,311204673,15703367,8642872,319847545,282025449
29379201_8642876,CM021101.1,2,29379201,311204673,15703367,8642876,319847549,282025453
29379201_8642888,CM021101.1,2,29379201,311204673,15703367,8642888,319847561,282025465
29379201_8642901,CM021101.1,2,29379201,311204673,15703367,8642901,319847574,282025478
29379201_9431747,CM021101.1,2,29379201,311204673,15703367,9431747,320636420,282814324
29379201_9447923,CM021101.1,2,29379201,311204673,15703367,9447923,320652596,282830500
29379201_9448396,CM021101.1,2,29379201,311204673,15703367,9448396,320653069,282830973
29343519_87245,CM021101.1,2,29343519,336051781,127998,87245,336139026,298316930
29379645_421737,CM021101.1,2,29379645,336053460,1061067,421737,336475197,298653101
29379645_631025,CM021101.1,2,29379645,336053460,1061067,631025,336684485,298862389
29378046_1987774,CM021101.1,2,29378046,345799891,3098966,1987774,347787665,309965569
29378046_1987780,CM021101.1,2,29378046,345799891,3098966,1987780,347787671,309965575
29378046_2004897,CM021101.1,2,29378046,345799891,3098966,2004897,347804788,309982692
29378046_2012219,CM021101.1,2,29378046,345799891,3098966,2012219,347812110,309990014
29378046_2681036,CM021101.1,2,29378046,345799891,3098966,2681036,348480927,310658831
29378046_2681049,CM021101.1,2,29378046,345799891,3098966,2681049,348480940,310658844
29379622_3658167,CM021101.1,2,29379622,345798910,3774007,3658167,349457077,311634981
29379622_3658206,CM021101.1,2,29379622,345798910,3774007,3658206,349457116,311635020
29379622_3658237,CM021101.1,2,29379622,345798910,3774007,3658237,349457147,311635051
29379622_3658332,CM021101.1,2,29379622,345798910,3774007,3658332,349457242,311635146
29379622_3658355,CM021101.1,2,29379622,345798910,3774007,3658355,349457265,311635169
29379622_3658512,CM021101.1,2,29379622,345798910,3774007,3658512,349457422,311635326
29379622_3658631,CM021101.1,2,29379622,345798910,3774007,3658631,349457541,311635445
29381954_37015,CM021101.1,2,29381954,351493147,54720,37015,351530162,313708066
29381954_37016,CM021101.1,2,29381954,351493147,54720,37016,351530163,313708067
29381954_37033,CM021101.1,2,29381954,351493147,54720,37033,351530180,313708084
29381954_37057,CM021101.1,2,29381954,351493147,54720,37057,351530204,313708108
29381954_37075,CM021101.1,2,29381954,351493147,54720,37075,351530222,313708126
29381954_37108,CM021101.1,2,29381954,351493147,54720,37108,351530255,313708159
29381954_37130,CM021101.1,2,29381954,351493147,54720,37130,351530277,313708181
29378907_126011,CM021101.1,2,29378907,351493306,273821,126011,351619317,313797221
29378907_126013,CM021101.1,2,29378907,351493306,273821,126013,351619319,313797223
29378907_126029,CM021101.1,2,29378907,351493306,273821,126029,351619335,313797239
29378907_126030,CM021101.1,2,29378907,351493306,273821,126030,351619336,313797240
29378907_126033,CM021101.1,2,29378907,351493306,273821,126033,351619339,313797243
29378907_126085,CM021101.1,2,29378907,351493306,273821,126085,351619391,313797295
29378907_126092,CM021101.1,2,29378907,351493306,273821,126092,351619398,313797302
29378907_126132,CM021101.1,2,29378907,351493306,273821,126132,351619438,313797342
29378907_126147,CM021101.1,2,29378907,351493306,273821,126147,351619453,313797357
29378907_126152,CM021101.1,2,29378907,351493306,273821,126152,351619458,313797362
29378907_126272,CM021101.1,2,29378907,351493306,273821,126272,351619578,313797482
29378907_126290,CM021101.1,2,29378907,351493306,273821,126290,351619596,313797500
29378907_126352,CM021101.1,2,29378907,351493306,273821,126352,351619658,313797562
29378907_206181,CM021101.1,2,29378907,351493306,273821,206181,351699487,313877391
29378907_206466,CM021101.1,2,29378907,351493306,273821,206466,351699772,313877676
29380150_541,CM021101.1,2,29380150,354411411,304353,541,354411952,316589856
29380150_14331,CM021101.1,2,29380150,354411411,304353,14331,354425742,316603646
29380150_14436,CM021101.1,2,29380150,354411411,304353,14436,354425847,316603751
29379022_52795,CM021101.1,2,29379022,354411417,459164,52795,354464212,316642116
29379022_52796,CM021101.1,2,29379022,354411417,459164,52796,354464213,316642117
29379022_52833,CM021101.1,2,29379022,354411417,459164,52833,354464250,316642154
28499031_2843,CM021101.1,2,28499031,394233483,7001,2843,394236326,356414230
28499031_2844,CM021101.1,2,28499031,394233483,7001,2844,394236327,356414231
29382460_10717,CM021101.1,2,29382460,414216187,2701421,10717,414226904,376404808
29382460_10790,CM021101.1,2,29382460,414216187,2701421,10790,414226977,376404881
29382460_10844,CM021101.1,2,29382460,414216187,2701421,10844,414227031,376404935
29382460_10898,CM021101.1,2,29382460,414216187,2701421,10898,414227085,376404989
29378937_29331,CM021101.1,2,29378937,414215534,1223164,29331,414244865,376422769
29378937_29376,CM021101.1,2,29378937,414215534,1223164,29376,414244910,376422814
29378937_49012,CM021101.1,2,29378937,414215534,1223164,49012,414264546,376442450
29378937_49076,CM021101.1,2,29378937,414215534,1223164,49076,414264610,376442514
29382414_193772,CM021101.1,2,29382414,414215347,3877561,193772,414409119,376587023
29382414_194079,CM021101.1,2,29382414,414215347,3877561,194079,414409426,376587330
29378479_261578,CM021101.1,2,29378479,414216817,1214185,261578,414478395,376656299
29378479_261755,CM021101.1,2,29378479,414216817,1214185,261755,414478572,376656476
29378937_273184,CM021101.1,2,29378937,414215534,1223164,273184,414488718,376666622
29378937_273273,CM021101.1,2,29378937,414215534,1223164,273273,414488807,376666711
29378937_322493,CM021101.1,2,29378937,414215534,1223164,322493,414538027,376715931
29378937_324206,CM021101.1,2,29378937,414215534,1223164,324206,414539740,376717644
29378937_324313,CM021101.1,2,29378937,414215534,1223164,324313,414539847,376717751
29378937_324527,CM021101.1,2,29378937,414215534,1223164,324527,414540061,376717965
29378937_324553,CM021101.1,2,29378937,414215534,1223164,324553,414540087,376717991
29378937_325075,CM021101.1,2,29378937,414215534,1223164,325075,414540609,376718513
29378937_325081,CM021101.1,2,29378937,414215534,1223164,325081,414540615,376718519
29378937_325095,CM021101.1,2,29378937,414215534,1223164,325095,414540629,376718533
29378937_325096,CM021101.1,2,29378937,414215534,1223164,325096,414540630,376718534
29378937_325139,CM021101.1,2,29378937,414215534,1223164,325139,414540673,376718577
29380887_356219,CM021101.1,2,29380887,414216049,1862398,356219,414572268,376750172
29379513_393568,CM021101.1,2,29379513,414215278,4088723,393568,414608846,376786750
29378444_423073,CM021101.1,2,29378444,414216266,1615151,423073,414639339,376817243
29378444_464593,CM021101.1,2,29378444,414216266,1615151,464593,414680859,376858763
29380856_507010,CM021101.1,2,29380856,414215276,2860816,507010,414722286,376900190
29381141_508695,CM021101.1,2,29381141,414216033,3305497,508695,414724728,376902632
29378444_517900,CM021101.1,2,29378444,414216266,1615151,517900,414734166,376912070
29378444_517903,CM021101.1,2,29378444,414216266,1615151,517903,414734169,376912073
29378444_517985,CM021101.1,2,29378444,414216266,1615151,517985,414734251,376912155
29379873_675098,CM021101.1,2,29379873,414217277,742681,675098,414892375,377070279
29379873_675114,CM021101.1,2,29379873,414217277,742681,675114,414892391,377070295
29379873_696324,CM021101.1,2,29379873,414217277,742681,696324,414913601,377091505
29345239_713348,CM021101.1,2,29345239,414215275,750787,713348,414928623,377106527
29378479_753922,CM021101.1,2,29378479,414216817,1214185,753922,414970739,377148643
29378479_770458,CM021101.1,2,29378479,414216817,1214185,770458,414987275,377165179
29380887_882779,CM021101.1,2,29380887,414216049,1862398,882779,415098828,377276732
29380887_882818,CM021101.1,2,29380887,414216049,1862398,882818,415098867,377276771
29380887_882842,CM021101.1,2,29380887,414216049,1862398,882842,415098891,377276795
29380887_882879,CM021101.1,2,29380887,414216049,1862398,882879,415098928,377276832
29380887_941251,CM021101.1,2,29380887,414216049,1862398,941251,415157300,377335204
29380887_941261,CM021101.1,2,29380887,414216049,1862398,941261,415157310,377335214
29380887_941263,CM021101.1,2,29380887,414216049,1862398,941263,415157312,377335216
29380887_941265,CM021101.1,2,29380887,414216049,1862398,941265,415157314,377335218
29380887_941482,CM021101.1,2,29380887,414216049,1862398,941482,415157531,377335435
29377587_1165908,CM021101.1,2,29377587,414215281,5541571,1165908,415381189,377559093
29379513_1358945,CM021101.1,2,29379513,414215278,4088723,1358945,415574223,377752127
29379513_1358947,CM021101.1,2,29379513,414215278,4088723,1358947,415574225,377752129
29379513_1358998,CM021101.1,2,29379513,414215278,4088723,1358998,415574276,377752180
29379513_1359005,CM021101.1,2,29379513,414215278,4088723,1359005,415574283,377752187
29379513_1359026,CM021101.1,2,29379513,414215278,4088723,1359026,415574304,377752208
29379513_1359030,CM021101.1,2,29379513,414215278,4088723,1359030,415574308,377752212
29379513_1359068,CM021101.1,2,29379513,414215278,4088723,1359068,415574346,377752250
29382027_1369335,CM021101.1,2,29382027,414216169,6441402,1369335,415585504,377763408
29382027_1369337,CM021101.1,2,29382027,414216169,6441402,1369337,415585506,377763410
29382027_1369354,CM021101.1,2,29382027,414216169,6441402,1369354,415585523,377763427
29382027_1369355,CM021101.1,2,29382027,414216169,6441402,1369355,415585524,377763428
29382027_1369413,CM021101.1,2,29382027,414216169,6441402,1369413,415585582,377763486
29382027_1369428,CM021101.1,2,29382027,414216169,6441402,1369428,415585597,377763501
29382027_1369429,CM021101.1,2,29382027,414216169,6441402,1369429,415585598,377763502
29378444_1383845,CM021101.1,2,29378444,414216266,1615151,1383845,415600111,377778015
29378444_1383853,CM021101.1,2,29378444,414216266,1615151,1383853,415600119,377778023
29378444_1383860,CM021101.1,2,29378444,414216266,1615151,1383860,415600126,377778030
29378444_1383905,CM021101.1,2,29378444,414216266,1615151,1383905,415600171,377778075
29379513_1518882,CM021101.1,2,29379513,414215278,4088723,1518882,415734160,377912064
29379513_1518947,CM021101.1,2,29379513,414215278,4088723,1518947,415734225,377912129
29379513_1518971,CM021101.1,2,29379513,414215278,4088723,1518971,415734249,377912153
29382414_1596826,CM021101.1,2,29382414,414215347,3877561,1596826,415812173,377990077
29379513_1612374,CM021101.1,2,29379513,414215278,4088723,1612374,415827652,378005556
29379513_1612381,CM021101.1,2,29379513,414215278,4088723,1612381,415827659,378005563
29379513_1612600,CM021101.1,2,29379513,414215278,4088723,1612600,415827878,378005782
29379513_1652987,CM021101.1,2,29379513,414215278,4088723,1652987,415868265,378046169
29379513_1652994,CM021101.1,2,29379513,414215278,4088723,1652994,415868272,378046176
29379513_1653009,CM021101.1,2,29379513,414215278,4088723,1653009,415868287,378046191
29379513_1653078,CM021101.1,2,29379513,414215278,4088723,1653078,415868356,378046260
29382414_1728326,CM021101.1,2,29382414,414215347,3877561,1728326,415943673,378121577
29382414_1728392,CM021101.1,2,29382414,414215347,3877561,1728392,415943739,378121643
29380633_1926747,CM021101.1,2,29380633,414215555,2601126,1926747,416142302,378320206
29380633_1927069,CM021101.1,2,29380633,414215555,2601126,1927069,416142624,378320528
29380856_1955088,CM021101.1,2,29380856,414215276,2860816,1955088,416170364,378348268
29380856_1955126,CM021101.1,2,29380856,414215276,2860816,1955126,416170402,378348306
29380633_1963959,CM021101.1,2,29380633,414215555,2601126,1963959,416179514,378357418
29382414_2125463,CM021101.1,2,29382414,414215347,3877561,2125463,416340810,378518714
29382414_2125537,CM021101.1,2,29382414,414215347,3877561,2125537,416340884,378518788
29382414_2125595,CM021101.1,2,29382414,414215347,3877561,2125595,416340942,378518846
29377972_2150945,CM021101.1,2,29377972,414215281,2633906,2150945,416366226,378544130
29377972_2151005,CM021101.1,2,29377972,414215281,2633906,2151005,416366286,378544190
29377972_2151109,CM021101.1,2,29377972,414215281,2633906,2151109,416366390,378544294
29377972_2151119,CM021101.1,2,29377972,414215281,2633906,2151119,416366400,378544304
29377151_2154878,CM021101.1,2,29377151,414215277,5504596,2154878,416370155,378548059
29379513_2255218,CM021101.1,2,29379513,414215278,4088723,2255218,416470496,378648400
29379513_2255564,CM021101.1,2,29379513,414215278,4088723,2255564,416470842,378648746
29381124_2348569,CM021101.1,2,29381124,414215281,7228331,2348569,416563850,378741754
29380633_2475011,CM021101.1,2,29380633,414215555,2601126,2475011,416690566,378868470
29380633_2475052,CM021101.1,2,29380633,414215555,2601126,2475052,416690607,378868511
29382414_2541779,CM021101.1,2,29382414,414215347,3877561,2541779,416757126,378935030
29382414_2541823,CM021101.1,2,29382414,414215347,3877561,2541823,416757170,378935074
29382414_2541855,CM021101.1,2,29382414,414215347,3877561,2541855,416757202,378935106
29380856_2660409,CM021101.1,2,29380856,414215276,2860816,2660409,416875685,379053589
29382414_2734103,CM021101.1,2,29382414,414215347,3877561,2734103,416949450,379127354
29382414_2742643,CM021101.1,2,29382414,414215347,3877561,2742643,416957990,379135894
29382414_2757607,CM021101.1,2,29382414,414215347,3877561,2757607,416972954,379150858
29382414_2757696,CM021101.1,2,29382414,414215347,3877561,2757696,416973043,379150947
29382414_2757708,CM021101.1,2,29382414,414215347,3877561,2757708,416973055,379150959
29382414_2757712,CM021101.1,2,29382414,414215347,3877561,2757712,416973059,379150963
29382414_2757724,CM021101.1,2,29382414,414215347,3877561,2757724,416973071,379150975
29377587_3188623,CM021101.1,2,29377587,414215281,5541571,3188623,417403904,379581808
29377587_3188649,CM021101.1,2,29377587,414215281,5541571,3188649,417403930,379581834
29377587_3188894,CM021101.1,2,29377587,414215281,5541571,3188894,417404175,379582079
29377587_3206760,CM021101.1,2,29377587,414215281,5541571,3206760,417422041,379599945
29377587_3206772,CM021101.1,2,29377587,414215281,5541571,3206772,417422053,379599957
29377587_3206815,CM021101.1,2,29377587,414215281,5541571,3206815,417422096,379600000
29381124_3275747,CM021101.1,2,29381124,414215281,7228331,3275747,417491028,379668932
29381124_3275791,CM021101.1,2,29381124,414215281,7228331,3275791,417491072,379668976
29381124_3331597,CM021101.1,2,29381124,414215281,7228331,3331597,417546878,379724782
29382027_3415206,CM021101.1,2,29382027,414216169,6441402,3415206,417631375,379809279
29382027_3415229,CM021101.1,2,29382027,414216169,6441402,3415229,417631398,379809302
29381124_3417535,CM021101.1,2,29381124,414215281,7228331,3417535,417632816,379810720
29381124_3417602,CM021101.1,2,29381124,414215281,7228331,3417602,417632883,379810787
29379513_3684616,CM021101.1,2,29379513,414215278,4088723,3684616,417899894,380077798
29379513_3684634,CM021101.1,2,29379513,414215278,4088723,3684634,417899912,380077816
29379513_3685225,CM021101.1,2,29379513,414215278,4088723,3685225,417900503,380078407
29379513_3685737,CM021101.1,2,29379513,414215278,4088723,3685737,417901015,380078919
29379513_3685772,CM021101.1,2,29379513,414215278,4088723,3685772,417901050,380078954
29381124_3705983,CM021101.1,2,29381124,414215281,7228331,3705983,417921264,380099168
29381124_3710590,CM021101.1,2,29381124,414215281,7228331,3710590,417925871,380103775
29377587_3730147,CM021101.1,2,29377587,414215281,5541571,3730147,417945428,380123332
29377587_3730165,CM021101.1,2,29377587,414215281,5541571,3730165,417945446,380123350
29377587_3733210,CM021101.1,2,29377587,414215281,5541571,3733210,417948491,380126395
29377587_4040686,CM021101.1,2,29377587,414215281,5541571,4040686,418255967,380433871
29377587_4040806,CM021101.1,2,29377587,414215281,5541571,4040806,418256087,380433991
29377587_4042980,CM021101.1,2,29377587,414215281,5541571,4042980,418258261,380436165
29377587_4043039,CM021101.1,2,29377587,414215281,5541571,4043039,418258320,380436224
29377587_4171571,CM021101.1,2,29377587,414215281,5541571,4171571,418386852,380564756
29377587_4171602,CM021101.1,2,29377587,414215281,5541571,4171602,418386883,380564787
29382027_4405661,CM021101.1,2,29382027,414216169,6441402,4405661,418621830,380799734
29382027_4405671,CM021101.1,2,29382027,414216169,6441402,4405671,418621840,380799744
29382027_4405684,CM021101.1,2,29382027,414216169,6441402,4405684,418621853,380799757
29382027_4405743,CM021101.1,2,29382027,414216169,6441402,4405743,418621912,380799816
29382027_4423783,CM021101.1,2,29382027,414216169,6441402,4423783,418639952,380817856
29382027_4423799,CM021101.1,2,29382027,414216169,6441402,4423799,418639968,380817872
29382027_4423809,CM021101.1,2,29382027,414216169,6441402,4423809,418639978,380817882
29382027_4423917,CM021101.1,2,29382027,414216169,6441402,4423917,418640086,380817990
29382027_4423932,CM021101.1,2,29382027,414216169,6441402,4423932,418640101,380818005
29382027_4424100,CM021101.1,2,29382027,414216169,6441402,4424100,418640269,380818173
29382027_4424124,CM021101.1,2,29382027,414216169,6441402,4424124,418640293,380818197
29382027_4424132,CM021101.1,2,29382027,414216169,6441402,4424132,418640301,380818205
29382027_4424189,CM021101.1,2,29382027,414216169,6441402,4424189,418640358,380818262
29382027_4424223,CM021101.1,2,29382027,414216169,6441402,4424223,418640392,380818296
29382027_4430658,CM021101.1,2,29382027,414216169,6441402,4430658,418646827,380824731
29382027_4430688,CM021101.1,2,29382027,414216169,6441402,4430688,418646857,380824761
29382027_4450748,CM021101.1,2,29382027,414216169,6441402,4450748,418666917,380844821
29382027_4482241,CM021101.1,2,29382027,414216169,6441402,4482241,418698410,380876314
29382027_4482283,CM021101.1,2,29382027,414216169,6441402,4482283,418698452,380876356
29382027_4514605,CM021101.1,2,29382027,414216169,6441402,4514605,418730774,380908678
29382027_4514675,CM021101.1,2,29382027,414216169,6441402,4514675,418730844,380908748
29382027_4516883,CM021101.1,2,29382027,414216169,6441402,4516883,418733052,380910956
29377587_4906130,CM021101.1,2,29377587,414215281,5541571,4906130,419121411,381299315
29377587_4906730,CM021101.1,2,29377587,414215281,5541571,4906730,419122011,381299915
29382027_5031775,CM021101.1,2,29382027,414216169,6441402,5031775,419247944,381425848
29382027_5031859,CM021101.1,2,29382027,414216169,6441402,5031859,419248028,381425932
29382027_5521227,CM021101.1,2,29382027,414216169,6441402,5521227,419737396,381915300
29382027_5522294,CM021101.1,2,29382027,414216169,6441402,5522294,419738463,381916367
29382027_5522422,CM021101.1,2,29382027,414216169,6441402,5522422,419738591,381916495
29381124_5679127,CM021101.1,2,29381124,414215281,7228331,5679127,419894408,382072312
29381124_5824997,CM021101.1,2,29381124,414215281,7228331,5824997,420040278,382218182
29382027_5876772,CM021101.1,2,29382027,414216169,6441402,5876772,420092941,382270845
29382027_5876811,CM021101.1,2,29382027,414216169,6441402,5876811,420092980,382270884
29382027_5927767,CM021101.1,2,29382027,414216169,6441402,5927767,420143936,382321840
29382027_5927771,CM021101.1,2,29382027,414216169,6441402,5927771,420143940,382321844
29382027_5927824,CM021101.1,2,29382027,414216169,6441402,5927824,420143993,382321897
29381124_6106577,CM021101.1,2,29381124,414215281,7228331,6106577,420321858,382499762
29381124_6111854,CM021101.1,2,29381124,414215281,7228331,6111854,420327135,382505039
29381124_6113638,CM021101.1,2,29381124,414215281,7228331,6113638,420328919,382506823
29378059_79152,CM021101.1,2,29378059,420775354,920244,79152,420854506,383032410
29378059_79688,CM021101.1,2,29378059,420775354,920244,79688,420855042,383032946
29360892_81066,CM021101.1,2,29360892,420775358,353716,81066,420856424,383034328
29379893_82389,CM021101.1,2,29379893,420775355,991008,82389,420857744,383035648
29381147_309886,CM021101.1,2,29381147,420775358,2204446,309886,421085244,383263148
29381147_309917,CM021101.1,2,29381147,420775358,2204446,309917,421085275,383263179
29381147_309978,CM021101.1,2,29381147,420775358,2204446,309978,421085336,383263240
29381147_312314,CM021101.1,2,29381147,420775358,2204446,312314,421087672,383265576
29381147_312429,CM021101.1,2,29381147,420775358,2204446,312429,421087787,383265691
29381147_314344,CM021101.1,2,29381147,420775358,2204446,314344,421089702,383267606
29378059_617624,CM021101.1,2,29378059,420775354,920244,617624,421392978,383570882
29377213_643080,CM021101.1,2,29377213,420775355,1751788,643080,421418435,383596339
29377213_643090,CM021101.1,2,29377213,420775355,1751788,643090,421418445,383596349
29377213_643094,CM021101.1,2,29377213,420775355,1751788,643094,421418449,383596353
29377213_643107,CM021101.1,2,29377213,420775355,1751788,643107,421418462,383596366
29381147_1378923,CM021101.1,2,29381147,420775358,2204446,1378923,422154281,384332185
29381147_1378925,CM021101.1,2,29381147,420775358,2204446,1378925,422154283,384332187
29381147_1378982,CM021101.1,2,29381147,420775358,2204446,1378982,422154340,384332244
29381147_1379058,CM021101.1,2,29381147,420775358,2204446,1379058,422154416,384332320
29381147_1379065,CM021101.1,2,29381147,420775358,2204446,1379065,422154423,384332327
29381147_1379071,CM021101.1,2,29381147,420775358,2204446,1379071,422154429,384332333
29381147_1379100,CM021101.1,2,29381147,420775358,2204446,1379100,422154458,384332362
29381147_1379101,CM021101.1,2,29381147,420775358,2204446,1379101,422154459,384332363
29381147_1379178,CM021101.1,2,29381147,420775358,2204446,1379178,422154536,384332440
29381147_1394045,CM021101.1,2,29381147,420775358,2204446,1394045,422169403,384347307
29378101_1486422,CM021101.1,2,29378101,420775358,1664717,1486422,422261780,384439684
29378101_1486428,CM021101.1,2,29378101,420775358,1664717,1486428,422261786,384439690
29378101_1486469,CM021101.1,2,29378101,420775358,1664717,1486469,422261827,384439731
29381147_1716417,CM021101.1,2,29381147,420775358,2204446,1716417,422491775,384669679
29210654_3769,CM021101.1,2,29210654,423295973,9862,3769,423299742,385477646
29378684_12139,CM021101.1,2,29378684,428854007,89247,12139,428866146,391044050
29378684_12150,CM021101.1,2,29378684,428854007,89247,12150,428866157,391044061
29379621_65573,CM021101.1,2,29379621,441851090,209592,65573,441916663,404094567
29379621_65575,CM021101.1,2,29379621,441851090,209592,65575,441916665,404094569
29379621_65576,CM021101.1,2,29379621,441851090,209592,65576,441916666,404094570
29379621_65577,CM021101.1,2,29379621,441851090,209592,65577,441916667,404094571
29379621_65605,CM021101.1,2,29379621,441851090,209592,65605,441916695,404094599
29379621_65608,CM021101.1,2,29379621,441851090,209592,65608,441916698,404094602
29379621_65614,CM021101.1,2,29379621,441851090,209592,65614,441916704,404094608
29379621_65620,CM021101.1,2,29379621,441851090,209592,65620,441916710,404094614
29379621_65622,CM021101.1,2,29379621,441851090,209592,65622,441916712,404094616
29379621_65632,CM021101.1,2,29379621,441851090,209592,65632,441916722,404094626
29379621_65640,CM021101.1,2,29379621,441851090,209592,65640,441916730,404094634
29379621_65641,CM021101.1,2,29379621,441851090,209592,65641,441916731,404094635
29379621_65653,CM021101.1,2,29379621,441851090,209592,65653,441916743,404094647
29379621_65654,CM021101.1,2,29379621,441851090,209592,65654,441916744,404094648
29375018_91401,CM021101.1,2,29375018,449125831,266508,91401,449217232,411395136
29375018_91523,CM021101.1,2,29375018,449125831,266508,91523,449217354,411395258
29375018_211025,CM021101.1,2,29375018,449125831,266508,211025,449336856,411514760
29375018_211033,CM021101.1,2,29375018,449125831,266508,211033,449336864,411514768
29375018_211053,CM021101.1,2,29375018,449125831,266508,211053,449336884,411514788
29375018_211056,CM021101.1,2,29375018,449125831,266508,211056,449336887,411514791
29375018_211067,CM021101.1,2,29375018,449125831,266508,211067,449336898,411514802
29375018_211079,CM021101.1,2,29375018,449125831,266508,211079,449336910,411514814
29375018_211104,CM021101.1,2,29375018,449125831,266508,211104,449336935,411514839
29375018_211107,CM021101.1,2,29375018,449125831,266508,211107,449336938,411514842
29375018_211110,CM021101.1,2,29375018,449125831,266508,211110,449336941,411514845
29375018_211121,CM021101.1,2,29375018,449125831,266508,211121,449336952,411514856
29375018_211127,CM021101.1,2,29375018,449125831,266508,211127,449336958,411514862
29375018_211136,CM021101.1,2,29375018,449125831,266508,211136,449336967,411514871
29375018_211148,CM021101.1,2,29375018,449125831,266508,211148,449336979,411514883
29375018_211196,CM021101.1,2,29375018,449125831,266508,211196,449337027,411514931
29375018_211197,CM021101.1,2,29375018,449125831,266508,211197,449337028,411514932
29375018_211198,CM021101.1,2,29375018,449125831,266508,211198,449337029,411514933
29375018_255042,CM021101.1,2,29375018,449125831,266508,255042,449380873,411558777
29375018_255044,CM021101.1,2,29375018,449125831,266508,255044,449380875,411558779
29375018_255048,CM021101.1,2,29375018,449125831,266508,255048,449380879,411558783
29375018_255051,CM021101.1,2,29375018,449125831,266508,255051,449380882,411558786
29375018_255052,CM021101.1,2,29375018,449125831,266508,255052,449380883,411558787
29375018_255063,CM021101.1,2,29375018,449125831,266508,255063,449380894,411558798
29375018_255108,CM021101.1,2,29375018,449125831,266508,255108,449380939,411558843
29375018_255109,CM021101.1,2,29375018,449125831,266508,255109,449380940,411558844
29375018_255168,CM021101.1,2,29375018,449125831,266508,255168,449380999,411558903
29378106_49663,CM021101.1,2,29378106,454739958,902876,49663,454789621,416967525
29378106_97273,CM021101.1,2,29378106,454739958,902876,97273,454837231,417015135
29378106_97356,CM021101.1,2,29378106,454739958,902876,97356,454837314,417015218
29378106_97425,CM021101.1,2,29378106,454739958,902876,97425,454837383,417015287
29378106_261182,CM021101.1,2,29378106,454739958,902876,261182,455001140,417179044
29378106_261184,CM021101.1,2,29378106,454739958,902876,261184,455001142,417179046
29378106_261225,CM021101.1,2,29378106,454739958,902876,261225,455001183,417179087
29378106_261226,CM021101.1,2,29378106,454739958,902876,261226,455001184,417179088
29378106_261229,CM021101.1,2,29378106,454739958,902876,261229,455001187,417179091
29378106_405982,CM021101.1,2,29378106,454739958,902876,405982,455145940,417323844
29378106_525257,CM021101.1,2,29378106,454739958,902876,525257,455265215,417443119
29378106_525274,CM021101.1,2,29378106,454739958,902876,525274,455265232,417443136
29378106_525381,CM021101.1,2,29378106,454739958,902876,525381,455265339,417443243
29378106_601078,CM021101.1,2,29378106,454739958,902876,601078,455341036,417518940
29378106_601118,CM021101.1,2,29378106,454739958,902876,601118,455341076,417518980
29379402_32718,CM021101.1,2,29379402,460544382,3212405,32718,460577100,422755004
29381624_35117,CM021101.1,2,29381624,460544382,1121031,35117,460579499,422757403
29381624_35157,CM021101.1,2,29381624,460544382,1121031,35157,460579539,422757443
29381624_35179,CM021101.1,2,29381624,460544382,1121031,35179,460579561,422757465
29381624_35199,CM021101.1,2,29381624,460544382,1121031,35199,460579581,422757485
29381624_35203,CM021101.1,2,29381624,460544382,1121031,35203,460579585,422757489
29379887_70841,CM021101.1,2,29379887,460544850,1400076,70841,460615691,422793595
29382334_150199,CM021101.1,2,29382334,460546197,4084982,150199,460696396,422874300
29354452_155650,CM021101.1,2,29354452,460544381,473850,155650,460700031,422877935
29380035_205294,CM021101.1,2,29380035,460544380,1068685,205294,460749674,422927578
29380035_205334,CM021101.1,2,29380035,460544380,1068685,205334,460749714,422927618
29379887_207699,CM021101.1,2,29379887,460544850,1400076,207699,460752549,422930453
29380035_220025,CM021101.1,2,29380035,460544380,1068685,220025,460764405,422942309
29380035_220134,CM021101.1,2,29380035,460544380,1068685,220134,460764514,422942418
29379402_223950,CM021101.1,2,29379402,460544382,3212405,223950,460768332,422946236
29379402_223956,CM021101.1,2,29379402,460544382,3212405,223956,460768338,422946242
29379402_223989,CM021101.1,2,29379402,460544382,3212405,223989,460768371,422946275
29379402_224041,CM021101.1,2,29379402,460544382,3212405,224041,460768423,422946327
29379402_224055,CM021101.1,2,29379402,460544382,3212405,224055,460768437,422946341
29377685_234234,CM021101.1,2,29377685,460544382,2464179,234234,460778616,422956520
29377685_237435,CM021101.1,2,29377685,460544382,2464179,237435,460781817,422959721
29377685_238911,CM021101.1,2,29377685,460544382,2464179,238911,460783293,422961197
29379887_248018,CM021101.1,2,29379887,460544850,1400076,248018,460792868,422970772
29379887_248050,CM021101.1,2,29379887,460544850,1400076,248050,460792900,422970804
29379887_248071,CM021101.1,2,29379887,460544850,1400076,248071,460792921,422970825
29377719_249204,CM021101.1,2,29377719,460544382,3935609,249204,460793586,422971490
29381970_278974,CM021101.1,2,29381970,460544381,2815733,278974,460823355,423001259
29377719_281676,CM021101.1,2,29377719,460544382,3935609,281676,460826058,423003962
29377719_281728,CM021101.1,2,29377719,460544382,3935609,281728,460826110,423004014
29380237_332605,CM021101.1,2,29380237,460546817,1032297,332605,460879422,423057326
29382334_355353,CM021101.1,2,29382334,460546197,4084982,355353,460901550,423079454
29382334_355468,CM021101.1,2,29382334,460546197,4084982,355468,460901665,423079569
29334876_363225,CM021101.1,2,29334876,460544382,382939,363225,460907607,423085511
29334876_363307,CM021101.1,2,29334876,460544382,382939,363307,460907689,423085593
29334876_363334,CM021101.1,2,29334876,460544382,382939,363334,460907716,423085620
29334876_363342,CM021101.1,2,29334876,460544382,382939,363342,460907724,423085628
29379402_367641,CM021101.1,2,29379402,460544382,3212405,367641,460912023,423089927
29379402_367785,CM021101.1,2,29379402,460544382,3212405,367785,460912167,423090071
29379402_367951,CM021101.1,2,29379402,460544382,3212405,367951,460912333,423090237
29381404_399068,CM021101.1,2,29381404,460544382,4146394,399068,460943450,423121354
29382334_402977,CM021101.1,2,29382334,460546197,4084982,402977,460949174,423127078
29382334_403017,CM021101.1,2,29382334,460546197,4084982,403017,460949214,423127118
29379402_436548,CM021101.1,2,29379402,460544382,3212405,436548,460980930,423158834
29379402_436564,CM021101.1,2,29379402,460544382,3212405,436564,460980946,423158850
29379402_442824,CM021101.1,2,29379402,460544382,3212405,442824,460987206,423165110
29381311_487731,CM021101.1,2,29381311,460544381,5923666,487731,461032112,423210016
29381311_487772,CM021101.1,2,29381311,460544381,5923666,487772,461032153,423210057
29381311_487798,CM021101.1,2,29381311,460544381,5923666,487798,461032179,423210083
29381311_487942,CM021101.1,2,29381311,460544381,5923666,487942,461032323,423210227
29341362_491472,CM021101.1,2,29341362,460544382,497088,491472,461035854,423213758
29379402_491894,CM021101.1,2,29379402,460544382,3212405,491894,461036276,423214180
29379402_491943,CM021101.1,2,29379402,460544382,3212405,491943,461036325,423214229
29379402_496278,CM021101.1,2,29379402,460544382,3212405,496278,461040660,423218564
29379707_497789,CM021101.1,2,29379707,460544382,1356807,497789,461042171,423220075
29379707_497820,CM021101.1,2,29379707,460544382,1356807,497820,461042202,423220106
29379707_497821,CM021101.1,2,29379707,460544382,1356807,497821,461042203,423220107
29379707_497889,CM021101.1,2,29379707,460544382,1356807,497889,461042271,423220175
29380035_514105,CM021101.1,2,29380035,460544380,1068685,514105,461058485,423236389
29379887_539803,CM021101.1,2,29379887,460544850,1400076,539803,461084653,423262557
29379887_540125,CM021101.1,2,29379887,460544850,1400076,540125,461084975,423262879
29380358_543930,CM021101.1,2,29380358,460544382,3440958,543930,461088312,423266216
29380358_544051,CM021101.1,2,29380358,460544382,3440958,544051,461088433,423266337
29380358_544123,CM021101.1,2,29380358,460544382,3440958,544123,461088505,423266409
29380358_544154,CM021101.1,2,29380358,460544382,3440958,544154,461088536,423266440
29380358_544192,CM021101.1,2,29380358,460544382,3440958,544192,461088574,423266478
29377299_694174,CM021101.1,2,29377299,460544382,3814112,694174,461238556,423416460
29378126_699535,CM021101.1,2,29378126,460544382,1243787,699535,461243917,423421821
29377719_704337,CM021101.1,2,29377719,460544382,3935609,704337,461248719,423426623
29377719_704356,CM021101.1,2,29377719,460544382,3935609,704356,461248738,423426642
29377719_704374,CM021101.1,2,29377719,460544382,3935609,704374,461248756,423426660
29377719_704570,CM021101.1,2,29377719,460544382,3935609,704570,461248952,423426856
29377299_709440,CM021101.1,2,29377299,460544382,3814112,709440,461253822,423431726
29377719_735934,CM021101.1,2,29377719,460544382,3935609,735934,461280316,423458220
29377719_736111,CM021101.1,2,29377719,460544382,3935609,736111,461280493,423458397
29377719_748798,CM021101.1,2,29377719,460544382,3935609,748798,461293180,423471084
29377719_748936,CM021101.1,2,29377719,460544382,3935609,748936,461293318,423471222
29380237_808897,CM021101.1,2,29380237,460546817,1032297,808897,461355714,423533618
29380237_808938,CM021101.1,2,29380237,460546817,1032297,808938,461355755,423533659
29379707_882792,CM021101.1,2,29379707,460544382,1356807,882792,461427174,423605078
29379707_882807,CM021101.1,2,29379707,460544382,1356807,882807,461427189,423605093
29377685_937324,CM021101.1,2,29377685,460544382,2464179,937324,461481706,423659610
29377685_937367,CM021101.1,2,29377685,460544382,2464179,937367,461481749,423659653
29377685_937456,CM021101.1,2,29377685,460544382,2464179,937456,461481838,423659742
29377685_937489,CM021101.1,2,29377685,460544382,2464179,937489,461481871,423659775
29379887_1008230,CM021101.1,2,29379887,460544850,1400076,1008230,461553080,423730984
29379887_1008247,CM021101.1,2,29379887,460544850,1400076,1008247,461553097,423731001
29379887_1008321,CM021101.1,2,29379887,460544850,1400076,1008321,461553171,423731075
29379887_1008332,CM021101.1,2,29379887,460544850,1400076,1008332,461553182,423731086
29379887_1008341,CM021101.1,2,29379887,460544850,1400076,1008341,461553191,423731095
29379887_1008343,CM021101.1,2,29379887,460544850,1400076,1008343,461553193,423731097
29379887_1008363,CM021101.1,2,29379887,460544850,1400076,1008363,461553213,423731117
29378445_1076816,CM021101.1,2,29378445,460547592,2054957,1076816,461624408,423802312
29378445_1076906,CM021101.1,2,29378445,460547592,2054957,1076906,461624498,423802402
29378445_1082893,CM021101.1,2,29378445,460547592,2054957,1082893,461630485,423808389
29378445_1083096,CM021101.1,2,29378445,460547592,2054957,1083096,461630688,423808592
29380358_1301384,CM021101.1,2,29380358,460544382,3440958,1301384,461845766,424023670
29380358_1301408,CM021101.1,2,29380358,460544382,3440958,1301408,461845790,424023694
29378445_1330904,CM021101.1,2,29378445,460547592,2054957,1330904,461878496,424056400
29378445_1330934,CM021101.1,2,29378445,460547592,2054957,1330934,461878526,424056430
29378445_1399606,CM021101.1,2,29378445,460547592,2054957,1399606,461947198,424125102
29378445_1399609,CM021101.1,2,29378445,460547592,2054957,1399609,461947201,424125105
29378445_1399672,CM021101.1,2,29378445,460547592,2054957,1399672,461947264,424125168
29379402_1472630,CM021101.1,2,29379402,460544382,3212405,1472630,462017012,424194916
29379402_1476316,CM021101.1,2,29379402,460544382,3212405,1476316,462020698,424198602
29379402_1476368,CM021101.1,2,29379402,460544382,3212405,1476368,462020750,424198654
29379402_1476612,CM021101.1,2,29379402,460544382,3212405,1476612,462020994,424198898
29379402_1476676,CM021101.1,2,29379402,460544382,3212405,1476676,462021058,424198962
29379402_1476698,CM021101.1,2,29379402,460544382,3212405,1476698,462021080,424198984
29379402_1476713,CM021101.1,2,29379402,460544382,3212405,1476713,462021095,424198999
29378971_1485307,CM021101.1,2,29378971,460544382,2790270,1485307,462029689,424207593
29380358_1513600,CM021101.1,2,29380358,460544382,3440958,1513600,462057982,424235886
29378445_1516603,CM021101.1,2,29378445,460547592,2054957,1516603,462064195,424242099
29378445_1516622,CM021101.1,2,29378445,460547592,2054957,1516622,462064214,424242118
29380330_1573540,CM021101.1,2,29380330,460544382,2498412,1573540,462117922,424295826
29379402_1595856,CM021101.1,2,29379402,460544382,3212405,1595856,462140238,424318142
29379402_1595892,CM021101.1,2,29379402,460544382,3212405,1595892,462140274,424318178
29380330_1639110,CM021101.1,2,29380330,460544382,2498412,1639110,462183492,424361396
29380330_1639276,CM021101.1,2,29380330,460544382,2498412,1639276,462183658,424361562
29378445_1704519,CM021101.1,2,29378445,460547592,2054957,1704519,462252111,424430015
29378445_1704540,CM021101.1,2,29378445,460547592,2054957,1704540,462252132,424430036
29378445_1705402,CM021101.1,2,29378445,460547592,2054957,1705402,462252994,424430898
29378445_1705520,CM021101.1,2,29378445,460547592,2054957,1705520,462253112,424431016
29378445_1716347,CM021101.1,2,29378445,460547592,2054957,1716347,462263939,424441843
29378445_1718098,CM021101.1,2,29378445,460547592,2054957,1718098,462265690,424443594
29379572_1724594,CM021101.1,2,29379572,460544382,2385510,1724594,462268976,424446880
29379572_1724647,CM021101.1,2,29379572,460544382,2385510,1724647,462269029,424446933
29379572_1724707,CM021101.1,2,29379572,460544382,2385510,1724707,462269089,424446993
29378445_1808449,CM021101.1,2,29378445,460547592,2054957,1808449,462356041,424533945
29378445_1808550,CM021101.1,2,29378445,460547592,2054957,1808550,462356142,424534046
29378445_1808554,CM021101.1,2,29378445,460547592,2054957,1808554,462356146,424534050
29378445_1808555,CM021101.1,2,29378445,460547592,2054957,1808555,462356147,424534051
29378445_1808580,CM021101.1,2,29378445,460547592,2054957,1808580,462356172,424534076
29380330_1834061,CM021101.1,2,29380330,460544382,2498412,1834061,462378443,424556347
29379572_1887718,CM021101.1,2,29379572,460544382,2385510,1887718,462432100,424610004
29379572_1887764,CM021101.1,2,29379572,460544382,2385510,1887764,462432146,424610050
29379572_1887795,CM021101.1,2,29379572,460544382,2385510,1887795,462432177,424610081
29379572_1887825,CM021101.1,2,29379572,460544382,2385510,1887825,462432207,424610111
29379572_1887844,CM021101.1,2,29379572,460544382,2385510,1887844,462432226,424610130
29379572_1887847,CM021101.1,2,29379572,460544382,2385510,1887847,462432229,424610133
29379572_1887868,CM021101.1,2,29379572,460544382,2385510,1887868,462432250,424610154
29379572_1887887,CM021101.1,2,29379572,460544382,2385510,1887887,462432269,424610173
29378445_1899431,CM021101.1,2,29378445,460547592,2054957,1899431,462447023,424624927
29378445_1899506,CM021101.1,2,29378445,460547592,2054957,1899506,462447098,424625002
29378445_1955544,CM021101.1,2,29378445,460547592,2054957,1955544,462503136,424681040
29378445_1955581,CM021101.1,2,29378445,460547592,2054957,1955581,462503173,424681077
29378445_1955620,CM021101.1,2,29378445,460547592,2054957,1955620,462503212,424681116
29377719_1971417,CM021101.1,2,29377719,460544382,3935609,1971417,462515799,424693703
29379402_1989984,CM021101.1,2,29379402,460544382,3212405,1989984,462534366,424712270
29379402_1990032,CM021101.1,2,29379402,460544382,3212405,1990032,462534414,424712318
29379402_1990071,CM021101.1,2,29379402,460544382,3212405,1990071,462534453,424712357
29379402_1990329,CM021101.1,2,29379402,460544382,3212405,1990329,462534711,424712615
29379402_1991269,CM021101.1,2,29379402,460544382,3212405,1991269,462535651,424713555
29377719_2074570,CM021101.1,2,29377719,460544382,3935609,2074570,462618952,424796856
29379188_2191438,CM021101.1,2,29379188,460544375,2699744,2191438,462735813,424913717
29379188_2191603,CM021101.1,2,29379188,460544375,2699744,2191603,462735978,424913882
29379188_2233377,CM021101.1,2,29379188,460544375,2699744,2233377,462777752,424955656
29379188_2233736,CM021101.1,2,29379188,460544375,2699744,2233736,462778111,424956015
29379188_2233737,CM021101.1,2,29379188,460544375,2699744,2233737,462778112,424956016
29381970_2294914,CM021101.1,2,29381970,460544381,2815733,2294914,462839295,425017199
29381970_2295817,CM021101.1,2,29381970,460544381,2815733,2295817,462840198,425018102
29381970_2295826,CM021101.1,2,29381970,460544381,2815733,2295826,462840207,425018111
29379402_2307360,CM021101.1,2,29379402,460544382,3212405,2307360,462851742,425029646
29379402_2409134,CM021101.1,2,29379402,460544382,3212405,2409134,462953516,425131420
29379402_2418343,CM021101.1,2,29379402,460544382,3212405,2418343,462962725,425140629
29377299_2450195,CM021101.1,2,29377299,460544382,3814112,2450195,462994577,425172481
29377299_2450201,CM021101.1,2,29377299,460544382,3814112,2450201,462994583,425172487
29377685_2450810,CM021101.1,2,29377685,460544382,2464179,2450810,462995192,425173096
29377685_2450865,CM021101.1,2,29377685,460544382,2464179,2450865,462995247,425173151
29377685_2450874,CM021101.1,2,29377685,460544382,2464179,2450874,462995256,425173160
29380358_2565599,CM021101.1,2,29380358,460544382,3440958,2565599,463109981,425287885
29380358_2565723,CM021101.1,2,29380358,460544382,3440958,2565723,463110105,425288009
29377719_2582284,CM021101.1,2,29377719,460544382,3935609,2582284,463126666,425304570
29377719_2582310,CM021101.1,2,29377719,460544382,3935609,2582310,463126692,425304596
29381970_2586011,CM021101.1,2,29381970,460544381,2815733,2586011,463130392,425308296
29381970_2586137,CM021101.1,2,29381970,460544381,2815733,2586137,463130518,425308422
29380358_2593555,CM021101.1,2,29380358,460544382,3440958,2593555,463137937,425315841
29381970_2621096,CM021101.1,2,29381970,460544381,2815733,2621096,463165477,425343381
29381970_2621161,CM021101.1,2,29381970,460544381,2815733,2621161,463165542,425343446
29381311_2643820,CM021101.1,2,29381311,460544381,5923666,2643820,463188201,425366105
29381311_2643881,CM021101.1,2,29381311,460544381,5923666,2643881,463188262,425366166
29381311_2643915,CM021101.1,2,29381311,460544381,5923666,2643915,463188296,425366200
29381311_2643994,CM021101.1,2,29381311,460544381,5923666,2643994,463188375,425366279
29380358_2720851,CM021101.1,2,29380358,460544382,3440958,2720851,463265233,425443137
29379246_2815196,CM021101.1,2,29379246,460544380,2884779,2815196,463359576,425537480
29379246_2815248,CM021101.1,2,29379246,460544380,2884779,2815248,463359628,425537532
29377719_2877680,CM021101.1,2,29377719,460544382,3935609,2877680,463422062,425599966
29377719_2877681,CM021101.1,2,29377719,460544382,3935609,2877681,463422063,425599967
29377719_2877727,CM021101.1,2,29377719,460544382,3935609,2877727,463422109,425600013
29377719_2877728,CM021101.1,2,29377719,460544382,3935609,2877728,463422110,425600014
29377719_2877744,CM021101.1,2,29377719,460544382,3935609,2877744,463422126,425600030
29377299_2975237,CM021101.1,2,29377299,460544382,3814112,2975237,463519619,425697523
29377299_2975347,CM021101.1,2,29377299,460544382,3814112,2975347,463519729,425697633
29377299_2975520,CM021101.1,2,29377299,460544382,3814112,2975520,463519902,425697806
29377299_3012934,CM021101.1,2,29377299,460544382,3814112,3012934,463557316,425735220
29377299_3014190,CM021101.1,2,29377299,460544382,3814112,3014190,463558572,425736476
29377299_3214606,CM021101.1,2,29377299,460544382,3814112,3214606,463758988,425936892
29377299_3214615,CM021101.1,2,29377299,460544382,3814112,3214615,463758997,425936901
29381311_3892358,CM021101.1,2,29381311,460544381,5923666,3892358,464436739,426614643
29381311_4457287,CM021101.1,2,29381311,460544381,5923666,4457287,465001668,427179572
29381311_4457328,CM021101.1,2,29381311,460544381,5923666,4457328,465001709,427179613
29381311_4461247,CM021101.1,2,29381311,460544381,5923666,4461247,465005628,427183532
29381122_68977,CM021101.1,2,29381122,469314381,182877,68977,469383358,431561262
29381122_69256,CM021101.1,2,29381122,469314381,182877,69256,469383637,431561541
29381122_70028,CM021101.1,2,29381122,469314381,182877,70028,469384409,431562313
29381122_70050,CM021101.1,2,29381122,469314381,182877,70050,469384431,431562335
29381122_70099,CM021101.1,2,29381122,469314381,182877,70099,469384480,431562384
29381122_70512,CM021101.1,2,29381122,469314381,182877,70512,469384893,431562797
29381122_75110,CM021101.1,2,29381122,469314381,182877,75110,469389491,431567395
29381049_2557,CM021101.1,2,29381049,471259540,1712460,2557,471262097,433440001
29379082_10230,CM021101.1,2,29379082,471259539,1401845,10230,471269769,433447673
29379082_10335,CM021101.1,2,29379082,471259539,1401845,10335,471269874,433447778
29381960_15053,CM021101.1,2,29381960,471259538,4013782,15053,471274591,433452495
29381960_15058,CM021101.1,2,29381960,471259538,4013782,15058,471274596,433452500
29381960_15109,CM021101.1,2,29381960,471259538,4013782,15109,471274647,433452551
29379136_23875,CM021101.1,2,29379136,471259540,1073763,23875,471283415,433461319
29379136_23903,CM021101.1,2,29379136,471259540,1073763,23903,471283443,433461347
29379845_21544,CM021101.1,2,29379845,471264523,9783444,21544,471286067,433463971
29379845_21621,CM021101.1,2,29379845,471264523,9783444,21621,471286144,433464048
29377863_23863,CM021101.1,2,29377863,471265836,802136,23863,471289699,433467603
29377863_26487,CM021101.1,2,29377863,471265836,802136,26487,471292323,433470227
29381752_44419,CM021101.1,2,29381752,471259538,1051674,44419,471303957,433481861
29381752_44449,CM021101.1,2,29381752,471259538,1051674,44449,471303987,433481891
29381752_44663,CM021101.1,2,29381752,471259538,1051674,44663,471304201,433482105
29381752_47211,CM021101.1,2,29381752,471259538,1051674,47211,471306749,433484653
29381752_47399,CM021101.1,2,29381752,471259538,1051674,47399,471306937,433484841
29381752_47493,CM021101.1,2,29381752,471259538,1051674,47493,471307031,433484935
29381752_50465,CM021101.1,2,29381752,471259538,1051674,50465,471310003,433487907
29381752_50492,CM021101.1,2,29381752,471259538,1051674,50492,471310030,433487934
29380842_44303,CM021101.1,2,29380842,471269062,588070,44303,471313365,433491269
29380842_44344,CM021101.1,2,29380842,471269062,588070,44344,471313406,433491310
29382266_57894,CM021101.1,2,29382266,471259539,908893,57894,471317433,433495337
29377572_51655,CM021101.1,2,29377572,471265877,1497010,51655,471317532,433495436
29381693_71676,CM021101.1,2,29381693,471259539,2647394,71676,471331215,433509119
29381693_71724,CM021101.1,2,29381693,471259539,2647394,71724,471331263,433509167
29379314_77823,CM021101.1,2,29379314,471265116,2849305,77823,471342939,433520843
29381163_117226,CM021101.1,2,29381163,471259538,2322522,117226,471376764,433554668
29379845_124944,CM021101.1,2,29379845,471264523,9783444,124944,471389467,433567371
29378487_167982,CM021101.1,2,29378487,471259525,1877815,167982,471427507,433605411
29381152_199745,CM021101.1,2,29381152,471259534,3223383,199745,471459279,433637183
29381152_199859,CM021101.1,2,29381152,471259534,3223383,199859,471459393,433637297
29381152_199958,CM021101.1,2,29381152,471259534,3223383,199958,471459492,433637396
29381152_199968,CM021101.1,2,29381152,471259534,3223383,199968,471459502,433637406
29381152_199980,CM021101.1,2,29381152,471259534,3223383,199980,471459514,433637418
29381693_205994,CM021101.1,2,29381693,471259539,2647394,205994,471465533,433643437
29381693_206013,CM021101.1,2,29381693,471259539,2647394,206013,471465552,433643456
29381693_206197,CM021101.1,2,29381693,471259539,2647394,206197,471465736,433643640
29381693_206220,CM021101.1,2,29381693,471259539,2647394,206220,471465759,433643663
29381693_206289,CM021101.1,2,29381693,471259539,2647394,206289,471465828,433643732
29379782_206629,CM021101.1,2,29379782,471261168,3013445,206629,471467797,433645701
29379782_206704,CM021101.1,2,29379782,471261168,3013445,206704,471467872,433645776
29379782_206924,CM021101.1,2,29379782,471261168,3013445,206924,471468092,433645996
29379782_206944,CM021101.1,2,29379782,471261168,3013445,206944,471468112,433646016
29380072_211361,CM021101.1,2,29380072,471259540,572619,211361,471470901,433648805
29380072_211375,CM021101.1,2,29380072,471259540,572619,211375,471470915,433648819
29380072_211386,CM021101.1,2,29380072,471259540,572619,211386,471470926,433648830
29380072_211401,CM021101.1,2,29380072,471259540,572619,211401,471470941,433648845
29379034_220925,CM021101.1,2,29379034,471259540,1841595,220925,471480465,433658369
29381191_255490,CM021101.1,2,29381191,471259534,1991135,255490,471515024,433692928
29381191_255497,CM021101.1,2,29381191,471259534,1991135,255497,471515031,433692935
29381191_255504,CM021101.1,2,29381191,471259534,1991135,255504,471515038,433692942
29381191_255547,CM021101.1,2,29381191,471259534,1991135,255547,471515081,433692985
29381191_255556,CM021101.1,2,29381191,471259534,1991135,255556,471515090,433692994
29381191_255564,CM021101.1,2,29381191,471259534,1991135,255564,471515098,433693002
29381191_255600,CM021101.1,2,29381191,471259534,1991135,255600,471515134,433693038
29381191_255746,CM021101.1,2,29381191,471259534,1991135,255746,471515280,433693184
29381191_255774,CM021101.1,2,29381191,471259534,1991135,255774,471515308,433693212
29381191_255787,CM021101.1,2,29381191,471259534,1991135,255787,471515321,433693225
29378717_262232,CM021101.1,2,29378717,471259539,1790392,262232,471521771,433699675
29378717_262501,CM021101.1,2,29378717,471259539,1790392,262501,471522040,433699944
29378789_264346,CM021101.1,2,29378789,471259539,1381581,264346,471523885,433701789
29378789_264357,CM021101.1,2,29378789,471259539,1381581,264357,471523896,433701800
29379782_267655,CM021101.1,2,29379782,471261168,3013445,267655,471528823,433706727
29379782_267666,CM021101.1,2,29379782,471261168,3013445,267666,471528834,433706738
29379782_267676,CM021101.1,2,29379782,471261168,3013445,267676,471528844,433706748
29379782_267686,CM021101.1,2,29379782,471261168,3013445,267686,471528854,433706758
29379782_267933,CM021101.1,2,29379782,471261168,3013445,267933,471529101,433707005
29379782_267945,CM021101.1,2,29379782,471261168,3013445,267945,471529113,433707017
29382378_299468,CM021101.1,2,29382378,471265991,2792566,299468,471565459,433743363
29378789_316009,CM021101.1,2,29378789,471259539,1381581,316009,471575548,433753452
29377484_329723,CM021101.1,2,29377484,471259538,2340375,329723,471589261,433767165
29377484_356603,CM021101.1,2,29377484,471259538,2340375,356603,471616141,433794045
29377484_356677,CM021101.1,2,29377484,471259538,2340375,356677,471616215,433794119
29377484_358172,CM021101.1,2,29377484,471259538,2340375,358172,471617710,433795614
29377484_359835,CM021101.1,2,29377484,471259538,2340375,359835,471619373,433797277
29382385_372997,CM021101.1,2,29382385,471265483,2253252,372997,471638480,433816384
29381163_405573,CM021101.1,2,29381163,471259538,2322522,405573,471665111,433843015
29381163_405577,CM021101.1,2,29381163,471259538,2322522,405577,471665115,433843019
29379082_409092,CM021101.1,2,29379082,471259539,1401845,409092,471668631,433846535
29379082_409446,CM021101.1,2,29379082,471259539,1401845,409446,471668985,433846889
29351615_410962,CM021101.1,2,29351615,471259539,1226215,410962,471670501,433848405
29382385_405295,CM021101.1,2,29382385,471265483,2253252,405295,471670778,433848682
29380003_406609,CM021101.1,2,29380003,471265953,1262985,406609,471672562,433850466
29382378_426380,CM021101.1,2,29382378,471265991,2792566,426380,471692371,433870275
29382378_426408,CM021101.1,2,29382378,471265991,2792566,426408,471692399,433870303
29382378_426434,CM021101.1,2,29382378,471265991,2792566,426434,471692425,433870329
29382378_426448,CM021101.1,2,29382378,471265991,2792566,426448,471692439,433870343
29382378_426449,CM021101.1,2,29382378,471265991,2792566,426449,471692440,433870344
29382378_426478,CM021101.1,2,29382378,471265991,2792566,426478,471692469,433870373
29382378_426490,CM021101.1,2,29382378,471265991,2792566,426490,471692481,433870385
29382378_426493,CM021101.1,2,29382378,471265991,2792566,426493,471692484,433870388
29382378_426495,CM021101.1,2,29382378,471265991,2792566,426495,471692486,433870390
29382378_426501,CM021101.1,2,29382378,471265991,2792566,426501,471692492,433870396
29382378_426510,CM021101.1,2,29382378,471265991,2792566,426510,471692501,433870405
29382378_426518,CM021101.1,2,29382378,471265991,2792566,426518,471692509,433870413
29381152_485378,CM021101.1,2,29381152,471259534,3223383,485378,471744912,433922816
29381152_485462,CM021101.1,2,29381152,471259534,3223383,485462,471744996,433922900
29379082_531659,CM021101.1,2,29379082,471259539,1401845,531659,471791198,433969102
29379082_531712,CM021101.1,2,29379082,471259539,1401845,531712,471791251,433969155
29379082_531719,CM021101.1,2,29379082,471259539,1401845,531719,471791258,433969162
29379082_531721,CM021101.1,2,29379082,471259539,1401845,531721,471791260,433969164
29379082_531760,CM021101.1,2,29379082,471259539,1401845,531760,471791299,433969203
29382378_536441,CM021101.1,2,29382378,471265991,2792566,536441,471802432,433980336
29382378_536451,CM021101.1,2,29382378,471265991,2792566,536451,471802442,433980346
29382378_536489,CM021101.1,2,29382378,471265991,2792566,536489,471802480,433980384
29381049_628929,CM021101.1,2,29381049,471259540,1712460,628929,471888469,434066373
29379594_644420,CM021101.1,2,29379594,471259539,3412462,644420,471903959,434081863
29381152_659782,CM021101.1,2,29381152,471259534,3223383,659782,471919316,434097220
29381152_690001,CM021101.1,2,29381152,471259534,3223383,690001,471949535,434127439
29381152_690097,CM021101.1,2,29381152,471259534,3223383,690097,471949631,434127535
29381152_692299,CM021101.1,2,29381152,471259534,3223383,692299,471951833,434129737
29381049_744749,CM021101.1,2,29381049,471259540,1712460,744749,472004289,434182193
29381933_758800,CM021101.1,2,29381933,471259539,1249263,758800,472018339,434196243
29381933_767633,CM021101.1,2,29381933,471259539,1249263,767633,472027172,434205076
29379082_827778,CM021101.1,2,29379082,471259539,1401845,827778,472087317,434265221
29379082_827797,CM021101.1,2,29379082,471259539,1401845,827797,472087336,434265240
29379136_899412,CM021101.1,2,29379136,471259540,1073763,899412,472158952,434336856
29379136_899496,CM021101.1,2,29379136,471259540,1073763,899496,472159036,434336940
29381439_943064,CM021101.1,2,29381439,471259540,4680510,943064,472202604,434380508
29379314_959555,CM021101.1,2,29379314,471265116,2849305,959555,472224671,434402575
29379314_959597,CM021101.1,2,29379314,471265116,2849305,959597,472224713,434402617
29379314_959641,CM021101.1,2,29379314,471265116,2849305,959641,472224757,434402661
29381960_1025881,CM021101.1,2,29381960,471259538,4013782,1025881,472285419,434463323
29381152_1029675,CM021101.1,2,29381152,471259534,3223383,1029675,472289209,434467113
29380003_1044757,CM021101.1,2,29380003,471265953,1262985,1044757,472310710,434488614
29377572_1054856,CM021101.1,2,29377572,471265877,1497010,1054856,472320733,434498637
29377572_1054875,CM021101.1,2,29377572,471265877,1497010,1054875,472320752,434498656
29380003_1070634,CM021101.1,2,29380003,471265953,1262985,1070634,472336587,434514491
29380003_1090160,CM021101.1,2,29380003,471265953,1262985,1090160,472356113,434534017
29381693_1113461,CM021101.1,2,29381693,471259539,2647394,1113461,472373000,434550904
29381693_1113486,CM021101.1,2,29381693,471259539,2647394,1113486,472373025,434550929
29381693_1113892,CM021101.1,2,29381693,471259539,2647394,1113892,472373431,434551335
29381693_1113932,CM021101.1,2,29381693,471259539,2647394,1113932,472373471,434551375
29381693_1115691,CM021101.1,2,29381693,471259539,2647394,1115691,472375230,434553134
29381693_1115757,CM021101.1,2,29381693,471259539,2647394,1115757,472375296,434553200
29381693_1117460,CM021101.1,2,29381693,471259539,2647394,1117460,472376999,434554903
29381693_1117463,CM021101.1,2,29381693,471259539,2647394,1117463,472377002,434554906
29381693_1117605,CM021101.1,2,29381693,471259539,2647394,1117605,472377144,434555048
29381693_1117615,CM021101.1,2,29381693,471259539,2647394,1117615,472377154,434555058
29381555_1119145,CM021101.1,2,29381555,471259540,4124790,1119145,472378685,434556589
29381933_1136344,CM021101.1,2,29381933,471259539,1249263,1136344,472395883,434573787
29381933_1159857,CM021101.1,2,29381933,471259539,1249263,1159857,472419396,434597300
29381152_1168034,CM021101.1,2,29381152,471259534,3223383,1168034,472427568,434605472
29381152_1168885,CM021101.1,2,29381152,471259534,3223383,1168885,472428419,434606323
29378717_1193333,CM021101.1,2,29378717,471259539,1790392,1193333,472452872,434630776
29381933_1195567,CM021101.1,2,29381933,471259539,1249263,1195567,472455106,434633010
29381933_1195591,CM021101.1,2,29381933,471259539,1249263,1195591,472455130,434633034
29381933_1196230,CM021101.1,2,29381933,471259539,1249263,1196230,472455769,434633673
29381933_1196291,CM021101.1,2,29381933,471259539,1249263,1196291,472455830,434633734
29379962_1207637,CM021101.1,2,29379962,471259513,2955541,1207637,472467150,434645054
29378717_1232442,CM021101.1,2,29378717,471259539,1790392,1232442,472491981,434669885
29382378_1234251,CM021101.1,2,29382378,471265991,2792566,1234251,472500242,434678146
29379782_1255347,CM021101.1,2,29379782,471261168,3013445,1255347,472516515,434694419
29379782_1255414,CM021101.1,2,29379782,471261168,3013445,1255414,472516582,434694486
29379782_1269290,CM021101.1,2,29379782,471261168,3013445,1269290,472530458,434708362
29379782_1269876,CM021101.1,2,29379782,471261168,3013445,1269876,472531044,434708948
29381049_1290294,CM021101.1,2,29381049,471259540,1712460,1290294,472549834,434727738
29381049_1290346,CM021101.1,2,29381049,471259540,1712460,1290346,472549886,434727790
29381152_1294832,CM021101.1,2,29381152,471259534,3223383,1294832,472554366,434732270
29381152_1294900,CM021101.1,2,29381152,471259534,3223383,1294900,472554434,434732338
29381152_1294940,CM021101.1,2,29381152,471259534,3223383,1294940,472554474,434732378
29381152_1294972,CM021101.1,2,29381152,471259534,3223383,1294972,472554506,434732410
29377484_1304690,CM021101.1,2,29377484,471259538,2340375,1304690,472564228,434742132
29377484_1304721,CM021101.1,2,29377484,471259538,2340375,1304721,472564259,434742163
29378717_1337796,CM021101.1,2,29378717,471259539,1790392,1337796,472597335,434775239
29378717_1361607,CM021101.1,2,29378717,471259539,1790392,1361607,472621146,434799050
29378717_1362873,CM021101.1,2,29378717,471259539,1790392,1362873,472622412,434800316
29378717_1362883,CM021101.1,2,29378717,471259539,1790392,1362883,472622422,434800326
29378717_1362926,CM021101.1,2,29378717,471259539,1790392,1362926,472622465,434800369
29378717_1362996,CM021101.1,2,29378717,471259539,1790392,1362996,472622535,434800439
29377572_1357732,CM021101.1,2,29377572,471265877,1497010,1357732,472623609,434801513
29379845_1365722,CM021101.1,2,29379845,471264523,9783444,1365722,472630245,434808149
29379845_1374161,CM021101.1,2,29379845,471264523,9783444,1374161,472638684,434816588
29381460_1391038,CM021101.1,2,29381460,471259540,3957517,1391038,472650578,434828482
29378161_1413119,CM021101.1,2,29378161,471259540,3108621,1413119,472672659,434850563
29378161_1413640,CM021101.1,2,29378161,471259540,3108621,1413640,472673180,434851084
29378161_1413662,CM021101.1,2,29378161,471259540,3108621,1413662,472673202,434851106
29378161_1413771,CM021101.1,2,29378161,471259540,3108621,1413771,472673311,434851215
29378161_1413773,CM021101.1,2,29378161,471259540,3108621,1413773,472673313,434851217
29378161_1413774,CM021101.1,2,29378161,471259540,3108621,1413774,472673314,434851218
29378161_1413819,CM021101.1,2,29378161,471259540,3108621,1413819,472673359,434851263
29378161_1413855,CM021101.1,2,29378161,471259540,3108621,1413855,472673395,434851299
29379845_1477458,CM021101.1,2,29379845,471264523,9783444,1477458,472741981,434919885
29382378_1490509,CM021101.1,2,29382378,471265991,2792566,1490509,472756500,434934404
29379782_1550584,CM021101.1,2,29379782,471261168,3013445,1550584,472811752,434989656
29379782_1550593,CM021101.1,2,29379782,471261168,3013445,1550593,472811761,434989665
29379782_1550604,CM021101.1,2,29379782,471261168,3013445,1550604,472811772,434989676
29381439_1572427,CM021101.1,2,29381439,471259540,4680510,1572427,472831967,435009871
29381439_1572461,CM021101.1,2,29381439,471259540,4680510,1572461,472832001,435009905
29381152_1574938,CM021101.1,2,29381152,471259534,3223383,1574938,472834472,435012376
29381152_1575007,CM021101.1,2,29381152,471259534,3223383,1575007,472834541,435012445
29381152_1614550,CM021101.1,2,29381152,471259534,3223383,1614550,472874084,435051988
29381152_1617321,CM021101.1,2,29381152,471259534,3223383,1617321,472876855,435054759
29381152_1617438,CM021101.1,2,29381152,471259534,3223383,1617438,472876972,435054876
29381152_1617464,CM021101.1,2,29381152,471259534,3223383,1617464,472876998,435054902
29378721_1618858,CM021101.1,2,29378721,471259539,3502721,1618858,472878397,435056301
29381163_1627123,CM021101.1,2,29381163,471259538,2322522,1627123,472886661,435064565
29381163_1627146,CM021101.1,2,29381163,471259538,2322522,1627146,472886684,435064588
29381163_1627197,CM021101.1,2,29381163,471259538,2322522,1627197,472886735,435064639
29381163_1627310,CM021101.1,2,29381163,471259538,2322522,1627310,472886848,435064752
29381163_1627335,CM021101.1,2,29381163,471259538,2322522,1627335,472886873,435064777
29381152_1661231,CM021101.1,2,29381152,471259534,3223383,1661231,472920765,435098669
29381152_1661539,CM021101.1,2,29381152,471259534,3223383,1661539,472921073,435098977
29381776_1677057,CM021101.1,2,29381776,471259534,6270018,1677057,472936591,435114495
29381776_1677063,CM021101.1,2,29381776,471259534,6270018,1677063,472936597,435114501
29381776_1677143,CM021101.1,2,29381776,471259534,6270018,1677143,472936677,435114581
29381776_1677810,CM021101.1,2,29381776,471259534,6270018,1677810,472937344,435115248
29381776_1677863,CM021101.1,2,29381776,471259534,6270018,1677863,472937397,435115301
29381776_1681313,CM021101.1,2,29381776,471259534,6270018,1681313,472940847,435118751
29381776_1681389,CM021101.1,2,29381776,471259534,6270018,1681389,472940923,435118827
29379962_1722955,CM021101.1,2,29379962,471259513,2955541,1722955,472982468,435160372
29379962_1722963,CM021101.1,2,29379962,471259513,2955541,1722963,472982476,435160380
29379962_1724133,CM021101.1,2,29379962,471259513,2955541,1724133,472983646,435161550
29379962_1724196,CM021101.1,2,29379962,471259513,2955541,1724196,472983709,435161613
29378161_1751405,CM021101.1,2,29378161,471259540,3108621,1751405,473010945,435188849
29378161_1751410,CM021101.1,2,29378161,471259540,3108621,1751410,473010950,435188854
29378161_1751506,CM021101.1,2,29378161,471259540,3108621,1751506,473011046,435188950
29379782_1769560,CM021101.1,2,29379782,471261168,3013445,1769560,473030728,435208632
29379782_1769601,CM021101.1,2,29379782,471261168,3013445,1769601,473030769,435208673
29379782_1770759,CM021101.1,2,29379782,471261168,3013445,1770759,473031927,435209831
29379314_1780076,CM021101.1,2,29379314,471265116,2849305,1780076,473045192,435223096
29379314_1781068,CM021101.1,2,29379314,471265116,2849305,1781068,473046184,435224088
29379782_1808388,CM021101.1,2,29379782,471261168,3013445,1808388,473069556,435247460
29379782_1808393,CM021101.1,2,29379782,471261168,3013445,1808393,473069561,435247465
29379782_1817966,CM021101.1,2,29379782,471261168,3013445,1817966,473079134,435257038
29379782_1818205,CM021101.1,2,29379782,471261168,3013445,1818205,473079373,435257277
29377673_1816805,CM021101.1,2,29377673,471265958,2936057,1816805,473082763,435260667
29377673_1816829,CM021101.1,2,29377673,471265958,2936057,1816829,473082787,435260691
29377673_1816878,CM021101.1,2,29377673,471265958,2936057,1816878,473082836,435260740
29378721_1837105,CM021101.1,2,29378721,471259539,3502721,1837105,473096644,435274548
29378487_1874942,CM021101.1,2,29378487,471259525,1877815,1874942,473134467,435312371
29378487_1874963,CM021101.1,2,29378487,471259525,1877815,1874963,473134488,435312392
29381152_1897068,CM021101.1,2,29381152,471259534,3223383,1897068,473156602,435334506
29381152_1898861,CM021101.1,2,29381152,471259534,3223383,1898861,473158395,435336299
29380941_1931992,CM021101.1,2,29380941,471266514,3854389,1931992,473198506,435376410
29380941_1932009,CM021101.1,2,29380941,471266514,3854389,1932009,473198523,435376427
29380941_1932029,CM021101.1,2,29380941,471266514,3854389,1932029,473198543,435376447
29377673_1971095,CM021101.1,2,29377673,471265958,2936057,1971095,473237053,435414957
29377673_1971149,CM021101.1,2,29377673,471265958,2936057,1971149,473237107,435415011
29377673_1971786,CM021101.1,2,29377673,471265958,2936057,1971786,473237744,435415648
29377673_1971787,CM021101.1,2,29377673,471265958,2936057,1971787,473237745,435415649
29381693_1986890,CM021101.1,2,29381693,471259539,2647394,1986890,473246429,435424333
29379782_1999891,CM021101.1,2,29379782,471261168,3013445,1999891,473261059,435438963
29379782_2000062,CM021101.1,2,29379782,471261168,3013445,2000062,473261230,435439134
29381919_2005699,CM021101.1,2,29381919,471259539,3684735,2005699,473265238,435443142
29381919_2005707,CM021101.1,2,29381919,471259539,3684735,2005707,473265246,435443150
29381919_2005774,CM021101.1,2,29381919,471259539,3684735,2005774,473265313,435443217
29381919_2005785,CM021101.1,2,29381919,471259539,3684735,2005785,473265324,435443228
29381439_2027427,CM021101.1,2,29381439,471259540,4680510,2027427,473286967,435464871
29377673_2070264,CM021101.1,2,29377673,471265958,2936057,2070264,473336222,435514126
29379966_2094118,CM021101.1,2,29379966,471259540,2246718,2094118,473353658,435531562
29379966_2094204,CM021101.1,2,29379966,471259540,2246718,2094204,473353744,435531648
29379966_2094245,CM021101.1,2,29379966,471259540,2246718,2094245,473353785,435531689
29379966_2094264,CM021101.1,2,29379966,471259540,2246718,2094264,473353804,435531708
29379966_2106137,CM021101.1,2,29379966,471259540,2246718,2106137,473365677,435543581
29379966_2106197,CM021101.1,2,29379966,471259540,2246718,2106197,473365737,435543641
29379966_2107206,CM021101.1,2,29379966,471259540,2246718,2107206,473366746,435544650
29379966_2107230,CM021101.1,2,29379966,471259540,2246718,2107230,473366770,435544674
29379966_2107259,CM021101.1,2,29379966,471259540,2246718,2107259,473366799,435544703
29379966_2107261,CM021101.1,2,29379966,471259540,2246718,2107261,473366801,435544705
29379966_2107279,CM021101.1,2,29379966,471259540,2246718,2107279,473366819,435544723
29381368_2174930,CM021101.1,2,29381368,471259538,2240013,2174930,473434468,435612372
29377484_2196052,CM021101.1,2,29377484,471259538,2340375,2196052,473455590,435633494
29377484_2196073,CM021101.1,2,29377484,471259538,2340375,2196073,473455611,435633515
29377484_2196196,CM021101.1,2,29377484,471259538,2340375,2196196,473455734,435633638
29377484_2196483,CM021101.1,2,29377484,471259538,2340375,2196483,473456021,435633925
29379913_2264757,CM021101.1,2,29379913,471259539,3526174,2264757,473524296,435702200
29379314_2362622,CM021101.1,2,29379314,471265116,2849305,2362622,473627738,435805642
29379314_2362657,CM021101.1,2,29379314,471265116,2849305,2362657,473627773,435805677
29379314_2362660,CM021101.1,2,29379314,471265116,2849305,2362660,473627776,435805680
29379314_2362686,CM021101.1,2,29379314,471265116,2849305,2362686,473627802,435805706
29379314_2362693,CM021101.1,2,29379314,471265116,2849305,2362693,473627809,435805713
29379314_2362696,CM021101.1,2,29379314,471265116,2849305,2362696,473627812,435805716
29379314_2362828,CM021101.1,2,29379314,471265116,2849305,2362828,473627944,435805848
29379314_2362844,CM021101.1,2,29379314,471265116,2849305,2362844,473627960,435805864
29379314_2362884,CM021101.1,2,29379314,471265116,2849305,2362884,473628000,435805904
29379314_2370920,CM021101.1,2,29379314,471265116,2849305,2370920,473636036,435813940
29379314_2370979,CM021101.1,2,29379314,471265116,2849305,2370979,473636095,435813999
29379314_2371008,CM021101.1,2,29379314,471265116,2849305,2371008,473636124,435814028
29382378_2418517,CM021101.1,2,29382378,471265991,2792566,2418517,473684508,435862412
29379845_2433102,CM021101.1,2,29379845,471264523,9783444,2433102,473697625,435875529
29379845_2433148,CM021101.1,2,29379845,471264523,9783444,2433148,473697671,435875575
29379845_2433153,CM021101.1,2,29379845,471264523,9783444,2433153,473697676,435875580
29382378_2447113,CM021101.1,2,29382378,471265991,2792566,2447113,473713104,435891008
29378161_2531945,CM021101.1,2,29378161,471259540,3108621,2531945,473791485,435969389
29382378_2541798,CM021101.1,2,29382378,471265991,2792566,2541798,473807789,435985693
29377358_2653920,CM021101.1,2,29377358,471265534,4237943,2653920,473919454,436097358
29379314_2719792,CM021101.1,2,29379314,471265116,2849305,2719792,473984908,436162812
29381439_2726581,CM021101.1,2,29381439,471259540,4680510,2726581,473986121,436164025
29379314_2732736,CM021101.1,2,29379314,471265116,2849305,2732736,473997852,436175756
29379314_2732741,CM021101.1,2,29379314,471265116,2849305,2732741,473997857,436175761
29381919_2761948,CM021101.1,2,29381919,471259539,3684735,2761948,474021487,436199391
29381919_2762017,CM021101.1,2,29381919,471259539,3684735,2762017,474021556,436199460
29381919_2762142,CM021101.1,2,29381919,471259539,3684735,2762142,474021681,436199585
29379314_2763441,CM021101.1,2,29379314,471265116,2849305,2763441,474028557,436206461
29379314_2763514,CM021101.1,2,29379314,471265116,2849305,2763514,474028630,436206534
29381919_2837767,CM021101.1,2,29381919,471259539,3684735,2837767,474097306,436275210
29379913_2892251,CM021101.1,2,29379913,471259539,3526174,2892251,474151790,436329694
29381152_2910492,CM021101.1,2,29381152,471259534,3223383,2910492,474170026,436347930
29381152_2910511,CM021101.1,2,29381152,471259534,3223383,2910511,474170045,436347949
29381152_2910515,CM021101.1,2,29381152,471259534,3223383,2910515,474170049,436347953
29381152_2910600,CM021101.1,2,29381152,471259534,3223383,2910600,474170134,436348038
29379913_2910858,CM021101.1,2,29379913,471259539,3526174,2910858,474170397,436348301
29381919_2916550,CM021101.1,2,29381919,471259539,3684735,2916550,474176089,436353993
29381919_2916614,CM021101.1,2,29381919,471259539,3684735,2916614,474176153,436354057
29381919_2916634,CM021101.1,2,29381919,471259539,3684735,2916634,474176173,436354077
29381919_2917324,CM021101.1,2,29381919,471259539,3684735,2917324,474176863,436354767
29381960_2966551,CM021101.1,2,29381960,471259538,4013782,2966551,474226089,436403993
29378161_2967994,CM021101.1,2,29378161,471259540,3108621,2967994,474227534,436405438
29378161_2968046,CM021101.1,2,29378161,471259540,3108621,2968046,474227586,436405490
29378161_2994570,CM021101.1,2,29378161,471259540,3108621,2994570,474254110,436432014
29378161_2994585,CM021101.1,2,29378161,471259540,3108621,2994585,474254125,436432029
29378161_2994633,CM021101.1,2,29378161,471259540,3108621,2994633,474254173,436432077
29378161_2994659,CM021101.1,2,29378161,471259540,3108621,2994659,474254199,436432103
29378161_2994663,CM021101.1,2,29378161,471259540,3108621,2994663,474254203,436432107
29378161_2994666,CM021101.1,2,29378161,471259540,3108621,2994666,474254206,436432110
29378161_2994698,CM021101.1,2,29378161,471259540,3108621,2994698,474254238,436432142
29378161_2994701,CM021101.1,2,29378161,471259540,3108621,2994701,474254241,436432145
29378161_2994718,CM021101.1,2,29378161,471259540,3108621,2994718,474254258,436432162
29378161_2994720,CM021101.1,2,29378161,471259540,3108621,2994720,474254260,436432164
29381919_2999348,CM021101.1,2,29381919,471259539,3684735,2999348,474258887,436436791
29381919_2999366,CM021101.1,2,29381919,471259539,3684735,2999366,474258905,436436809
29381919_2999576,CM021101.1,2,29381919,471259539,3684735,2999576,474259115,436437019
29381919_2999619,CM021101.1,2,29381919,471259539,3684735,2999619,474259158,436437062
29381776_3024593,CM021101.1,2,29381776,471259534,6270018,3024593,474284127,436462031
29381776_3024604,CM021101.1,2,29381776,471259534,6270018,3024604,474284138,436462042
29381776_3024668,CM021101.1,2,29381776,471259534,6270018,3024668,474284202,436462106
29381776_3026099,CM021101.1,2,29381776,471259534,6270018,3026099,474285633,436463537
29381960_3026781,CM021101.1,2,29381960,471259538,4013782,3026781,474286319,436464223
29377358_3062194,CM021101.1,2,29377358,471265534,4237943,3062194,474327728,436505632
29381460_3169618,CM021101.1,2,29381460,471259540,3957517,3169618,474429158,436607062
29380941_3357323,CM021101.1,2,29380941,471266514,3854389,3357323,474623837,436801741
29380941_3357324,CM021101.1,2,29380941,471266514,3854389,3357324,474623838,436801742
29380941_3357347,CM021101.1,2,29380941,471266514,3854389,3357347,474623861,436801765
29380941_3357361,CM021101.1,2,29380941,471266514,3854389,3357361,474623875,436801779
29380941_3357378,CM021101.1,2,29380941,471266514,3854389,3357378,474623892,436801796
29380941_3357391,CM021101.1,2,29380941,471266514,3854389,3357391,474623905,436801809
29380941_3357413,CM021101.1,2,29380941,471266514,3854389,3357413,474623927,436801831
29380941_3357459,CM021101.1,2,29380941,471266514,3854389,3357459,474623973,436801877
29380941_3402751,CM021101.1,2,29380941,471266514,3854389,3402751,474669265,436847169
29380941_3402855,CM021101.1,2,29380941,471266514,3854389,3402855,474669369,436847273
29381776_3444075,CM021101.1,2,29381776,471259534,6270018,3444075,474703609,436881513
29377684_3448032,CM021101.1,2,29377684,471259538,5144748,3448032,474707570,436885474
29379845_3488470,CM021101.1,2,29379845,471264523,9783444,3488470,474752993,436930897
29377684_3672243,CM021101.1,2,29377684,471259538,5144748,3672243,474931781,437109685
29381776_3727137,CM021101.1,2,29381776,471259534,6270018,3727137,474986671,437164575
29381776_3727549,CM021101.1,2,29381776,471259534,6270018,3727549,474987083,437164987
29377358_3741491,CM021101.1,2,29377358,471265534,4237943,3741491,475007025,437184929
29381776_3755763,CM021101.1,2,29381776,471259534,6270018,3755763,475015297,437193201
29381776_3755775,CM021101.1,2,29381776,471259534,6270018,3755775,475015309,437193213
29381776_3755820,CM021101.1,2,29381776,471259534,6270018,3755820,475015354,437193258
29381776_4121038,CM021101.1,2,29381776,471259534,6270018,4121038,475380572,437558476
29377684_4261458,CM021101.1,2,29377684,471259538,5144748,4261458,475520996,437698900
29377684_4262410,CM021101.1,2,29377684,471259538,5144748,4262410,475521948,437699852
29381439_4416171,CM021101.1,2,29381439,471259540,4680510,4416171,475675711,437853615
29381439_4416440,CM021101.1,2,29381439,471259540,4680510,4416440,475675980,437853884
29377684_4766670,CM021101.1,2,29377684,471259538,5144748,4766670,476026208,438204112
29381776_5269073,CM021101.1,2,29381776,471259534,6270018,5269073,476528607,438706511
29381776_5269175,CM021101.1,2,29381776,471259534,6270018,5269175,476528709,438706613
29381776_5269186,CM021101.1,2,29381776,471259534,6270018,5269186,476528720,438706624
29381776_5269228,CM021101.1,2,29381776,471259534,6270018,5269228,476528762,438706666
29381776_5269249,CM021101.1,2,29381776,471259534,6270018,5269249,476528783,438706687
29381776_5269255,CM021101.1,2,29381776,471259534,6270018,5269255,476528789,438706693
29381776_5269286,CM021101.1,2,29381776,471259534,6270018,5269286,476528820,438706724
29381776_5269309,CM021101.1,2,29381776,471259534,6270018,5269309,476528843,438706747
29381776_5269327,CM021101.1,2,29381776,471259534,6270018,5269327,476528861,438706765
29381776_5269339,CM021101.1,2,29381776,471259534,6270018,5269339,476528873,438706777
29381776_5303181,CM021101.1,2,29381776,471259534,6270018,5303181,476562715,438740619
29381776_5324102,CM021101.1,2,29381776,471259534,6270018,5324102,476583636,438761540
29381776_5324150,CM021101.1,2,29381776,471259534,6270018,5324150,476583684,438761588
29381776_5672339,CM021101.1,2,29381776,471259534,6270018,5672339,476931873,439109777
29381776_6017368,CM021101.1,2,29381776,471259534,6270018,6017368,477276902,439454806
29381776_6018171,CM021101.1,2,29381776,471259534,6270018,6018171,477277705,439455609
29378548_183990,CM021101.1,2,29378548,478783460,383637,183990,478967450,441145354
29378548_184005,CM021101.1,2,29378548,478783460,383637,184005,478967465,441145369
29377479_404262,CM021101.1,2,29377479,478784513,553164,404262,479188775,441366679
29377479_404278,CM021101.1,2,29377479,478784513,553164,404278,479188791,441366695
29377479_404352,CM021101.1,2,29377479,478784513,553164,404352,479188865,441366769
29379408_443899,CM021101.1,2,29379408,478783460,1504288,443899,479227359,441405263
29253970_2056,CM021101.1,2,29253970,482202494,5041,2056,482204550,444382454
29253970_4080,CM021101.1,2,29253970,482202494,5041,4080,482206574,444384478
29346623_2002,CM021101.1,2,29346623,485060296,92338,2002,485062298,447240202
29380797_46265,CM021101.1,2,29380797,485231468,4736544,46265,485277733,447455637
29381366_130503,CM021101.1,2,29381366,485234593,2401689,130503,485365096,447543000
29381366_191267,CM021101.1,2,29381366,485234593,2401689,191267,485425860,447603764
29381366_191375,CM021101.1,2,29381366,485234593,2401689,191375,485425968,447603872
29381366_191385,CM021101.1,2,29381366,485234593,2401689,191385,485425978,447603882
29379850_222698,CM021101.1,2,29379850,485231468,3397320,222698,485454166,447632070
29377496_225714,CM021101.1,2,29377496,485231468,1778429,225714,485457182,447635086
29379850_226498,CM021101.1,2,29379850,485231468,3397320,226498,485457966,447635870
29379850_226539,CM021101.1,2,29379850,485231468,3397320,226539,485458007,447635911
29377496_233378,CM021101.1,2,29377496,485231468,1778429,233378,485464846,447642750
29379850_310799,CM021101.1,2,29379850,485231468,3397320,310799,485542267,447720171
29379850_314518,CM021101.1,2,29379850,485231468,3397320,314518,485545986,447723890
29379488_371800,CM021101.1,2,29379488,485233075,2371898,371800,485604875,447782779
29381875_567743,CM021101.1,2,29381875,485233811,1310087,567743,485801554,447979458
29381875_567746,CM021101.1,2,29381875,485233811,1310087,567746,485801557,447979461
29381875_567752,CM021101.1,2,29381875,485233811,1310087,567752,485801563,447979467
29381875_568292,CM021101.1,2,29381875,485233811,1310087,568292,485802103,447980007
29381875_568294,CM021101.1,2,29381875,485233811,1310087,568294,485802105,447980009
29381875_568337,CM021101.1,2,29381875,485233811,1310087,568337,485802148,447980052
29381875_568365,CM021101.1,2,29381875,485233811,1310087,568365,485802176,447980080
29381875_673716,CM021101.1,2,29381875,485233811,1310087,673716,485907527,448085431
29381875_899276,CM021101.1,2,29381875,485233811,1310087,899276,486133087,448310991
29381875_899280,CM021101.1,2,29381875,485233811,1310087,899280,486133091,448310995
29381875_899395,CM021101.1,2,29381875,485233811,1310087,899395,486133206,448311110
29377672_1132399,CM021101.1,2,29377672,485233802,2962506,1132399,486366201,448544105
29377672_1132436,CM021101.1,2,29377672,485233802,2962506,1132436,486366238,448544142
29377672_1132454,CM021101.1,2,29377672,485233802,2962506,1132454,486366256,448544160
29377496_1156801,CM021101.1,2,29377496,485231468,1778429,1156801,486388269,448566173
29377672_1177735,CM021101.1,2,29377672,485233802,2962506,1177735,486411537,448589441
29377672_1177761,CM021101.1,2,29377672,485233802,2962506,1177761,486411563,448589467
29377672_1177787,CM021101.1,2,29377672,485233802,2962506,1177787,486411589,448589493
29377672_1199250,CM021101.1,2,29377672,485233802,2962506,1199250,486433052,448610956
29377672_1230935,CM021101.1,2,29377672,485233802,2962506,1230935,486464737,448642641
29377672_1234483,CM021101.1,2,29377672,485233802,2962506,1234483,486468285,448646189
29379850_1294064,CM021101.1,2,29379850,485231468,3397320,1294064,486525532,448703436
29379850_1294076,CM021101.1,2,29379850,485231468,3397320,1294076,486525544,448703448
29379850_1295483,CM021101.1,2,29379850,485231468,3397320,1295483,486526951,448704855
29379850_1295747,CM021101.1,2,29379850,485231468,3397320,1295747,486527215,448705119
29377496_1316294,CM021101.1,2,29377496,485231468,1778429,1316294,486547762,448725666
29379850_1346218,CM021101.1,2,29379850,485231468,3397320,1346218,486577686,448755590
29379850_1361295,CM021101.1,2,29379850,485231468,3397320,1361295,486592763,448770667
29379850_1361351,CM021101.1,2,29379850,485231468,3397320,1361351,486592819,448770723
29379850_1361465,CM021101.1,2,29379850,485231468,3397320,1361465,486592933,448770837
29380797_1489659,CM021101.1,2,29380797,485231468,4736544,1489659,486721127,448899031
29377496_1524336,CM021101.1,2,29377496,485231468,1778429,1524336,486755804,448933708
29377496_1525973,CM021101.1,2,29377496,485231468,1778429,1525973,486757441,448935345
29377496_1525984,CM021101.1,2,29377496,485231468,1778429,1525984,486757452,448935356
29377496_1526016,CM021101.1,2,29377496,485231468,1778429,1526016,486757484,448935388
29377496_1526017,CM021101.1,2,29377496,485231468,1778429,1526017,486757485,448935389
29377672_1632678,CM021101.1,2,29377672,485233802,2962506,1632678,486866480,449044384
29377672_1636011,CM021101.1,2,29377672,485233802,2962506,1636011,486869813,449047717
29377672_1636044,CM021101.1,2,29377672,485233802,2962506,1636044,486869846,449047750
29379488_1782917,CM021101.1,2,29379488,485233075,2371898,1782917,487015992,449193896
29379488_1782930,CM021101.1,2,29379488,485233075,2371898,1782930,487016005,449193909
29377672_1964473,CM021101.1,2,29377672,485233802,2962506,1964473,487198275,449376179
29377672_1964477,CM021101.1,2,29377672,485233802,2962506,1964477,487198279,449376183
29380797_2108310,CM021101.1,2,29380797,485231468,4736544,2108310,487339778,449517682
29380797_2108333,CM021101.1,2,29380797,485231468,4736544,2108333,487339801,449517705
29380797_2108353,CM021101.1,2,29380797,485231468,4736544,2108353,487339821,449517725
29379488_2134170,CM021101.1,2,29379488,485233075,2371898,2134170,487367245,449545149
29379488_2134182,CM021101.1,2,29379488,485233075,2371898,2134182,487367257,449545161
29379488_2134241,CM021101.1,2,29379488,485233075,2371898,2134241,487367316,449545220
29379488_2134266,CM021101.1,2,29379488,485233075,2371898,2134266,487367341,449545245
29381366_2182781,CM021101.1,2,29381366,485234593,2401689,2182781,487417374,449595278
29381366_2182798,CM021101.1,2,29381366,485234593,2401689,2182798,487417391,449595295
29382214_2254423,CM021101.1,2,29382214,485232975,3202207,2254423,487487398,449665302
29382214_2254434,CM021101.1,2,29382214,485232975,3202207,2254434,487487409,449665313
29379850_2264245,CM021101.1,2,29379850,485231468,3397320,2264245,487495713,449673617
29379850_2264596,CM021101.1,2,29379850,485231468,3397320,2264596,487496064,449673968
29379850_2264609,CM021101.1,2,29379850,485231468,3397320,2264609,487496077,449673981
29379850_2264643,CM021101.1,2,29379850,485231468,3397320,2264643,487496111,449674015
29382214_2790501,CM021101.1,2,29382214,485232975,3202207,2790501,488023476,450201380
29382214_2790502,CM021101.1,2,29382214,485232975,3202207,2790502,488023477,450201381
29382214_2790547,CM021101.1,2,29382214,485232975,3202207,2790547,488023522,450201426
29380797_4238657,CM021101.1,2,29380797,485231468,4736544,4238657,489470125,451648029
28610758_7361,CM021101.1,2,28610758,511701963,8513,7361,511709324,473887228
28610758_7423,CM021101.1,2,28610758,511701963,8513,7423,511709386,473887290
29382241_14593,CM021101.1,2,29382241,511701963,32566,14593,511716556,473894460
29381735_11591,CM021101.1,2,29381735,515026730,539975,11591,515038321,477216225
29381735_11615,CM021101.1,2,29381735,515026730,539975,11615,515038345,477216249
29381735_11628,CM021101.1,2,29381735,515026730,539975,11628,515038358,477216262
29381735_11634,CM021101.1,2,29381735,515026730,539975,11634,515038364,477216268
29381735_11636,CM021101.1,2,29381735,515026730,539975,11636,515038366,477216270
29340121_28645,CM021101.1,2,29340121,515028162,39864,28645,515056807,477234711
29381850_91924,CM021101.1,2,29381850,515026730,284506,91924,515118654,477296558
29381850_91934,CM021101.1,2,29381850,515026730,284506,91934,515118664,477296568
29381850_91937,CM021101.1,2,29381850,515026730,284506,91937,515118667,477296571
29381850_91953,CM021101.1,2,29381850,515026730,284506,91953,515118683,477296587
29381850_247604,CM021101.1,2,29381850,515026730,284506,247604,515274334,477452238
29381850_247637,CM021101.1,2,29381850,515026730,284506,247637,515274367,477452271
29381850_247658,CM021101.1,2,29381850,515026730,284506,247658,515274388,477452292
29381850_247697,CM021101.1,2,29381850,515026730,284506,247697,515274427,477452331
29381850_247701,CM021101.1,2,29381850,515026730,284506,247701,515274431,477452335
29381850_247709,CM021101.1,2,29381850,515026730,284506,247709,515274439,477452343
29381850_247719,CM021101.1,2,29381850,515026730,284506,247719,515274449,477452353
29381850_247725,CM021101.1,2,29381850,515026730,284506,247725,515274455,477452359
29381850_247728,CM021101.1,2,29381850,515026730,284506,247728,515274458,477452362
29381850_247744,CM021101.1,2,29381850,515026730,284506,247744,515274474,477452378
29381850_247746,CM021101.1,2,29381850,515026730,284506,247746,515274476,477452380
29381850_247755,CM021101.1,2,29381850,515026730,284506,247755,515274485,477452389
29381850_247763,CM021101.1,2,29381850,515026730,284506,247763,515274493,477452397
29381850_247780,CM021101.1,2,29381850,515026730,284506,247780,515274510,477452414
29381850_247781,CM021101.1,2,29381850,515026730,284506,247781,515274511,477452415
29381850_247792,CM021101.1,2,29381850,515026730,284506,247792,515274522,477452426
29381850_247800,CM021101.1,2,29381850,515026730,284506,247800,515274530,477452434
29381850_247808,CM021101.1,2,29381850,515026730,284506,247808,515274538,477452442
29381850_247813,CM021101.1,2,29381850,515026730,284506,247813,515274543,477452447
29381154_741840,CM021101.1,2,29381154,515026730,1360550,741840,515768570,477946474
29378569_811371,CM021101.1,2,29378569,515026730,1301680,811371,515838101,478016005
29381154_1050338,CM021101.1,2,29381154,515026730,1360550,1050338,516077068,478254972
29376458_574176,CM021101.1,2,29376458,516875245,850149,574176,517449421,479627325
29376458_574250,CM021101.1,2,29376458,516875245,850149,574250,517449495,479627399
29376458_616470,CM021101.1,2,29376458,516875245,850149,616470,517491715,479669619
29381467_5254,CM021101.1,2,29381467,525054530,751525,5254,525059784,487237688
29381467_5290,CM021101.1,2,29381467,525054530,751525,5290,525059820,487237724
29381467_23308,CM021101.1,2,29381467,525054530,751525,23308,525077838,487255742
29381467_69468,CM021101.1,2,29381467,525054530,751525,69468,525123998,487301902
29381467_69474,CM021101.1,2,29381467,525054530,751525,69474,525124004,487301908
29379798_183299,CM021101.1,2,29379798,525055754,381111,183299,525239053,487416957
29379798_183444,CM021101.1,2,29379798,525055754,381111,183444,525239198,487417102
29380529_278663,CM021101.1,2,29380529,525053617,591300,278663,525332280,487510184
29380529_278670,CM021101.1,2,29380529,525053617,591300,278670,525332287,487510191
29381080_532318,CM021101.1,2,29381080,525053613,677937,532318,525585931,487763835
29380697_572336,CM021101.1,2,29380697,525053614,1353561,572336,525625950,487803854
29380697_1189182,CM021101.1,2,29380697,525053614,1353561,1189182,526242796,488420700
29380697_1189237,CM021101.1,2,29380697,525053614,1353561,1189237,526242851,488420755
29380697_1189266,CM021101.1,2,29380697,525053614,1353561,1189266,526242880,488420784
29380697_1189283,CM021101.1,2,29380697,525053614,1353561,1189283,526242897,488420801
29380697_1191614,CM021101.1,2,29380697,525053614,1353561,1191614,526245228,488423132
29380697_1191655,CM021101.1,2,29380697,525053614,1353561,1191655,526245269,488423173
29380697_1191892,CM021101.1,2,29380697,525053614,1353561,1191892,526245506,488423410
29380697_1197161,CM021101.1,2,29380697,525053614,1353561,1197161,526250775,488428679
29380697_1198101,CM021101.1,2,29380697,525053614,1353561,1198101,526251715,488429619
29380697_1215263,CM021101.1,2,29380697,525053614,1353561,1215263,526268877,488446781
29380697_1215266,CM021101.1,2,29380697,525053614,1353561,1215266,526268880,488446784
29380697_1215300,CM021101.1,2,29380697,525053614,1353561,1215300,526268914,488446818
29378286_123538,CM021101.1,2,29378286,527517512,1386365,123538,527641050,489818954
29378286_123688,CM021101.1,2,29378286,527517512,1386365,123688,527641200,489819104
29378847_255176,CM021101.1,2,29378847,527517513,787983,255176,527772689,489950593
29378847_255281,CM021101.1,2,29378847,527517513,787983,255281,527772794,489950698
29378847_255287,CM021101.1,2,29378847,527517513,787983,255287,527772800,489950704
29378847_304211,CM021101.1,2,29378847,527517513,787983,304211,527821724,489999628
29378286_467129,CM021101.1,2,29378286,527517512,1386365,467129,527984641,490162545
29378286_519560,CM021101.1,2,29378286,527517512,1386365,519560,528037072,490214976
29380811_1008699,CM021101.1,2,29380811,527517509,2413015,1008699,528526208,490704112
29380811_1008720,CM021101.1,2,29380811,527517509,2413015,1008720,528526229,490704133
29380811_1938586,CM021101.1,2,29380811,527517509,2413015,1938586,529456095,491633999
29382444_28264,CM021101.1,2,29382444,530245733,100072,28264,530273997,492451901
29382444_28267,CM021101.1,2,29382444,530245733,100072,28267,530274000,492451904
29382444_28362,CM021101.1,2,29382444,530245733,100072,28362,530274095,492451999
29382444_29924,CM021101.1,2,29382444,530245733,100072,29924,530275657,492453561
29382444_31351,CM021101.1,2,29382444,530245733,100072,31351,530277084,492454988
29382444_31459,CM021101.1,2,29382444,530245733,100072,31459,530277192,492455096
29382444_32805,CM021101.1,2,29382444,530245733,100072,32805,530278538,492456442
29377915_139,CM021101.1,2,29377915,534575469,653131,139,534575608,496753512
29377915_1196,CM021101.1,2,29377915,534575469,653131,1196,534576665,496754569
29377915_1311,CM021101.1,2,29377915,534575469,653131,1311,534576780,496754684
29377915_1320,CM021101.1,2,29377915,534575469,653131,1320,534576789,496754693
29381424_48259,CM021101.1,2,29381424,534574410,4131567,48259,534622669,496800573
29344802_53558,CM021101.1,2,29344802,534579226,71425,53558,534632784,496810688
29344802_53566,CM021101.1,2,29344802,534579226,71425,53566,534632792,496810696
29344802_53710,CM021101.1,2,29344802,534579226,71425,53710,534632936,496810840
29380053_146216,CM021101.1,2,29380053,534575201,637555,146216,534721417,496899321
29380053_244820,CM021101.1,2,29380053,534575201,637555,244820,534820021,496997925
29380053_244845,CM021101.1,2,29380053,534575201,637555,244845,534820046,496997950
29381381_274057,CM021101.1,2,29381381,534574410,1231205,274057,534848467,497026371
29381381_274105,CM021101.1,2,29381381,534574410,1231205,274105,534848515,497026419
29381381_274106,CM021101.1,2,29381381,534574410,1231205,274106,534848516,497026420
29381381_274111,CM021101.1,2,29381381,534574410,1231205,274111,534848521,497026425
29381381_274132,CM021101.1,2,29381381,534574410,1231205,274132,534848542,497026446
29381381_274133,CM021101.1,2,29381381,534574410,1231205,274133,534848543,497026447
29381381_274151,CM021101.1,2,29381381,534574410,1231205,274151,534848561,497026465
29381381_274194,CM021101.1,2,29381381,534574410,1231205,274194,534848604,497026508
29381381_274195,CM021101.1,2,29381381,534574410,1231205,274195,534848605,497026509
29381381_274196,CM021101.1,2,29381381,534574410,1231205,274196,534848606,497026510
29381424_491494,CM021101.1,2,29381424,534574410,4131567,491494,535065904,497243808
29381424_491579,CM021101.1,2,29381424,534574410,4131567,491579,535065989,497243893
29379886_544695,CM021101.1,2,29379886,534576249,2329321,544695,535120944,497298848
29377941_549723,CM021101.1,2,29377941,534575172,884943,549723,535124895,497302799
29377941_549760,CM021101.1,2,29377941,534575172,884943,549760,535124932,497302836
29377318_555956,CM021101.1,2,29377318,534575402,3301104,555956,535131358,497309262
29378516_577595,CM021101.1,2,29378516,534574516,1158413,577595,535152111,497330015
29377941_669550,CM021101.1,2,29377941,534575172,884943,669550,535244722,497422626
29377941_670484,CM021101.1,2,29377941,534575172,884943,670484,535245656,497423560
29377941_670569,CM021101.1,2,29377941,534575172,884943,670569,535245741,497423645
29377941_675427,CM021101.1,2,29377941,534575172,884943,675427,535250599,497428503
29377941_675458,CM021101.1,2,29377941,534575172,884943,675458,535250630,497428534
29382319_767324,CM021101.1,2,29382319,534574410,4339180,767324,535341734,497519638
29379406_828141,CM021101.1,2,29379406,534575864,1715002,828141,535404005,497581909
29379406_828154,CM021101.1,2,29379406,534575864,1715002,828154,535404018,497581922
29381424_913522,CM021101.1,2,29381424,534574410,4131567,913522,535487932,497665836
29381424_913544,CM021101.1,2,29381424,534574410,4131567,913544,535487954,497665858
29377656_923314,CM021101.1,2,29377656,534574987,1225873,923314,535498301,497676205
29377318_937795,CM021101.1,2,29377318,534575402,3301104,937795,535513197,497691101
29377318_937823,CM021101.1,2,29377318,534575402,3301104,937823,535513225,497691129
29382319_1184493,CM021101.1,2,29382319,534574410,4339180,1184493,535758903,497936807
29382319_1185877,CM021101.1,2,29382319,534574410,4339180,1185877,535760287,497938191
29379406_1460973,CM021101.1,2,29379406,534575864,1715002,1460973,536036837,498214741
29379406_1461043,CM021101.1,2,29379406,534575864,1715002,1461043,536036907,498214811
29382319_1585535,CM021101.1,2,29382319,534574410,4339180,1585535,536159945,498337849
29379406_1629675,CM021101.1,2,29379406,534575864,1715002,1629675,536205539,498383443
29382319_1701497,CM021101.1,2,29382319,534574410,4339180,1701497,536275907,498453811
29382319_1701530,CM021101.1,2,29382319,534574410,4339180,1701530,536275940,498453844
29382319_1701551,CM021101.1,2,29382319,534574410,4339180,1701551,536275961,498453865
29379821_1812074,CM021101.1,2,29379821,534574410,3591037,1812074,536386484,498564388
29379821_1812089,CM021101.1,2,29379821,534574410,3591037,1812089,536386499,498564403
29379821_1812093,CM021101.1,2,29379821,534574410,3591037,1812093,536386503,498564407
29379821_1812109,CM021101.1,2,29379821,534574410,3591037,1812109,536386519,498564423
29379821_1812127,CM021101.1,2,29379821,534574410,3591037,1812127,536386537,498564441
29379821_1812168,CM021101.1,2,29379821,534574410,3591037,1812168,536386578,498564482
29379821_1812170,CM021101.1,2,29379821,534574410,3591037,1812170,536386580,498564484
29379821_1812172,CM021101.1,2,29379821,534574410,3591037,1812172,536386582,498564486
29379821_1812175,CM021101.1,2,29379821,534574410,3591037,1812175,536386585,498564489
29379821_1812176,CM021101.1,2,29379821,534574410,3591037,1812176,536386586,498564490
29379821_1812201,CM021101.1,2,29379821,534574410,3591037,1812201,536386611,498564515
29379821_1812237,CM021101.1,2,29379821,534574410,3591037,1812237,536386647,498564551
29379556_1958719,CM021101.1,2,29379556,534574710,2109713,1958719,536533429,498711333
29379805_1982786,CM021101.1,2,29379805,534574832,4386789,1982786,536557618,498735522
29379556_2065338,CM021101.1,2,29379556,534574710,2109713,2065338,536640048,498817952
29379556_2066192,CM021101.1,2,29379556,534574710,2109713,2066192,536640902,498818806
29379556_2089211,CM021101.1,2,29379556,534574710,2109713,2089211,536663921,498841825
29379821_2295103,CM021101.1,2,29379821,534574410,3591037,2295103,536869513,499047417
29382376_2336551,CM021101.1,2,29382376,534574410,2629668,2336551,536910961,499088865
29382376_2336554,CM021101.1,2,29382376,534574410,2629668,2336554,536910964,499088868
29379805_2360494,CM021101.1,2,29379805,534574832,4386789,2360494,536935326,499113230
29379805_2386986,CM021101.1,2,29379805,534574832,4386789,2386986,536961818,499139722
29379805_2387061,CM021101.1,2,29379805,534574832,4386789,2387061,536961893,499139797
29379805_2387078,CM021101.1,2,29379805,534574832,4386789,2387078,536961910,499139814
29382319_2404603,CM021101.1,2,29382319,534574410,4339180,2404603,536979013,499156917
29382319_2404696,CM021101.1,2,29382319,534574410,4339180,2404696,536979106,499157010
29379805_2605731,CM021101.1,2,29379805,534574832,4386789,2605731,537180563,499358467
29379805_2619166,CM021101.1,2,29379805,534574832,4386789,2619166,537193998,499371902
29379805_2619250,CM021101.1,2,29379805,534574832,4386789,2619250,537194082,499371986
29382319_3039263,CM021101.1,2,29382319,534574410,4339180,3039263,537613673,499791577
29379805_3097055,CM021101.1,2,29379805,534574832,4386789,3097055,537671887,499849791
29382097_3187490,CM021101.1,2,29382097,534575289,3608410,3187490,537762779,499940683
29382097_3187580,CM021101.1,2,29382097,534575289,3608410,3187580,537762869,499940773
29382097_3187703,CM021101.1,2,29382097,534575289,3608410,3187703,537762992,499940896
29382317_99528,CM021101.1,2,29382317,537753882,712753,99528,537853410,500031314
29382317_99598,CM021101.1,2,29382317,537753882,712753,99598,537853480,500031384
29382317_99667,CM021101.1,2,29382317,537753882,712753,99667,537853549,500031453
29379821_3480034,CM021101.1,2,29379821,534574410,3591037,3480034,538054444,500232348
29379821_3480050,CM021101.1,2,29379821,534574410,3591037,3480050,538054460,500232364
29379821_3480095,CM021101.1,2,29379821,534574410,3591037,3480095,538054505,500232409
29381357_325067,CM021101.1,2,29381357,537753882,1285793,325067,538078949,500256853
29381357_325265,CM021101.1,2,29381357,537753882,1285793,325265,538079147,500257051
29381357_325266,CM021101.1,2,29381357,537753882,1285793,325266,538079148,500257052
29381295_482401,CM021101.1,2,29381295,537753887,645615,482401,538236288,500414192
29381295_483127,CM021101.1,2,29381295,537753887,645615,483127,538237014,500414918
29381295_485954,CM021101.1,2,29381295,537753887,645615,485954,538239841,500417745
29381357_582867,CM021101.1,2,29381357,537753882,1285793,582867,538336749,500514653
29381357_582912,CM021101.1,2,29381357,537753882,1285793,582912,538336794,500514698
29379805_3807311,CM021101.1,2,29379805,534574832,4386789,3807311,538382143,500560047
29379805_3807358,CM021101.1,2,29379805,534574832,4386789,3807358,538382190,500560094
29379805_3807448,CM021101.1,2,29379805,534574832,4386789,3807448,538382280,500560184
29381111_16274,CM021101.1,2,29381111,553051680,689132,16274,553067954,515245858
29381111_16382,CM021101.1,2,29381111,553051680,689132,16382,553068062,515245966
29381111_16388,CM021101.1,2,29381111,553051680,689132,16388,553068068,515245972
29381111_18082,CM021101.1,2,29381111,553051680,689132,18082,553069762,515247666
29381111_51741,CM021101.1,2,29381111,553051680,689132,51741,553103421,515281325
29381111_53185,CM021101.1,2,29381111,553051680,689132,53185,553104865,515282769
29381111_57411,CM021101.1,2,29381111,553051680,689132,57411,553109091,515286995
29381111_57414,CM021101.1,2,29381111,553051680,689132,57414,553109094,515286998
29381111_60100,CM021101.1,2,29381111,553051680,689132,60100,553111780,515289684
29381111_67774,CM021101.1,2,29381111,553051680,689132,67774,553119454,515297358
29381111_325143,CM021101.1,2,29381111,553051680,689132,325143,553376823,515554727
29381111_376097,CM021101.1,2,29381111,553051680,689132,376097,553427777,515605681
29343571_6101,CM021101.1,2,29343571,554094230,8690,6101,554100331,516278235
29343571_6147,CM021101.1,2,29343571,554094230,8690,6147,554100377,516278281
29343571_6150,CM021101.1,2,29343571,554094230,8690,6150,554100380,516278284
29378397_88052,CM021101.1,2,29378397,572209063,217877,88052,572297115,534475019
29376989_20105,CM021101.1,2,29376989,573723092,32323,20105,573743197,535921101
28317569_5060,CM021101.1,2,28317569,574018018,8419,5060,574023078,536200982
28317569_5069,CM021101.1,2,28317569,574018018,8419,5069,574023087,536200991
28317569_5277,CM021101.1,2,28317569,574018018,8419,5277,574023295,536201199
28317569_5681,CM021101.1,2,28317569,574018018,8419,5681,574023699,536201603
29381685_92737,CM021101.1,2,29381685,587680854,570170,92737,587773591,549951495
29381685_499993,CM021101.1,2,29381685,587680854,570170,499993,588180847,550358751
29381685_500085,CM021101.1,2,29381685,587680854,570170,500085,588180939,550358843
29381685_500137,CM021101.1,2,29381685,587680854,570170,500137,588180991,550358895
29379651_513888,CM021101.1,2,29379651,612346481,2337250,513888,612860369,575038273
29379143_1185575,CM021101.1,2,29379143,612346480,1903181,1185575,613532055,575709959
29379143_1185797,CM021101.1,2,29379143,612346480,1903181,1185797,613532277,575710181
29379143_1225659,CM021101.1,2,29379143,612346480,1903181,1225659,613572139,575750043
29379143_1225854,CM021101.1,2,29379143,612346480,1903181,1225854,613572334,575750238
29379651_1332186,CM021101.1,2,29379651,612346481,2337250,1332186,613678667,575856571
29379651_1332295,CM021101.1,2,29379651,612346481,2337250,1332295,613678776,575856680
29378600_1672613,CM021101.1,2,29378600,612346480,2351596,1672613,614019093,576196997
29379599_63723,CM021101.1,2,29379599,636249428,1361032,63723,636313151,598491055
29379599_63733,CM021101.1,2,29379599,636249428,1361032,63733,636313161,598491065
29379599_63753,CM021101.1,2,29379599,636249428,1361032,63753,636313181,598491085
29377731_42242,CM021101.1,2,29377731,643311070,929713,42242,643353312,605531216
29377052_92478,CM021101.1,2,29377052,643309781,771477,92478,643402259,605580163
29349267_119307,CM021101.1,2,29349267,643309782,219821,119307,643429089,605606993
29349267_129858,CM021101.1,2,29349267,643309782,219821,129858,643439640,605617544
29380132_131820,CM021101.1,2,29380132,643310234,559631,131820,643442054,605619958
29380132_131849,CM021101.1,2,29380132,643310234,559631,131849,643442083,605619987
29380132_131864,CM021101.1,2,29380132,643310234,559631,131864,643442098,605620002
29380132_131890,CM021101.1,2,29380132,643310234,559631,131890,643442124,605620028
29380132_131912,CM021101.1,2,29380132,643310234,559631,131912,643442146,605620050
29380132_131938,CM021101.1,2,29380132,643310234,559631,131938,643442172,605620076
29380132_131939,CM021101.1,2,29380132,643310234,559631,131939,643442173,605620077
29377052_152864,CM021101.1,2,29377052,643309781,771477,152864,643462645,605640549
29377731_297532,CM021101.1,2,29377731,643311070,929713,297532,643608602,605786506
29377731_297534,CM021101.1,2,29377731,643311070,929713,297534,643608604,605786508
29377731_300112,CM021101.1,2,29377731,643311070,929713,300112,643611182,605789086
29335891_396984,CM021101.1,2,29335891,643309782,818360,396984,643706766,605884670
29363798_409072,CM021101.1,2,29363798,643309782,726494,409072,643718854,605896758
29378854_531103,CM021101.1,2,29378854,643309785,639657,531103,643840888,606018792
29378854_531171,CM021101.1,2,29378854,643309785,639657,531171,643840956,606018860
29378854_531308,CM021101.1,2,29378854,643309785,639657,531308,643841093,606018997
29381563_739536,CM021101.1,2,29381563,643309785,4351534,739536,644049321,606227225
29381563_739541,CM021101.1,2,29381563,643309785,4351534,739541,644049326,606227230
29377731_891972,CM021101.1,2,29377731,643311070,929713,891972,644203042,606380946
29377731_892284,CM021101.1,2,29377731,643311070,929713,892284,644203354,606381258
29377731_892326,CM021101.1,2,29377731,643311070,929713,892326,644203396,606381300
29377731_911743,CM021101.1,2,29377731,643311070,929713,911743,644222813,606400717
29381563_1460160,CM021101.1,2,29381563,643309785,4351534,1460160,644769945,606947849
29381563_1564642,CM021101.1,2,29381563,643309785,4351534,1564642,644874427,607052331
29380959_1617815,CM021101.1,2,29380959,643310301,1896949,1617815,644928116,607106020
29377008_1713978,CM021101.1,2,29377008,643309780,1895263,1713978,645023758,607201662
29377008_1860823,CM021101.1,2,29377008,643309780,1895263,1860823,645170603,607348507
29377008_1860862,CM021101.1,2,29377008,643309780,1895263,1860862,645170642,607348546
29377008_1860876,CM021101.1,2,29377008,643309780,1895263,1860876,645170656,607348560
29381563_2648692,CM021101.1,2,29381563,643309785,4351534,2648692,645958477,608136381
29381563_2946083,CM021101.1,2,29381563,643309785,4351534,2946083,646255868,608433772
29381563_2946092,CM021101.1,2,29381563,643309785,4351534,2946092,646255877,608433781
29381563_2946118,CM021101.1,2,29381563,643309785,4351534,2946118,646255903,608433807
29381563_2946152,CM021101.1,2,29381563,643309785,4351534,2946152,646255937,608433841
29381563_2946162,CM021101.1,2,29381563,643309785,4351534,2946162,646255947,608433851
29381563_2946164,CM021101.1,2,29381563,643309785,4351534,2946164,646255949,608433853
29381563_2946864,CM021101.1,2,29381563,643309785,4351534,2946864,646256649,608434553
29381563_3287505,CM021101.1,2,29381563,643309785,4351534,3287505,646597290,608775194
29381563_3570357,CM021101.1,2,29381563,643309785,4351534,3570357,646880142,609058046
29381563_3570359,CM021101.1,2,29381563,643309785,4351534,3570359,646880144,609058048
29381563_3570393,CM021101.1,2,29381563,643309785,4351534,3570393,646880178,609058082
29381563_3570640,CM021101.1,2,29381563,643309785,4351534,3570640,646880425,609058329
29381563_3570651,CM021101.1,2,29381563,643309785,4351534,3570651,646880436,609058340
29381563_3570653,CM021101.1,2,29381563,643309785,4351534,3570653,646880438,609058342
29381563_3570691,CM021101.1,2,29381563,643309785,4351534,3570691,646880476,609058380
29381563_3570692,CM021101.1,2,29381563,643309785,4351534,3570692,646880477,609058381
29381563_3600707,CM021101.1,2,29381563,643309785,4351534,3600707,646910492,609088396
29381563_4249199,CM021101.1,2,29381563,643309785,4351534,4249199,647558984,609736888
29130248_3364,CM021101.1,2,29130248,654943200,6194,3364,654946564,617124468
29382170_561038,CM021101.1,2,29382170,663764183,721453,561038,664325221,626503125
29382170_561040,CM021101.1,2,29382170,663764183,721453,561040,664325223,626503127
29377445_77431,CM021101.1,2,29377445,668726926,358068,77431,668804357,630982261
29382156_275763,CM021101.1,2,29382156,668725512,847447,275763,669001275,631179179
29382156_275886,CM021101.1,2,29382156,668725512,847447,275886,669001398,631179302
29378892_339567,CM021101.1,2,29378892,668726548,2868836,339567,669066115,631244019
29377978_364535,CM021101.1,2,29377978,668725516,1928749,364535,669090051,631267955
29378892_437936,CM021101.1,2,29378892,668726548,2868836,437936,669164484,631342388
29378892_438023,CM021101.1,2,29378892,668726548,2868836,438023,669164571,631342475
29377978_467227,CM021101.1,2,29377978,668725516,1928749,467227,669192743,631370647
29377978_467318,CM021101.1,2,29377978,668725516,1928749,467318,669192834,631370738
29377978_467372,CM021101.1,2,29377978,668725516,1928749,467372,669192888,631370792
29377435_677770,CM021101.1,2,29377435,668726089,2866436,677770,669403859,631581763
29377435_680434,CM021101.1,2,29377435,668726089,2866436,680434,669406523,631584427
29377435_680479,CM021101.1,2,29377435,668726089,2866436,680479,669406568,631584472
29377435_680498,CM021101.1,2,29377435,668726089,2866436,680498,669406587,631584491
29377435_680535,CM021101.1,2,29377435,668726089,2866436,680535,669406624,631584528
29377435_680605,CM021101.1,2,29377435,668726089,2866436,680605,669406694,631584598
29377435_700530,CM021101.1,2,29377435,668726089,2866436,700530,669426619,631604523
29377435_700541,CM021101.1,2,29377435,668726089,2866436,700541,669426630,631604534
29377435_700570,CM021101.1,2,29377435,668726089,2866436,700570,669426659,631604563
29377435_700608,CM021101.1,2,29377435,668726089,2866436,700608,669426697,631604601
29377435_700609,CM021101.1,2,29377435,668726089,2866436,700609,669426698,631604602
29377435_700616,CM021101.1,2,29377435,668726089,2866436,700616,669426705,631604609
29377435_700648,CM021101.1,2,29377435,668726089,2866436,700648,669426737,631604641
29380472_755541,CM021101.1,2,29380472,668727011,1890178,755541,669482552,631660456
29377954_1095499,CM021101.1,2,29377954,668726847,3044975,1095499,669822346,632000250
29377954_1095519,CM021101.1,2,29377954,668726847,3044975,1095519,669822366,632000270
29377859_1301173,CM021101.1,2,29377859,668726044,3030858,1301173,670027217,632205121
29378114_1313360,CM021101.1,2,29378114,668725516,5612905,1313360,670038876,632216780
29378114_1313370,CM021101.1,2,29378114,668725516,5612905,1313370,670038886,632216790
29378114_1313385,CM021101.1,2,29378114,668725516,5612905,1313385,670038901,632216805
29378114_1313458,CM021101.1,2,29378114,668725516,5612905,1313458,670038974,632216878
29377954_1383266,CM021101.1,2,29377954,668726847,3044975,1383266,670110113,632288017
29377954_1383368,CM021101.1,2,29377954,668726847,3044975,1383368,670110215,632288119
29377435_1435161,CM021101.1,2,29377435,668726089,2866436,1435161,670161250,632339154
29377435_1435201,CM021101.1,2,29377435,668726089,2866436,1435201,670161290,632339194
29377435_1435203,CM021101.1,2,29377435,668726089,2866436,1435203,670161292,632339196
29377435_1435256,CM021101.1,2,29377435,668726089,2866436,1435256,670161345,632339249
29377435_1437410,CM021101.1,2,29377435,668726089,2866436,1437410,670163499,632341403
29377954_1645779,CM021101.1,2,29377954,668726847,3044975,1645779,670372626,632550530
29377435_1658167,CM021101.1,2,29377435,668726089,2866436,1658167,670384256,632562160
29377978_1683701,CM021101.1,2,29377978,668725516,1928749,1683701,670409217,632587121
29378114_2118080,CM021101.1,2,29378114,668725516,5612905,2118080,670843596,633021500
29378114_2282468,CM021101.1,2,29378114,668725516,5612905,2282468,671007984,633185888
29377859_3025346,CM021101.1,2,29377859,668726044,3030858,3025346,671751390,633929294
29377859_3025437,CM021101.1,2,29377859,668726044,3030858,3025437,671751481,633929385
29377859_3025612,CM021101.1,2,29377859,668726044,3030858,3025612,671751656,633929560
29377859_3025654,CM021101.1,2,29377859,668726044,3030858,3025654,671751698,633929602
29378114_4106046,CM021101.1,2,29378114,668725516,5612905,4106046,672831562,635009466
29378114_4106167,CM021101.1,2,29378114,668725516,5612905,4106167,672831683,635009587
29382150_35883,CM021101.1,2,29382150,704904084,993267,35883,704939967,667117871
29382150_36421,CM021101.1,2,29382150,704904084,993267,36421,704940505,667118409
29379261_82608,CM021101.1,2,29379261,704904088,4144187,82608,704986696,667164600
29379261_82642,CM021101.1,2,29379261,704904088,4144187,82642,704986730,667164634
29379261_82750,CM021101.1,2,29379261,704904088,4144187,82750,704986838,667164742
29379261_82765,CM021101.1,2,29379261,704904088,4144187,82765,704986853,667164757
29382365_196511,CM021101.1,2,29382365,704904088,792470,196511,705100599,667278503
29382365_220316,CM021101.1,2,29382365,704904088,792470,220316,705124404,667302308
29382365_220393,CM021101.1,2,29382365,704904088,792470,220393,705124481,667302385
29382150_271494,CM021101.1,2,29382150,704904084,993267,271494,705175578,667353482
29382150_272031,CM021101.1,2,29382150,704904084,993267,272031,705176115,667354019
29382150_272077,CM021101.1,2,29382150,704904084,993267,272077,705176161,667354065
29377007_506614,CM021101.1,2,29377007,704904084,1518937,506614,705410698,667588602
29377007_507417,CM021101.1,2,29377007,704904084,1518937,507417,705411501,667589405
29377007_527125,CM021101.1,2,29377007,704904084,1518937,527125,705431209,667609113
29377007_527168,CM021101.1,2,29377007,704904084,1518937,527168,705431252,667609156
29377007_527203,CM021101.1,2,29377007,704904084,1518937,527203,705431287,667609191
29382365_583655,CM021101.1,2,29382365,704904088,792470,583655,705487743,667665647
29379261_589694,CM021101.1,2,29379261,704904088,4144187,589694,705493782,667671686
29379261_589745,CM021101.1,2,29379261,704904088,4144187,589745,705493833,667671737
29379261_589747,CM021101.1,2,29379261,704904088,4144187,589747,705493835,667671739
29379261_589787,CM021101.1,2,29379261,704904088,4144187,589787,705493875,667671779
29379261_589790,CM021101.1,2,29379261,704904088,4144187,589790,705493878,667671782
29379261_589876,CM021101.1,2,29379261,704904088,4144187,589876,705493964,667671868
29379261_669534,CM021101.1,2,29379261,704904088,4144187,669534,705573622,667751526
29379261_669607,CM021101.1,2,29379261,704904088,4144187,669607,705573695,667751599
29379261_669664,CM021101.1,2,29379261,704904088,4144187,669664,705573752,667751656
29379261_794406,CM021101.1,2,29379261,704904088,4144187,794406,705698494,667876398
29379261_794425,CM021101.1,2,29379261,704904088,4144187,794425,705698513,667876417
29379261_2112847,CM021101.1,2,29379261,704904088,4144187,2112847,707016935,669194839
29379261_2112912,CM021101.1,2,29379261,704904088,4144187,2112912,707017000,669194904
29382454_129550,CM021101.1,2,29382454,735867444,1337395,129550,735996994,698174898
29382454_129916,CM021101.1,2,29382454,735867444,1337395,129916,735997360,698175264
29382454_130581,CM021101.1,2,29382454,735867444,1337395,130581,735998025,698175929
29382454_132016,CM021101.1,2,29382454,735867444,1337395,132016,735999460,698177364
29382454_132046,CM021101.1,2,29382454,735867444,1337395,132046,735999490,698177394
29379668_415470,CM021101.1,2,29379668,735867444,1577261,415470,736282914,698460818
29379668_415572,CM021101.1,2,29379668,735867444,1577261,415572,736283016,698460920
29379668_415764,CM021101.1,2,29379668,735867444,1577261,415764,736283208,698461112
29379668_466293,CM021101.1,2,29379668,735867444,1577261,466293,736333737,698511641
29379668_466404,CM021101.1,2,29379668,735867444,1577261,466404,736333848,698511752
29380548_1132812,CM021101.1,2,29380548,735867440,1692216,1132812,737000252,699178156
29380548_1132929,CM021101.1,2,29380548,735867440,1692216,1132929,737000369,699178273
29379668_1402385,CM021101.1,2,29379668,735867444,1577261,1402385,737269829,699447733
29379668_1402482,CM021101.1,2,29379668,735867444,1577261,1402482,737269926,699447830
29380548_1465461,CM021101.1,2,29380548,735867440,1692216,1465461,737332901,699510805
29380548_1465533,CM021101.1,2,29380548,735867440,1692216,1465533,737332973,699510877
29380548_1465556,CM021101.1,2,29380548,735867440,1692216,1465556,737332996,699510900
29380548_1465561,CM021101.1,2,29380548,735867440,1692216,1465561,737333001,699510905
29380548_1465578,CM021101.1,2,29380548,735867440,1692216,1465578,737333018,699510922
29379668_1542433,CM021101.1,2,29379668,735867444,1577261,1542433,737409877,699587781
29379668_1576448,CM021101.1,2,29379668,735867444,1577261,1576448,737443892,699621796
29378043_200086,CM021101.1,2,29378043,737609436,1225724,200086,737809522,699987426
29378043_200090,CM021101.1,2,29378043,737609436,1225724,200090,737809526,699987430
29378043_200119,CM021101.1,2,29378043,737609436,1225724,200119,737809555,699987459
29378043_200146,CM021101.1,2,29378043,737609436,1225724,200146,737809582,699987486
29378043_200168,CM021101.1,2,29378043,737609436,1225724,200168,737809604,699987508
29378043_200202,CM021101.1,2,29378043,737609436,1225724,200202,737809638,699987542
29378043_200337,CM021101.1,2,29378043,737609436,1225724,200337,737809773,699987677
29378043_271965,CM021101.1,2,29378043,737609436,1225724,271965,737881401,700059305
29378043_272044,CM021101.1,2,29378043,737609436,1225724,272044,737881480,700059384
29378043_882737,CM021101.1,2,29378043,737609436,1225724,882737,738492173,700670077
29378043_882810,CM021101.1,2,29378043,737609436,1225724,882810,738492246,700670150
29378043_890167,CM021101.1,2,29378043,737609436,1225724,890167,738499603,700677507
29378043_953967,CM021101.1,2,29378043,737609436,1225724,953967,738563403,700741307
29378043_954025,CM021101.1,2,29378043,737609436,1225724,954025,738563461,700741365
29378043_954028,CM021101.1,2,29378043,737609436,1225724,954028,738563464,700741368
29378043_1111664,CM021101.1,2,29378043,737609436,1225724,1111664,738721100,700899004
29378043_1127420,CM021101.1,2,29378043,737609436,1225724,1127420,738736856,700914760
29378043_1143281,CM021101.1,2,29378043,737609436,1225724,1143281,738752717,700930621
29378043_1143383,CM021101.1,2,29378043,737609436,1225724,1143383,738752819,700930723
29378043_1154690,CM021101.1,2,29378043,737609436,1225724,1154690,738764126,700942030
29378043_1192602,CM021101.1,2,29378043,737609436,1225724,1192602,738802038,700979942
29378043_1192678,CM021101.1,2,29378043,737609436,1225724,1192678,738802114,700980018
29378043_1192704,CM021101.1,2,29378043,737609436,1225724,1192704,738802140,700980044
29378043_1193028,CM021101.1,2,29378043,737609436,1225724,1193028,738802464,700980368
29378672_10160,CM021101.1,2,29378672,742966756,894671,10160,742976916,705154820
29378672_10346,CM021101.1,2,29378672,742966756,894671,10346,742977102,705155006
29378858_65768,CM021101.1,2,29378858,742964403,583599,65768,743030171,705208075
29379255_157292,CM021101.1,2,29379255,750830018,881948,157292,750987310,713165214
29379255_157327,CM021101.1,2,29379255,750830018,881948,157327,750987345,713165249
29379255_157363,CM021101.1,2,29379255,750830018,881948,157363,750987381,713165285
29379255_157372,CM021101.1,2,29379255,750830018,881948,157372,750987390,713165294
29379255_173909,CM021101.1,2,29379255,750830018,881948,173909,751003927,713181831
29379255_173920,CM021101.1,2,29379255,750830018,881948,173920,751003938,713181842
29379255_176290,CM021101.1,2,29379255,750830018,881948,176290,751006308,713184212
29379255_176643,CM021101.1,2,29379255,750830018,881948,176643,751006661,713184565
29379255_176733,CM021101.1,2,29379255,750830018,881948,176733,751006751,713184655
29379255_275430,CM021101.1,2,29379255,750830018,881948,275430,751105448,713283352
29379255_277681,CM021101.1,2,29379255,750830018,881948,277681,751107699,713285603
29379255_340636,CM021101.1,2,29379255,750830018,881948,340636,751170654,713348558
29379255_340649,CM021101.1,2,29379255,750830018,881948,340649,751170667,713348571
29379255_340653,CM021101.1,2,29379255,750830018,881948,340653,751170671,713348575
29379255_340672,CM021101.1,2,29379255,750830018,881948,340672,751170690,713348594
29379255_340674,CM021101.1,2,29379255,750830018,881948,340674,751170692,713348596
29379255_340680,CM021101.1,2,29379255,750830018,881948,340680,751170698,713348602
29379255_862490,CM021101.1,2,29379255,750830018,881948,862490,751692508,713870412
29379255_862501,CM021101.1,2,29379255,750830018,881948,862501,751692519,713870423
29379255_862565,CM021101.1,2,29379255,750830018,881948,862565,751692583,713870487
29379255_862588,CM021101.1,2,29379255,750830018,881948,862588,751692606,713870510
29379255_862766,CM021101.1,2,29379255,750830018,881948,862766,751692784,713870688
29379255_862827,CM021101.1,2,29379255,750830018,881948,862827,751692845,713870749
29379255_863027,CM021101.1,2,29379255,750830018,881948,863027,751693045,713870949
29381866_34514,CM021101.1,2,29381866,752236436,6293366,34514,752270950,714448854
29377793_185363,CM021101.1,2,29377793,752236260,2119885,185363,752421623,714599527
29377796_191161,CM021101.1,2,29377796,752236365,1317327,191161,752427526,714605430
29381866_200840,CM021101.1,2,29381866,752236436,6293366,200840,752437276,714615180
29381866_204285,CM021101.1,2,29381866,752236436,6293366,204285,752440721,714618625
29378391_232368,CM021101.1,2,29378391,752237434,569351,232368,752469802,714647706
29377793_298030,CM021101.1,2,29377793,752236260,2119885,298030,752534290,714712194
29381654_309895,CM021101.1,2,29381654,752237310,1870653,309895,752547205,714725109
29381654_309907,CM021101.1,2,29381654,752237310,1870653,309907,752547217,714725121
29381654_310343,CM021101.1,2,29381654,752237310,1870653,310343,752547653,714725557
29381654_312982,CM021101.1,2,29381654,752237310,1870653,312982,752550292,714728196
29381654_313024,CM021101.1,2,29381654,752237310,1870653,313024,752550334,714728238
29380747_336696,CM021101.1,2,29380747,752235212,2969489,336696,752571908,714749812
29380747_374545,CM021101.1,2,29380747,752235212,2969489,374545,752609757,714787661
29380138_377443,CM021101.1,2,29380138,752237469,2161330,377443,752614912,714792816
29380138_380738,CM021101.1,2,29380138,752237469,2161330,380738,752618207,714796111
29377793_429523,CM021101.1,2,29377793,752236260,2119885,429523,752665783,714843687
29377793_429535,CM021101.1,2,29377793,752236260,2119885,429535,752665795,714843699
29377793_439396,CM021101.1,2,29377793,752236260,2119885,439396,752675656,714853560
29377793_439407,CM021101.1,2,29377793,752236260,2119885,439407,752675667,714853571
29377793_439472,CM021101.1,2,29377793,752236260,2119885,439472,752675732,714853636
29377793_439549,CM021101.1,2,29377793,752236260,2119885,439549,752675809,714853713
29377796_442044,CM021101.1,2,29377796,752236365,1317327,442044,752678409,714856313
29377796_442073,CM021101.1,2,29377796,752236365,1317327,442073,752678438,714856342
29377796_442092,CM021101.1,2,29377796,752236365,1317327,442092,752678457,714856361
29377796_451036,CM021101.1,2,29377796,752236365,1317327,451036,752687401,714865305
29377796_451044,CM021101.1,2,29377796,752236365,1317327,451044,752687409,714865313
29377796_451123,CM021101.1,2,29377796,752236365,1317327,451123,752687488,714865392
29378391_456146,CM021101.1,2,29378391,752237434,569351,456146,752693580,714871484
29380747_477346,CM021101.1,2,29380747,752235212,2969489,477346,752712558,714890462
29377793_595165,CM021101.1,2,29377793,752236260,2119885,595165,752831425,715009329
29377793_595270,CM021101.1,2,29377793,752236260,2119885,595270,752831530,715009434
29378338_610360,CM021101.1,2,29378338,752235934,4264644,610360,752846294,715024198
29378338_610375,CM021101.1,2,29378338,752235934,4264644,610375,752846309,715024213
29378338_610450,CM021101.1,2,29378338,752235934,4264644,610450,752846384,715024288
29378338_610487,CM021101.1,2,29378338,752235934,4264644,610487,752846421,715024325
29378116_711769,CM021101.1,2,29378116,752236609,5359258,711769,752948378,715126282
29379006_712184,CM021101.1,2,29379006,752236791,968603,712184,752948975,715126879
29379006_712893,CM021101.1,2,29379006,752236791,968603,712893,752949684,715127588
29380939_737945,CM021101.1,2,29380939,752236791,1571648,737945,752974736,715152640
29379006_759650,CM021101.1,2,29379006,752236791,968603,759650,752996441,715174345
29379006_759874,CM021101.1,2,29379006,752236791,968603,759874,752996665,715174569
29379006_759986,CM021101.1,2,29379006,752236791,968603,759986,752996777,715174681
29379006_760035,CM021101.1,2,29379006,752236791,968603,760035,752996826,715174730
29379006_760056,CM021101.1,2,29379006,752236791,968603,760056,752996847,715174751
29379006_760074,CM021101.1,2,29379006,752236791,968603,760074,752996865,715174769
29379006_760139,CM021101.1,2,29379006,752236791,968603,760139,752996930,715174834
29379006_760155,CM021101.1,2,29379006,752236791,968603,760155,752996946,715174850
29380623_772062,CM021101.1,2,29380623,752236980,1056251,772062,753009042,715186946
29380939_776980,CM021101.1,2,29380939,752236791,1571648,776980,753013771,715191675
29379006_810093,CM021101.1,2,29379006,752236791,968603,810093,753046884,715224788
29379006_810189,CM021101.1,2,29379006,752236791,968603,810189,753046980,715224884
29379006_810302,CM021101.1,2,29379006,752236791,968603,810302,753047093,715224997
29379006_810339,CM021101.1,2,29379006,752236791,968603,810339,753047130,715225034
29379006_810408,CM021101.1,2,29379006,752236791,968603,810408,753047199,715225103
29379006_810897,CM021101.1,2,29379006,752236791,968603,810897,753047688,715225592
29379006_811031,CM021101.1,2,29379006,752236791,968603,811031,753047822,715225726
29379006_811077,CM021101.1,2,29379006,752236791,968603,811077,753047868,715225772
29378959_815865,CM021101.1,2,29378959,752236107,3020058,815865,753051972,715229876
29379006_843428,CM021101.1,2,29379006,752236791,968603,843428,753080219,715258123
29379006_843439,CM021101.1,2,29379006,752236791,968603,843439,753080230,715258134
29379006_843508,CM021101.1,2,29379006,752236791,968603,843508,753080299,715258203
29379006_866211,CM021101.1,2,29379006,752236791,968603,866211,753103002,715280906
29379006_866235,CM021101.1,2,29379006,752236791,968603,866235,753103026,715280930
29377793_867919,CM021101.1,2,29377793,752236260,2119885,867919,753104179,715282083
29377793_867950,CM021101.1,2,29377793,752236260,2119885,867950,753104210,715282114
29378722_904732,CM021101.1,2,29378722,752235913,1148774,904732,753140645,715318549
29378722_904873,CM021101.1,2,29378722,752235913,1148774,904873,753140786,715318690
29378722_905274,CM021101.1,2,29378722,752235913,1148774,905274,753141187,715319091
29381866_1047757,CM021101.1,2,29381866,752236436,6293366,1047757,753284193,715462097
29381654_1080433,CM021101.1,2,29381654,752237310,1870653,1080433,753317743,715495647
29378959_1126271,CM021101.1,2,29378959,752236107,3020058,1126271,753362378,715540282
29378959_1126383,CM021101.1,2,29378959,752236107,3020058,1126383,753362490,715540394
29378959_1126439,CM021101.1,2,29378959,752236107,3020058,1126439,753362546,715540450
29379693_1128129,CM021101.1,2,29379693,752235510,4772497,1128129,753363639,715541543
29379693_1128140,CM021101.1,2,29379693,752235510,4772497,1128140,753363650,715541554
29380138_1129583,CM021101.1,2,29380138,752237469,2161330,1129583,753367052,715544956
29380138_1129759,CM021101.1,2,29380138,752237469,2161330,1129759,753367228,715545132
29380773_1158471,CM021101.1,2,29380773,752235954,2881270,1158471,753394425,715572329
29379693_1160899,CM021101.1,2,29379693,752235510,4772497,1160899,753396409,715574313
29379693_1166117,CM021101.1,2,29379693,752235510,4772497,1166117,753401627,715579531
29379693_1166706,CM021101.1,2,29379693,752235510,4772497,1166706,753402216,715580120
29379693_1166716,CM021101.1,2,29379693,752235510,4772497,1166716,753402226,715580130
29379693_1184370,CM021101.1,2,29379693,752235510,4772497,1184370,753419880,715597784
29379693_1184447,CM021101.1,2,29379693,752235510,4772497,1184447,753419957,715597861
29380747_1199771,CM021101.1,2,29380747,752235212,2969489,1199771,753434983,715612887
29380747_1199832,CM021101.1,2,29380747,752235212,2969489,1199832,753435044,715612948
29380747_1199904,CM021101.1,2,29380747,752235212,2969489,1199904,753435116,715613020
29377796_1243800,CM021101.1,2,29377796,752236365,1317327,1243800,753480165,715658069
29377796_1284763,CM021101.1,2,29377796,752236365,1317327,1284763,753521128,715699032
29381753_1295812,CM021101.1,2,29381753,752235208,3776117,1295812,753531020,715708924
29381753_1295828,CM021101.1,2,29381753,752235208,3776117,1295828,753531036,715708940
29381142_1354787,CM021101.1,2,29381142,752236699,2678282,1354787,753591486,715769390
29381142_1354829,CM021101.1,2,29381142,752236699,2678282,1354829,753591528,715769432
29381142_1354909,CM021101.1,2,29381142,752236699,2678282,1354909,753591608,715769512
29381142_1354937,CM021101.1,2,29381142,752236699,2678282,1354937,753591636,715769540
29381142_1354951,CM021101.1,2,29381142,752236699,2678282,1354951,753591650,715769554
29381142_1355838,CM021101.1,2,29381142,752236699,2678282,1355838,753592537,715770441
29381753_1370125,CM021101.1,2,29381753,752235208,3776117,1370125,753605333,715783237
29381753_1370193,CM021101.1,2,29381753,752235208,3776117,1370193,753605401,715783305
29381753_1370214,CM021101.1,2,29381753,752235208,3776117,1370214,753605422,715783326
29381753_1371693,CM021101.1,2,29381753,752235208,3776117,1371693,753606901,715784805
29380840_1371776,CM021101.1,2,29380840,752235212,6474624,1371776,753606988,715784892
29380840_1371907,CM021101.1,2,29380840,752235212,6474624,1371907,753607119,715785023
29380840_1372117,CM021101.1,2,29380840,752235212,6474624,1372117,753607329,715785233
29380840_1372118,CM021101.1,2,29380840,752235212,6474624,1372118,753607330,715785234
29380840_1372119,CM021101.1,2,29380840,752235212,6474624,1372119,753607331,715785235
29380840_1372132,CM021101.1,2,29380840,752235212,6474624,1372132,753607344,715785248
29380840_1372178,CM021101.1,2,29380840,752235212,6474624,1372178,753607390,715785294
29380840_1372299,CM021101.1,2,29380840,752235212,6474624,1372299,753607511,715785415
29380840_1372307,CM021101.1,2,29380840,752235212,6474624,1372307,753607519,715785423
29380840_1372358,CM021101.1,2,29380840,752235212,6474624,1372358,753607570,715785474
29380840_1383642,CM021101.1,2,29380840,752235212,6474624,1383642,753618854,715796758
29380840_1383677,CM021101.1,2,29380840,752235212,6474624,1383677,753618889,715796793
29377013_1429919,CM021101.1,2,29377013,752236651,3654554,1429919,753666570,715844474
29381654_1448884,CM021101.1,2,29381654,752237310,1870653,1448884,753686194,715864098
29380747_1597755,CM021101.1,2,29380747,752235212,2969489,1597755,753832967,716010871
29380747_1597986,CM021101.1,2,29380747,752235212,2969489,1597986,753833198,716011102
29380747_1601546,CM021101.1,2,29380747,752235212,2969489,1601546,753836758,716014662
29380747_1601580,CM021101.1,2,29380747,752235212,2969489,1601580,753836792,716014696
29380747_1601642,CM021101.1,2,29380747,752235212,2969489,1601642,753836854,716014758
29380747_1601706,CM021101.1,2,29380747,752235212,2969489,1601706,753836918,716014822
29380747_1603824,CM021101.1,2,29380747,752235212,2969489,1603824,753839036,716016940
29380747_1607787,CM021101.1,2,29380747,752235212,2969489,1607787,753842999,716020903
29380747_1609237,CM021101.1,2,29380747,752235212,2969489,1609237,753844449,716022353
29381654_1614309,CM021101.1,2,29381654,752237310,1870653,1614309,753851619,716029523
29381654_1614352,CM021101.1,2,29381654,752237310,1870653,1614352,753851662,716029566
29380138_1702913,CM021101.1,2,29380138,752237469,2161330,1702913,753940382,716118286
29378370_1746965,CM021101.1,2,29378370,752235708,3744346,1746965,753982673,716160577
29380138_1764004,CM021101.1,2,29380138,752237469,2161330,1764004,754001473,716179377
29380138_1764007,CM021101.1,2,29380138,752237469,2161330,1764007,754001476,716179380
29380138_1765097,CM021101.1,2,29380138,752237469,2161330,1765097,754002566,716180470
29380138_1765099,CM021101.1,2,29380138,752237469,2161330,1765099,754002568,716180472
29380138_1765135,CM021101.1,2,29380138,752237469,2161330,1765135,754002604,716180508
29380138_1765148,CM021101.1,2,29380138,752237469,2161330,1765148,754002617,716180521
29381142_1775659,CM021101.1,2,29381142,752236699,2678282,1775659,754012358,716190262
29381142_1775713,CM021101.1,2,29381142,752236699,2678282,1775713,754012412,716190316
29381142_1775734,CM021101.1,2,29381142,752236699,2678282,1775734,754012433,716190337
29381142_1775777,CM021101.1,2,29381142,752236699,2678282,1775777,754012476,716190380
29380747_1782392,CM021101.1,2,29380747,752235212,2969489,1782392,754017604,716195508
29380138_1810272,CM021101.1,2,29380138,752237469,2161330,1810272,754047741,716225645
29380747_1850585,CM021101.1,2,29380747,752235212,2969489,1850585,754085797,716263701
29380747_1850705,CM021101.1,2,29380747,752235212,2969489,1850705,754085917,716263821
29380747_1892914,CM021101.1,2,29380747,752235212,2969489,1892914,754128126,716306030
29380747_1892973,CM021101.1,2,29380747,752235212,2969489,1892973,754128185,716306089
29380747_1966267,CM021101.1,2,29380747,752235212,2969489,1966267,754201479,716379383
29380747_1966317,CM021101.1,2,29380747,752235212,2969489,1966317,754201529,716379433
29380747_1966351,CM021101.1,2,29380747,752235212,2969489,1966351,754201563,716379467
29380138_1976798,CM021101.1,2,29380138,752237469,2161330,1976798,754214267,716392171
29380138_1979588,CM021101.1,2,29380138,752237469,2161330,1979588,754217057,716394961
29380138_2001956,CM021101.1,2,29380138,752237469,2161330,2001956,754239425,716417329
29380747_2109523,CM021101.1,2,29380747,752235212,2969489,2109523,754344735,716522639
29379693_2129766,CM021101.1,2,29379693,752235510,4772497,2129766,754365276,716543180
29379693_2129806,CM021101.1,2,29379693,752235510,4772497,2129806,754365316,716543220
29378959_2425800,CM021101.1,2,29378959,752236107,3020058,2425800,754661907,716839811
29377013_2472444,CM021101.1,2,29377013,752236651,3654554,2472444,754709095,716886999
29378116_2568506,CM021101.1,2,29378116,752236609,5359258,2568506,754805115,716983019
29378116_2568520,CM021101.1,2,29378116,752236609,5359258,2568520,754805129,716983033
29378116_2568959,CM021101.1,2,29378116,752236609,5359258,2568959,754805568,716983472
29378370_2627719,CM021101.1,2,29378370,752235708,3744346,2627719,754863427,717041331
29381753_2736524,CM021101.1,2,29381753,752235208,3776117,2736524,754971732,717149636
29381753_2736560,CM021101.1,2,29381753,752235208,3776117,2736560,754971768,717149672
29378116_2826071,CM021101.1,2,29378116,752236609,5359258,2826071,755062680,717240584
29377013_3172362,CM021101.1,2,29377013,752236651,3654554,3172362,755409013,717586917
29378370_3257349,CM021101.1,2,29378370,752235708,3744346,3257349,755493057,717670961
29377013_3286886,CM021101.1,2,29377013,752236651,3654554,3286886,755523537,717701441
29377013_3287061,CM021101.1,2,29377013,752236651,3654554,3287061,755523712,717701616
29377013_3287224,CM021101.1,2,29377013,752236651,3654554,3287224,755523875,717701779
29377013_3287401,CM021101.1,2,29377013,752236651,3654554,3287401,755524052,717701956
29377013_3287419,CM021101.1,2,29377013,752236651,3654554,3287419,755524070,717701974
29377013_3299286,CM021101.1,2,29377013,752236651,3654554,3299286,755535937,717713841
29377013_3396578,CM021101.1,2,29377013,752236651,3654554,3396578,755633229,717811133
29377013_3398398,CM021101.1,2,29377013,752236651,3654554,3398398,755635049,717812953
29377013_3398424,CM021101.1,2,29377013,752236651,3654554,3398424,755635075,717812979
29381753_3482699,CM021101.1,2,29381753,752235208,3776117,3482699,755717907,717895811
29381753_3482704,CM021101.1,2,29381753,752235208,3776117,3482704,755717912,717895816
29381753_3482796,CM021101.1,2,29381753,752235208,3776117,3482796,755718004,717895908
29381753_3482808,CM021101.1,2,29381753,752235208,3776117,3482808,755718016,717895920
29378116_3611098,CM021101.1,2,29378116,752236609,5359258,3611098,755847707,718025611
29381866_3645247,CM021101.1,2,29381866,752236436,6293366,3645247,755881683,718059587
29381866_3645329,CM021101.1,2,29381866,752236436,6293366,3645329,755881765,718059669
29381866_3648065,CM021101.1,2,29381866,752236436,6293366,3648065,755884501,718062405
29381866_3654020,CM021101.1,2,29381866,752236436,6293366,3654020,755890456,718068360
29381866_3654467,CM021101.1,2,29381866,752236436,6293366,3654467,755890903,718068807
29381866_3654540,CM021101.1,2,29381866,752236436,6293366,3654540,755890976,718068880
29381866_3654554,CM021101.1,2,29381866,752236436,6293366,3654554,755890990,718068894
29381866_3654555,CM021101.1,2,29381866,752236436,6293366,3654555,755890991,718068895
29378116_3792022,CM021101.1,2,29378116,752236609,5359258,3792022,756028631,718206535
29378116_3792031,CM021101.1,2,29378116,752236609,5359258,3792031,756028640,718206544
29378116_3792137,CM021101.1,2,29378116,752236609,5359258,3792137,756028746,718206650
29379693_4024257,CM021101.1,2,29379693,752235510,4772497,4024257,756259767,718437671
29379693_4300633,CM021101.1,2,29379693,752235510,4772497,4300633,756536143,718714047
29379693_4300811,CM021101.1,2,29379693,752235510,4772497,4300811,756536321,718714225
29379693_4302746,CM021101.1,2,29379693,752235510,4772497,4302746,756538256,718716160
29378116_4331698,CM021101.1,2,29378116,752236609,5359258,4331698,756568307,718746211
29378116_4333113,CM021101.1,2,29378116,752236609,5359258,4333113,756569722,718747626
29378116_4333116,CM021101.1,2,29378116,752236609,5359258,4333116,756569725,718747629
29378116_4333121,CM021101.1,2,29378116,752236609,5359258,4333121,756569730,718747634
29378116_4333146,CM021101.1,2,29378116,752236609,5359258,4333146,756569755,718747659
29378116_4333193,CM021101.1,2,29378116,752236609,5359258,4333193,756569802,718747706
29378116_4333217,CM021101.1,2,29378116,752236609,5359258,4333217,756569826,718747730
29379693_4566288,CM021101.1,2,29379693,752235510,4772497,4566288,756801798,718979702
29379693_4566432,CM021101.1,2,29379693,752235510,4772497,4566432,756801942,718979846
29379693_4566588,CM021101.1,2,29379693,752235510,4772497,4566588,756802098,718980002
29379693_4566690,CM021101.1,2,29379693,752235510,4772497,4566690,756802200,718980104
29369828_74007,CM021101.1,2,29369828,769632309,197710,74007,769706316,731884220
29369828_74027,CM021101.1,2,29369828,769632309,197710,74027,769706336,731884240
29377481_750340,CM021101.1,2,29377481,769630970,3218451,750340,770381310,732559214
29377481_1467789,CM021101.1,2,29377481,769630970,3218451,1467789,771098759,733276663
29377481_1537009,CM021101.1,2,29377481,769630970,3218451,1537009,771167979,733345883
29377481_1923794,CM021101.1,2,29377481,769630970,3218451,1923794,771554764,733732668
29378164_19723,CM021101.1,2,29378164,776780513,1125406,19723,776800236,738978140
29378164_96106,CM021101.1,2,29378164,776780513,1125406,96106,776876619,739054523
29378164_96108,CM021101.1,2,29378164,776780513,1125406,96108,776876621,739054525
29378164_96128,CM021101.1,2,29378164,776780513,1125406,96128,776876641,739054545
29378164_96207,CM021101.1,2,29378164,776780513,1125406,96207,776876720,739054624
29378164_116427,CM021101.1,2,29378164,776780513,1125406,116427,776896940,739074844
29378164_116442,CM021101.1,2,29378164,776780513,1125406,116442,776896955,739074859
29378164_205544,CM021101.1,2,29378164,776780513,1125406,205544,776986057,739163961
29378164_236869,CM021101.1,2,29378164,776780513,1125406,236869,777017382,739195286
29378164_236906,CM021101.1,2,29378164,776780513,1125406,236906,777017419,739195323
29378164_236917,CM021101.1,2,29378164,776780513,1125406,236917,777017430,739195334
29378164_236932,CM021101.1,2,29378164,776780513,1125406,236932,777017445,739195349
29380270_531309,CM021101.1,2,29380270,776780521,938681,531309,777311830,739489734
29380270_876398,CM021101.1,2,29380270,776780521,938681,876398,777656919,739834823
29380270_876400,CM021101.1,2,29380270,776780521,938681,876400,777656921,739834825
29380270_914357,CM021101.1,2,29380270,776780521,938681,914357,777694878,739872782
29380270_914372,CM021101.1,2,29380270,776780521,938681,914372,777694893,739872797
29378164_1044434,CM021101.1,2,29378164,776780513,1125406,1044434,777824947,740002851
29378164_1044448,CM021101.1,2,29378164,776780513,1125406,1044448,777824961,740002865
29378164_1044468,CM021101.1,2,29378164,776780513,1125406,1044468,777824981,740002885
29378164_1044478,CM021101.1,2,29378164,776780513,1125406,1044478,777824991,740002895
29378164_1066622,CM021101.1,2,29378164,776780513,1125406,1066622,777847135,740025039
29378164_1066657,CM021101.1,2,29378164,776780513,1125406,1066657,777847170,740025074
29378164_1116086,CM021101.1,2,29378164,776780513,1125406,1116086,777896599,740074503
29378164_1116164,CM021101.1,2,29378164,776780513,1125406,1116164,777896677,740074581
29360359_80927,CM021101.1,2,29360359,804098111,159024,80927,804179038,766356942
29360359_80933,CM021101.1,2,29360359,804098111,159024,80933,804179044,766356948
29360359_143763,CM021101.1,2,29360359,804098111,159024,143763,804241874,766419778
29360359_143780,CM021101.1,2,29360359,804098111,159024,143780,804241891,766419795
29360359_143788,CM021101.1,2,29360359,804098111,159024,143788,804241899,766419803
29360359_143798,CM021101.1,2,29360359,804098111,159024,143798,804241909,766419813
29360359_143802,CM021101.1,2,29360359,804098111,159024,143802,804241913,766419817
29360359_143828,CM021101.1,2,29360359,804098111,159024,143828,804241939,766419843
29360359_143979,CM021101.1,2,29360359,804098111,159024,143979,804242090,766419994
29360359_143980,CM021101.1,2,29360359,804098111,159024,143980,804242091,766419995
29360359_143997,CM021101.1,2,29360359,804098111,159024,143997,804242108,766420012
29360359_144015,CM021101.1,2,29360359,804098111,159024,144015,804242126,766420030
29360359_144018,CM021101.1,2,29360359,804098111,159024,144018,804242129,766420033
29360359_144030,CM021101.1,2,29360359,804098111,159024,144030,804242141,766420045
29360359_144062,CM021101.1,2,29360359,804098111,159024,144062,804242173,766420077
29360359_144084,CM021101.1,2,29360359,804098111,159024,144084,804242195,766420099
29378132_722281,CM021101.1,2,29378132,804098110,810431,722281,804820391,766998295
29378132_722497,CM021101.1,2,29378132,804098110,810431,722497,804820607,766998511
29379032_513545,CM021101.1,2,29379032,806602523,824039,513545,807116068,769293972
29379032_513550,CM021101.1,2,29379032,806602523,824039,513550,807116073,769293977
29379032_513579,CM021101.1,2,29379032,806602523,824039,513579,807116102,769294006
29379032_513597,CM021101.1,2,29379032,806602523,824039,513597,807116120,769294024
29379032_514023,CM021101.1,2,29379032,806602523,824039,514023,807116546,769294450
29379032_520443,CM021101.1,2,29379032,806602523,824039,520443,807122966,769300870
29379032_571404,CM021101.1,2,29379032,806602523,824039,571404,807173927,769351831
29379032_571411,CM021101.1,2,29379032,806602523,824039,571411,807173934,769351838
29379032_571412,CM021101.1,2,29379032,806602523,824039,571412,807173935,769351839
29377230_776860,CM021101.1,2,29377230,809330146,851179,776860,810107006,772284910
29377230_776897,CM021101.1,2,29377230,809330146,851179,776897,810107043,772284947
29378750_52614,CM021101.1,2,29378750,818739353,2948322,52614,818791967,780969871
29378181_129981,CM021101.1,2,29378181,818731991,1303775,129981,818861972,781039876
29380325_147107,CM021101.1,2,29380325,818731983,4932600,147107,818879090,781056994
29378181_169654,CM021101.1,2,29378181,818731991,1303775,169654,818901645,781079549
29378181_169751,CM021101.1,2,29378181,818731991,1303775,169751,818901742,781079646
29382072_321901,CM021101.1,2,29382072,818731986,1434364,321901,819053887,781231791
29378181_411637,CM021101.1,2,29378181,818731991,1303775,411637,819143628,781321532
29378181_412699,CM021101.1,2,29378181,818731991,1303775,412699,819144690,781322594
29378181_412756,CM021101.1,2,29378181,818731991,1303775,412756,819144747,781322651
29378181_412783,CM021101.1,2,29378181,818731991,1303775,412783,819144774,781322678
29378181_412788,CM021101.1,2,29378181,818731991,1303775,412788,819144779,781322683
29378181_413024,CM021101.1,2,29378181,818731991,1303775,413024,819145015,781322919
29378181_572367,CM021101.1,2,29378181,818731991,1303775,572367,819304358,781482262
29378181_572368,CM021101.1,2,29378181,818731991,1303775,572368,819304359,781482263
29378181_572371,CM021101.1,2,29378181,818731991,1303775,572371,819304362,781482266
29378181_753521,CM021101.1,2,29378181,818731991,1303775,753521,819485512,781663416
29378181_753533,CM021101.1,2,29378181,818731991,1303775,753533,819485524,781663428
29378181_758607,CM021101.1,2,29378181,818731991,1303775,758607,819490598,781668502
29380325_1045500,CM021101.1,2,29380325,818731983,4932600,1045500,819777483,781955387
29379185_1070051,CM021101.1,2,29379185,818731986,13840581,1070051,819802037,781979941
29379185_1070126,CM021101.1,2,29379185,818731986,13840581,1070126,819802112,781980016
29378750_1402549,CM021101.1,2,29378750,818739353,2948322,1402549,820141902,782319806
29381623_2093587,CM021101.1,2,29381623,818731989,2590921,2093587,820825576,783003480
29379185_2380816,CM021101.1,2,29379185,818731986,13840581,2380816,821112802,783290706
29379185_2380823,CM021101.1,2,29379185,818731986,13840581,2380823,821112809,783290713
29379185_2380888,CM021101.1,2,29379185,818731986,13840581,2380888,821112874,783290778
29379185_2380895,CM021101.1,2,29379185,818731986,13840581,2380895,821112881,783290785
29379185_2380897,CM021101.1,2,29379185,818731986,13840581,2380897,821112883,783290787
29379185_2380941,CM021101.1,2,29379185,818731986,13840581,2380941,821112927,783290831
29379185_2380982,CM021101.1,2,29379185,818731986,13840581,2380982,821112968,783290872
29379185_2380989,CM021101.1,2,29379185,818731986,13840581,2380989,821112975,783290879
29379185_2381034,CM021101.1,2,29379185,818731986,13840581,2381034,821113020,783290924
29379185_2381038,CM021101.1,2,29379185,818731986,13840581,2381038,821113024,783290928
29379185_3027576,CM021101.1,2,29379185,818731986,13840581,3027576,821759562,783937466
29379185_3027590,CM021101.1,2,29379185,818731986,13840581,3027590,821759576,783937480
29379185_3027634,CM021101.1,2,29379185,818731986,13840581,3027634,821759620,783937524
29379185_3027769,CM021101.1,2,29379185,818731986,13840581,3027769,821759755,783937659
29380325_3455819,CM021101.1,2,29380325,818731983,4932600,3455819,822187802,784365706
29380325_3484840,CM021101.1,2,29380325,818731983,4932600,3484840,822216823,784394727
29380325_3773416,CM021101.1,2,29380325,818731983,4932600,3773416,822505399,784683303
29380325_3773452,CM021101.1,2,29380325,818731983,4932600,3773452,822505435,784683339
29380325_3773472,CM021101.1,2,29380325,818731983,4932600,3773472,822505455,784683359
29380325_3773511,CM021101.1,2,29380325,818731983,4932600,3773511,822505494,784683398
29380325_3773514,CM021101.1,2,29380325,818731983,4932600,3773514,822505497,784683401
29379185_11259259,CM021101.1,2,29379185,818731986,13840581,11259259,829991245,792169149
29379185_11259291,CM021101.1,2,29379185,818731986,13840581,11259291,829991277,792169181
29379185_11259413,CM021101.1,2,29379185,818731986,13840581,11259413,829991399,792169303
29379185_11259585,CM021101.1,2,29379185,818731986,13840581,11259585,829991571,792169475
29379185_11259647,CM021101.1,2,29379185,818731986,13840581,11259647,829991633,792169537
29379185_11273731,CM021101.1,2,29379185,818731986,13840581,11273731,830005717,792183621
29379185_11273782,CM021101.1,2,29379185,818731986,13840581,11273782,830005768,792183672
29379185_11333969,CM021101.1,2,29379185,818731986,13840581,11333969,830065955,792243859
29379185_11334060,CM021101.1,2,29379185,818731986,13840581,11334060,830066046,792243950
29379185_11334104,CM021101.1,2,29379185,818731986,13840581,11334104,830066090,792243994
29379185_11334105,CM021101.1,2,29379185,818731986,13840581,11334105,830066091,792243995
29379185_11334106,CM021101.1,2,29379185,818731986,13840581,11334106,830066092,792243996
29379185_11334127,CM021101.1,2,29379185,818731986,13840581,11334127,830066113,792244017
29379185_11524035,CM021101.1,2,29379185,818731986,13840581,11524035,830256021,792433925
29379185_12121295,CM021101.1,2,29379185,818731986,13840581,12121295,830853281,793031185
29379185_12663959,CM021101.1,2,29379185,818731986,13840581,12663959,831395945,793573849
28893556_2532,CM021101.1,2,28893556,872616679,9285,2532,872619211,834797115
29339708_27940,CM021102.1,3,29339708,3150111,488731,27940,3178051,27940
29339708_28008,CM021102.1,3,29339708,3150111,488731,28008,3178119,28008
29339708_28509,CM021102.1,3,29339708,3150111,488731,28509,3178620,28509
29379141_328717,CM021102.1,3,29379141,3150112,1487803,328717,3478829,328718
29379141_345562,CM021102.1,3,29379141,3150112,1487803,345562,3495674,345563
29379142_404912,CM021102.1,3,29379142,3150111,1086108,404912,3555023,404912
29379141_622359,CM021102.1,3,29379141,3150112,1487803,622359,3772471,622360
29379141_622384,CM021102.1,3,29379141,3150112,1487803,622384,3772496,622385
293657051_104673,CM021102.1,3,293657051,6414168,105469,104673,6518841,3368730
293657051_104734,CM021102.1,3,293657051,6414168,105469,104734,6518902,3368791
293657051_104878,CM021102.1,3,293657051,6414168,105469,104878,6519046,3368935
29381637_359610,CM021102.1,3,29381637,6413471,1273091,359610,6773081,3622970
29377668_27955,CM021102.1,3,29377668,6804600,1108499,27955,6832555,3682444
29380924_30665,CM021102.1,3,29380924,6804599,346542,30665,6835264,3685153
29380924_31034,CM021102.1,3,29380924,6804599,346542,31034,6835633,3685522
29377668_54862,CM021102.1,3,29377668,6804600,1108499,54862,6859462,3709351
29377668_178732,CM021102.1,3,29377668,6804600,1108499,178732,6983332,3833221
29377668_206853,CM021102.1,3,29377668,6804600,1108499,206853,7011453,3861342
29377668_206923,CM021102.1,3,29377668,6804600,1108499,206923,7011523,3861412
29377668_209152,CM021102.1,3,29377668,6804600,1108499,209152,7013752,3863641
29377668_502827,CM021102.1,3,29377668,6804600,1108499,502827,7307427,4157316
29377668_502891,CM021102.1,3,29377668,6804600,1108499,502891,7307491,4157380
29377480_833167,CM021102.1,3,29377480,6804611,4046048,833167,7637778,4487667
29377480_833185,CM021102.1,3,29377480,6804611,4046048,833185,7637796,4487685
29377480_833193,CM021102.1,3,29377480,6804611,4046048,833193,7637804,4487693
29377480_833194,CM021102.1,3,29377480,6804611,4046048,833194,7637805,4487694
29377480_833221,CM021102.1,3,29377480,6804611,4046048,833221,7637832,4487721
29377480_833226,CM021102.1,3,29377480,6804611,4046048,833226,7637837,4487726
29381637_1269623,CM021102.1,3,29381637,6413471,1273091,1269623,7683094,4532983
29381637_1269626,CM021102.1,3,29381637,6413471,1273091,1269626,7683097,4532986
29381637_1269639,CM021102.1,3,29381637,6413471,1273091,1269639,7683110,4532999
29342825_33547,CM021102.1,3,29342825,17199859,40854,33547,17233406,14083295
29377500_126718,CM021102.1,3,29377500,17193633,1489054,126718,17320351,14170240
29378227_229690,CM021102.1,3,29378227,17194416,3847910,229690,17424106,14273995
29378227_229748,CM021102.1,3,29378227,17194416,3847910,229748,17424164,14274053
29381236_286196,CM021102.1,3,29381236,17193638,5954024,286196,17479834,14329723
29381236_286220,CM021102.1,3,29381236,17193638,5954024,286220,17479858,14329747
29381236_286225,CM021102.1,3,29381236,17193638,5954024,286225,17479863,14329752
29379003_313455,CM021102.1,3,29379003,17194148,1605752,313455,17507603,14357492
29379003_313481,CM021102.1,3,29379003,17194148,1605752,313481,17507629,14357518
29381236_362240,CM021102.1,3,29381236,17193638,5954024,362240,17555878,14405767
29378243_439664,CM021102.1,3,29378243,17193638,2319192,439664,17633302,14483191
29378243_439708,CM021102.1,3,29378243,17193638,2319192,439708,17633346,14483235
29378243_439772,CM021102.1,3,29378243,17193638,2319192,439772,17633410,14483299
29377500_928546,CM021102.1,3,29377500,17193633,1489054,928546,18122179,14972068
29381236_969825,CM021102.1,3,29381236,17193638,5954024,969825,18163463,15013352
29381236_1505408,CM021102.1,3,29381236,17193638,5954024,1505408,18699046,15548935
29381236_2454345,CM021102.1,3,29381236,17193638,5954024,2454345,19647983,16497872
29381236_2771359,CM021102.1,3,29381236,17193638,5954024,2771359,19964997,16814886
29381236_3222903,CM021102.1,3,29381236,17193638,5954024,3222903,20416541,17266430
29378227_3313193,CM021102.1,3,29378227,17194416,3847910,3313193,20507609,17357498
29378227_3313442,CM021102.1,3,29378227,17194416,3847910,3313442,20507858,17357747
29378227_3357430,CM021102.1,3,29378227,17194416,3847910,3357430,20551846,17401735
29381236_4615921,CM021102.1,3,29381236,17193638,5954024,4615921,21809559,18659448
29381236_4615987,CM021102.1,3,29381236,17193638,5954024,4615987,21809625,18659514
29357246_2566,CM021102.1,3,29357246,25266791,28110,2566,25269357,22119246
29381515_59707,CM021102.1,3,29381515,45255495,88904,59707,45315202,42165091
29381515_59785,CM021102.1,3,29381515,45255495,88904,59785,45315280,42165169
28552192_3502,CM021102.1,3,28552192,50580091,6069,3502,50583593,47433482
29381207_873842,CM021102.1,3,29381207,69124138,1006136,873842,69997980,66847869
29343371_14617,CM021102.1,3,29343371,76980851,14720,14617,76995468,73845357
29343371_14626,CM021102.1,3,29343371,76980851,14720,14626,76995477,73845366
29343371_14641,CM021102.1,3,29343371,76980851,14720,14641,76995492,73845381
29377253_448044,CM021102.1,3,29377253,76827543,1819675,448044,77275587,74125476
29377253_525266,CM021102.1,3,29377253,76827543,1819675,525266,77352809,74202698
293681531_3365,CM021102.1,3,293681531,81402028,8605,3365,81405393,78255282
29381641_24878,CM021102.1,3,29381641,86623202,167268,24878,86648080,83497969
29381641_24882,CM021102.1,3,29381641,86623202,167268,24882,86648084,83497973
29381641_24901,CM021102.1,3,29381641,86623202,167268,24901,86648103,83497992
29381641_24909,CM021102.1,3,29381641,86623202,167268,24909,86648111,83498000
29381641_24927,CM021102.1,3,29381641,86623202,167268,24927,86648129,83498018
29381641_24932,CM021102.1,3,29381641,86623202,167268,24932,86648134,83498023
29381641_24949,CM021102.1,3,29381641,86623202,167268,24949,86648151,83498040
29381641_24955,CM021102.1,3,29381641,86623202,167268,24955,86648157,83498046
29381641_24957,CM021102.1,3,29381641,86623202,167268,24957,86648159,83498048
29381641_24968,CM021102.1,3,29381641,86623202,167268,24968,86648170,83498059
29381641_24978,CM021102.1,3,29381641,86623202,167268,24978,86648180,83498069
29381641_24985,CM021102.1,3,29381641,86623202,167268,24985,86648187,83498076
29381641_25011,CM021102.1,3,29381641,86623202,167268,25011,86648213,83498102
29378736_39398,CM021102.1,3,29378736,86616985,3948382,39398,86656383,83506272
29378736_39442,CM021102.1,3,29378736,86616985,3948382,39442,86656427,83506316
29378736_39489,CM021102.1,3,29378736,86616985,3948382,39489,86656474,83506363
29378736_82864,CM021102.1,3,29378736,86616985,3948382,82864,86699849,83549738
29378736_82878,CM021102.1,3,29378736,86616985,3948382,82878,86699863,83549752
29378736_108152,CM021102.1,3,29378736,86616985,3948382,108152,86725137,83575026
29336574_123236,CM021102.1,3,29336574,86621601,428322,123236,86744837,83594726
29378771_155153,CM021102.1,3,29378771,86616983,4016617,155153,86772136,83622025
29378771_155212,CM021102.1,3,29378771,86616983,4016617,155212,86772195,83622084
29378771_155447,CM021102.1,3,29378771,86616983,4016617,155447,86772430,83622319
29378771_155453,CM021102.1,3,29378771,86616983,4016617,155453,86772436,83622325
29378771_155470,CM021102.1,3,29378771,86616983,4016617,155470,86772453,83622342
29378771_155477,CM021102.1,3,29378771,86616983,4016617,155477,86772460,83622349
29378736_178137,CM021102.1,3,29378736,86616985,3948382,178137,86795122,83645011
29378736_178152,CM021102.1,3,29378736,86616985,3948382,178152,86795137,83645026
29378736_178153,CM021102.1,3,29378736,86616985,3948382,178153,86795138,83645027
29378736_178171,CM021102.1,3,29378736,86616985,3948382,178171,86795156,83645045
29378736_178201,CM021102.1,3,29378736,86616985,3948382,178201,86795186,83645075
29378736_179837,CM021102.1,3,29378736,86616985,3948382,179837,86796822,83646711
29378736_179946,CM021102.1,3,29378736,86616985,3948382,179946,86796931,83646820
29378736_180003,CM021102.1,3,29378736,86616985,3948382,180003,86796988,83646877
29378736_180060,CM021102.1,3,29378736,86616985,3948382,180060,86797045,83646934
29378736_180076,CM021102.1,3,29378736,86616985,3948382,180076,86797061,83646950
29378736_180089,CM021102.1,3,29378736,86616985,3948382,180089,86797074,83646963
29378771_191661,CM021102.1,3,29378771,86616983,4016617,191661,86808644,83658533
29378771_191827,CM021102.1,3,29378771,86616983,4016617,191827,86808810,83658699
29378572_195064,CM021102.1,3,29378572,86616984,1526949,195064,86812048,83661937
29378771_198010,CM021102.1,3,29378771,86616983,4016617,198010,86814993,83664882
29378771_198054,CM021102.1,3,29378771,86616983,4016617,198054,86815037,83664926
29378771_198112,CM021102.1,3,29378771,86616983,4016617,198112,86815095,83664984
29378771_198124,CM021102.1,3,29378771,86616983,4016617,198124,86815107,83664996
29378771_198179,CM021102.1,3,29378771,86616983,4016617,198179,86815162,83665051
29378771_198400,CM021102.1,3,29378771,86616983,4016617,198400,86815383,83665272
29378771_198430,CM021102.1,3,29378771,86616983,4016617,198430,86815413,83665302
29378771_198435,CM021102.1,3,29378771,86616983,4016617,198435,86815418,83665307
29380837_603102,CM021102.1,3,29380837,86616983,1058749,603102,87220085,84069974
29380837_604664,CM021102.1,3,29380837,86616983,1058749,604664,87221647,84071536
29380837_604693,CM021102.1,3,29380837,86616983,1058749,604693,87221676,84071565
29380837_604742,CM021102.1,3,29380837,86616983,1058749,604742,87221725,84071614
29380837_604754,CM021102.1,3,29380837,86616983,1058749,604754,87221737,84071626
29380837_604755,CM021102.1,3,29380837,86616983,1058749,604755,87221738,84071627
29378572_614428,CM021102.1,3,29378572,86616984,1526949,614428,87231412,84081301
29379393_615914,CM021102.1,3,29379393,86618380,1308390,615914,87234294,84084183
29377845_612758,CM021102.1,3,29377845,86623681,1569801,612758,87236439,84086328
29380837_663211,CM021102.1,3,29380837,86616983,1058749,663211,87280194,84130083
29380837_663238,CM021102.1,3,29380837,86616983,1058749,663238,87280221,84130110
29380837_663303,CM021102.1,3,29380837,86616983,1058749,663303,87280286,84130175
29380837_665276,CM021102.1,3,29380837,86616983,1058749,665276,87282259,84132148
29378546_761467,CM021102.1,3,29378546,86622613,1678355,761467,87384080,84233969
29378546_761536,CM021102.1,3,29378546,86622613,1678355,761536,87384149,84234038
29381248_882544,CM021102.1,3,29381248,86621636,3039551,882544,87504180,84354069
29381248_882737,CM021102.1,3,29381248,86621636,3039551,882737,87504373,84354262
29381248_925391,CM021102.1,3,29381248,86621636,3039551,925391,87547027,84396916
29381248_925511,CM021102.1,3,29381248,86621636,3039551,925511,87547147,84397036
29379393_948593,CM021102.1,3,29379393,86618380,1308390,948593,87566973,84416862
29378546_1050321,CM021102.1,3,29378546,86622613,1678355,1050321,87672934,84522823
29378546_1050374,CM021102.1,3,29378546,86622613,1678355,1050374,87672987,84522876
29378546_1050540,CM021102.1,3,29378546,86622613,1678355,1050540,87673153,84523042
29378546_1050591,CM021102.1,3,29378546,86622613,1678355,1050591,87673204,84523093
29378546_1054688,CM021102.1,3,29378546,86622613,1678355,1054688,87677301,84527190
29378546_1054705,CM021102.1,3,29378546,86622613,1678355,1054705,87677318,84527207
29379137_1189803,CM021102.1,3,29379137,86616985,4592655,1189803,87806788,84656677
29379137_1189874,CM021102.1,3,29379137,86616985,4592655,1189874,87806859,84656748
29378546_1210773,CM021102.1,3,29378546,86622613,1678355,1210773,87833386,84683275
29378546_1210780,CM021102.1,3,29378546,86622613,1678355,1210780,87833393,84683282
29378546_1210811,CM021102.1,3,29378546,86622613,1678355,1210811,87833424,84683313
29378771_1235245,CM021102.1,3,29378771,86616983,4016617,1235245,87852228,84702117
29378546_1262308,CM021102.1,3,29378546,86622613,1678355,1262308,87884921,84734810
29378546_1262309,CM021102.1,3,29378546,86622613,1678355,1262309,87884922,84734811
29378546_1262312,CM021102.1,3,29378546,86622613,1678355,1262312,87884925,84734814
29378546_1262349,CM021102.1,3,29378546,86622613,1678355,1262349,87884962,84734851
29378546_1269456,CM021102.1,3,29378546,86622613,1678355,1269456,87892069,84741958
29378546_1269464,CM021102.1,3,29378546,86622613,1678355,1269464,87892077,84741966
29378546_1269559,CM021102.1,3,29378546,86622613,1678355,1269559,87892172,84742061
29378546_1269614,CM021102.1,3,29378546,86622613,1678355,1269614,87892227,84742116
29378546_1269620,CM021102.1,3,29378546,86622613,1678355,1269620,87892233,84742122
29378546_1269994,CM021102.1,3,29378546,86622613,1678355,1269994,87892607,84742496
29378546_1270001,CM021102.1,3,29378546,86622613,1678355,1270001,87892614,84742503
29378546_1270056,CM021102.1,3,29378546,86622613,1678355,1270056,87892669,84742558
29378572_1354063,CM021102.1,3,29378572,86616984,1526949,1354063,87971047,84820936
29378572_1354150,CM021102.1,3,29378572,86616984,1526949,1354150,87971134,84821023
29379176_1477064,CM021102.1,3,29379176,86620416,3575684,1477064,88097480,84947369
29379176_1477138,CM021102.1,3,29379176,86620416,3575684,1477138,88097554,84947443
29379176_1477143,CM021102.1,3,29379176,86620416,3575684,1477143,88097559,84947448
29379137_1588571,CM021102.1,3,29379137,86616985,4592655,1588571,88205556,85055445
29379137_1588629,CM021102.1,3,29379137,86616985,4592655,1588629,88205614,85055503
29379137_1588640,CM021102.1,3,29379137,86616985,4592655,1588640,88205625,85055514
29379137_1588673,CM021102.1,3,29379137,86616985,4592655,1588673,88205658,85055547
29381248_1600770,CM021102.1,3,29381248,86621636,3039551,1600770,88222406,85072295
29381248_1600790,CM021102.1,3,29381248,86621636,3039551,1600790,88222426,85072315
29381248_1600807,CM021102.1,3,29381248,86621636,3039551,1600807,88222443,85072332
29381248_1600841,CM021102.1,3,29381248,86621636,3039551,1600841,88222477,85072366
29378736_1629390,CM021102.1,3,29378736,86616985,3948382,1629390,88246375,85096264
29378736_1629402,CM021102.1,3,29378736,86616985,3948382,1629402,88246387,85096276
29378736_1629487,CM021102.1,3,29378736,86616985,3948382,1629487,88246472,85096361
29381248_1755519,CM021102.1,3,29381248,86621636,3039551,1755519,88377155,85227044
29380577_2172635,CM021102.1,3,29380577,86621191,2417929,2172635,88793826,85643715
29378736_2484160,CM021102.1,3,29378736,86616985,3948382,2484160,89101145,85951034
29378736_2484163,CM021102.1,3,29378736,86616985,3948382,2484163,89101148,85951037
29378736_2484172,CM021102.1,3,29378736,86616985,3948382,2484172,89101157,85951046
29378736_2484186,CM021102.1,3,29378736,86616985,3948382,2484186,89101171,85951060
29378736_2484190,CM021102.1,3,29378736,86616985,3948382,2484190,89101175,85951064
29378736_2484223,CM021102.1,3,29378736,86616985,3948382,2484223,89101208,85951097
29378736_2511759,CM021102.1,3,29378736,86616985,3948382,2511759,89128744,85978633
29378736_2511778,CM021102.1,3,29378736,86616985,3948382,2511778,89128763,85978652
29378736_2511883,CM021102.1,3,29378736,86616985,3948382,2511883,89128868,85978757
29378736_2512280,CM021102.1,3,29378736,86616985,3948382,2512280,89129265,85979154
29378736_2512346,CM021102.1,3,29378736,86616985,3948382,2512346,89129331,85979220
29377119_2598068,CM021102.1,3,29377119,86616985,6245033,2598068,89215053,86064942
29377119_2621444,CM021102.1,3,29377119,86616985,6245033,2621444,89238429,86088318
29378736_2634987,CM021102.1,3,29378736,86616985,3948382,2634987,89251972,86101861
29378736_2635080,CM021102.1,3,29378736,86616985,3948382,2635080,89252065,86101954
29378736_2635208,CM021102.1,3,29378736,86616985,3948382,2635208,89252193,86102082
29378736_2635227,CM021102.1,3,29378736,86616985,3948382,2635227,89252212,86102101
29378736_2635338,CM021102.1,3,29378736,86616985,3948382,2635338,89252323,86102212
29378736_2635345,CM021102.1,3,29378736,86616985,3948382,2635345,89252330,86102219
29378736_2635365,CM021102.1,3,29378736,86616985,3948382,2635365,89252350,86102239
29377119_2972084,CM021102.1,3,29377119,86616985,6245033,2972084,89589069,86438958
29377119_2972433,CM021102.1,3,29377119,86616985,6245033,2972433,89589418,86439307
29377119_2972438,CM021102.1,3,29377119,86616985,6245033,2972438,89589423,86439312
29377119_2972453,CM021102.1,3,29377119,86616985,6245033,2972453,89589438,86439327
29379137_3194028,CM021102.1,3,29379137,86616985,4592655,3194028,89811013,86660902
29379137_3194048,CM021102.1,3,29379137,86616985,4592655,3194048,89811033,86660922
29379137_3194067,CM021102.1,3,29379137,86616985,4592655,3194067,89811052,86660941
29378771_3766791,CM021102.1,3,29378771,86616983,4016617,3766791,90383774,87233663
29378771_4008454,CM021102.1,3,29378771,86616983,4016617,4008454,90625437,87475326
29378771_4008462,CM021102.1,3,29378771,86616983,4016617,4008462,90625445,87475334
29378771_4008465,CM021102.1,3,29378771,86616983,4016617,4008465,90625448,87475337
29378771_4008490,CM021102.1,3,29378771,86616983,4016617,4008490,90625473,87475362
29378771_4008495,CM021102.1,3,29378771,86616983,4016617,4008495,90625478,87475367
29378771_4008498,CM021102.1,3,29378771,86616983,4016617,4008498,90625481,87475370
29378771_4008502,CM021102.1,3,29378771,86616983,4016617,4008502,90625485,87475374
29377119_4708030,CM021102.1,3,29377119,86616985,6245033,4708030,91325015,88174904
29377119_4708078,CM021102.1,3,29377119,86616985,6245033,4708078,91325063,88174952
29377119_4708151,CM021102.1,3,29377119,86616985,6245033,4708151,91325136,88175025
29377119_4708156,CM021102.1,3,29377119,86616985,6245033,4708156,91325141,88175030
29355979_198656,CM021102.1,3,29355979,96045350,418571,198656,96244006,93093895
29379531_846019,CM021102.1,3,29379531,96044287,1876491,846019,96890306,93740195
29379531_846069,CM021102.1,3,29379531,96044287,1876491,846069,96890356,93740245
29379531_846095,CM021102.1,3,29379531,96044287,1876491,846095,96890382,93740271
29379531_846102,CM021102.1,3,29379531,96044287,1876491,846102,96890389,93740278
29365211_2536,CM021102.1,3,29365211,97041951,12107,2536,97044487,93894376
29380740_286306,CM021102.1,3,29380740,97041955,302369,286306,97328261,94178150
29380740_286385,CM021102.1,3,29380740,97041955,302369,286385,97328340,94178229
29346865_17684,CM021102.1,3,29346865,98712379,94202,17684,98730063,95579952
29346865_17798,CM021102.1,3,29346865,98712379,94202,17798,98730177,95580066
29381524_151647,CM021102.1,3,29381524,98712383,1079228,151647,98864030,95713919
29372678_205306,CM021102.1,3,29372678,98712387,207896,205306,98917693,95767582
29372678_205311,CM021102.1,3,29372678,98712387,207896,205311,98917698,95767587
29372678_205338,CM021102.1,3,29372678,98712387,207896,205338,98917725,95767614
29381524_290157,CM021102.1,3,29381524,98712383,1079228,290157,99002540,95852429
29381524_290203,CM021102.1,3,29381524,98712383,1079228,290203,99002586,95852475
29381524_388328,CM021102.1,3,29381524,98712383,1079228,388328,99100711,95950600
29378663_392503,CM021102.1,3,29378663,98712384,516846,392503,99104887,95954776
29381524_481836,CM021102.1,3,29381524,98712383,1079228,481836,99194219,96044108
29381524_481859,CM021102.1,3,29381524,98712383,1079228,481859,99194242,96044131
29381524_481883,CM021102.1,3,29381524,98712383,1079228,481883,99194266,96044155
29381524_481902,CM021102.1,3,29381524,98712383,1079228,481902,99194285,96044174
29381524_482036,CM021102.1,3,29381524,98712383,1079228,482036,99194419,96044308
29379586_506113,CM021102.1,3,29379586,98712384,2150271,506113,99218497,96068386
29379586_506504,CM021102.1,3,29379586,98712384,2150271,506504,99218888,96068777
29381524_516383,CM021102.1,3,29381524,98712383,1079228,516383,99228766,96078655
29381524_516406,CM021102.1,3,29381524,98712383,1079228,516406,99228789,96078678
29381524_516685,CM021102.1,3,29381524,98712383,1079228,516685,99229068,96078957
29379586_519941,CM021102.1,3,29379586,98712384,2150271,519941,99232325,96082214
29379586_520026,CM021102.1,3,29379586,98712384,2150271,520026,99232410,96082299
29379586_548258,CM021102.1,3,29379586,98712384,2150271,548258,99260642,96110531
29379586_548305,CM021102.1,3,29379586,98712384,2150271,548305,99260689,96110578
29379586_548316,CM021102.1,3,29379586,98712384,2150271,548316,99260700,96110589
29379586_602790,CM021102.1,3,29379586,98712384,2150271,602790,99315174,96165063
29379586_603064,CM021102.1,3,29379586,98712384,2150271,603064,99315448,96165337
29377990_640372,CM021102.1,3,29377990,98712384,2450353,640372,99352756,96202645
29377990_640423,CM021102.1,3,29377990,98712384,2450353,640423,99352807,96202696
29377990_640435,CM021102.1,3,29377990,98712384,2450353,640435,99352819,96202708
29377990_640457,CM021102.1,3,29377990,98712384,2450353,640457,99352841,96202730
29377990_640476,CM021102.1,3,29377990,98712384,2450353,640476,99352860,96202749
29381524_663096,CM021102.1,3,29381524,98712383,1079228,663096,99375479,96225368
29381524_663131,CM021102.1,3,29381524,98712383,1079228,663131,99375514,96225403
29381524_663150,CM021102.1,3,29381524,98712383,1079228,663150,99375533,96225422
29381524_663156,CM021102.1,3,29381524,98712383,1079228,663156,99375539,96225428
29381524_697208,CM021102.1,3,29381524,98712383,1079228,697208,99409591,96259480
29381524_697242,CM021102.1,3,29381524,98712383,1079228,697242,99409625,96259514
29381524_697274,CM021102.1,3,29381524,98712383,1079228,697274,99409657,96259546
29377146_704216,CM021102.1,3,29377146,98712384,1765033,704216,99416600,96266489
29381524_712985,CM021102.1,3,29381524,98712383,1079228,712985,99425368,96275257
29381524_713019,CM021102.1,3,29381524,98712383,1079228,713019,99425402,96275291
29381524_913835,CM021102.1,3,29381524,98712383,1079228,913835,99626218,96476107
29381524_917990,CM021102.1,3,29381524,98712383,1079228,917990,99630373,96480262
29381524_919258,CM021102.1,3,29381524,98712383,1079228,919258,99631641,96481530
29381524_919265,CM021102.1,3,29381524,98712383,1079228,919265,99631648,96481537
29381524_943631,CM021102.1,3,29381524,98712383,1079228,943631,99656014,96505903
29381524_943689,CM021102.1,3,29381524,98712383,1079228,943689,99656072,96505961
29381524_955896,CM021102.1,3,29381524,98712383,1079228,955896,99668279,96518168
29381524_988221,CM021102.1,3,29381524,98712383,1079228,988221,99700604,96550493
29381524_1020745,CM021102.1,3,29381524,98712383,1079228,1020745,99733128,96583017
29381524_1021684,CM021102.1,3,29381524,98712383,1079228,1021684,99734067,96583956
29377146_1371254,CM021102.1,3,29377146,98712384,1765033,1371254,100083638,96933527
29377146_1675401,CM021102.1,3,29377146,98712384,1765033,1675401,100387785,97237674
29379586_1927403,CM021102.1,3,29379586,98712384,2150271,1927403,100639787,97489676
29377990_2437601,CM021102.1,3,29377990,98712384,2450353,2437601,101149985,97999874
29377112_284423,CM021102.1,3,29377112,104381200,1359374,284423,104665623,101515512
29377112_284458,CM021102.1,3,29377112,104381200,1359374,284458,104665658,101515547
29377112_285005,CM021102.1,3,29377112,104381200,1359374,285005,104666205,101516094
29377112_285022,CM021102.1,3,29377112,104381200,1359374,285022,104666222,101516111
29377112_285092,CM021102.1,3,29377112,104381200,1359374,285092,104666292,101516181
29377112_285094,CM021102.1,3,29377112,104381200,1359374,285094,104666294,101516183
29377112_285137,CM021102.1,3,29377112,104381200,1359374,285137,104666337,101516226
29377112_285149,CM021102.1,3,29377112,104381200,1359374,285149,104666349,101516238
29377112_285153,CM021102.1,3,29377112,104381200,1359374,285153,104666353,101516242
29377112_285166,CM021102.1,3,29377112,104381200,1359374,285166,104666366,101516255
29377112_285226,CM021102.1,3,29377112,104381200,1359374,285226,104666426,101516315
29377112_285234,CM021102.1,3,29377112,104381200,1359374,285234,104666434,101516323
29377112_285235,CM021102.1,3,29377112,104381200,1359374,285235,104666435,101516324
29377112_409128,CM021102.1,3,29377112,104381200,1359374,409128,104790328,101640217
29377112_410905,CM021102.1,3,29377112,104381200,1359374,410905,104792105,101641994
29378257_480714,CM021102.1,3,29378257,104381801,1257506,480714,104862515,101712404
29378257_480801,CM021102.1,3,29378257,104381801,1257506,480801,104862602,101712491
29378257_480814,CM021102.1,3,29378257,104381801,1257506,480814,104862615,101712504
29378257_480832,CM021102.1,3,29378257,104381801,1257506,480832,104862633,101712522
29378257_480856,CM021102.1,3,29378257,104381801,1257506,480856,104862657,101712546
29377112_525872,CM021102.1,3,29377112,104381200,1359374,525872,104907072,101756961
29377112_525890,CM021102.1,3,29377112,104381200,1359374,525890,104907090,101756979
29377112_525897,CM021102.1,3,29377112,104381200,1359374,525897,104907097,101756986
29377112_526027,CM021102.1,3,29377112,104381200,1359374,526027,104907227,101757116
29378257_527217,CM021102.1,3,29378257,104381801,1257506,527217,104909018,101758907
29377533_543824,CM021102.1,3,29377533,104381883,1076172,543824,104925707,101775596
29377533_546333,CM021102.1,3,29377533,104381883,1076172,546333,104928216,101778105
29377533_546349,CM021102.1,3,29377533,104381883,1076172,546349,104928232,101778121
29377533_588172,CM021102.1,3,29377533,104381883,1076172,588172,104970055,101819944
29377112_1279323,CM021102.1,3,29377112,104381200,1359374,1279323,105660523,102510412
29377112_1279359,CM021102.1,3,29377112,104381200,1359374,1279359,105660559,102510448
29377112_1279386,CM021102.1,3,29377112,104381200,1359374,1279386,105660586,102510475
29377112_1325314,CM021102.1,3,29377112,104381200,1359374,1325314,105706514,102556403
29377112_1325706,CM021102.1,3,29377112,104381200,1359374,1325706,105706906,102556795
29377112_1325760,CM021102.1,3,29377112,104381200,1359374,1325760,105706960,102556849
29377112_1325761,CM021102.1,3,29377112,104381200,1359374,1325761,105706961,102556850
29377112_1325796,CM021102.1,3,29377112,104381200,1359374,1325796,105706996,102556885
29377112_1325819,CM021102.1,3,29377112,104381200,1359374,1325819,105707019,102556908
29377112_1325822,CM021102.1,3,29377112,104381200,1359374,1325822,105707022,102556911
29377112_1325833,CM021102.1,3,29377112,104381200,1359374,1325833,105707033,102556922
29380521_1830255,CM021102.1,3,29380521,104383428,2056365,1830255,106213683,103063572
29358915_16798,CM021102.1,3,29358915,120147397,97366,16798,120164195,117014084
29378030_17485,CM021102.1,3,29378030,125835204,113425,17485,125852689,122702578
29378030_17577,CM021102.1,3,29378030,125835204,113425,17577,125852781,122702670
29378030_17585,CM021102.1,3,29378030,125835204,113425,17585,125852789,122702678
29378030_17612,CM021102.1,3,29378030,125835204,113425,17612,125852816,122702705
29379547_108979,CM021102.1,3,29379547,125828987,1180791,108979,125937966,122787855
29379547_108983,CM021102.1,3,29379547,125828987,1180791,108983,125937970,122787859
29379547_109002,CM021102.1,3,29379547,125828987,1180791,109002,125937989,122787878
29379547_109007,CM021102.1,3,29379547,125828987,1180791,109007,125937994,122787883
29379547_109058,CM021102.1,3,29379547,125828987,1180791,109058,125938045,122787934
29379547_109060,CM021102.1,3,29379547,125828987,1180791,109060,125938047,122787936
29378583_194162,CM021102.1,3,29378583,125828987,263065,194162,126023149,122873038
29378583_194220,CM021102.1,3,29378583,125828987,263065,194220,126023207,122873096
29378616_195019,CM021102.1,3,29378616,125831379,980263,195019,126026398,122876287
29378616_195636,CM021102.1,3,29378616,125831379,980263,195636,126027015,122876904
29377469_229265,CM021102.1,3,29377469,125834194,332548,229265,126063459,122913348
29377469_229266,CM021102.1,3,29377469,125834194,332548,229266,126063460,122913349
29377469_229295,CM021102.1,3,29377469,125834194,332548,229295,126063489,122913378
29377469_229322,CM021102.1,3,29377469,125834194,332548,229322,126063516,122913405
29380207_238943,CM021102.1,3,29380207,125831390,1218524,238943,126070333,122920222
29380207_239052,CM021102.1,3,29380207,125831390,1218524,239052,126070442,122920331
29380207_239132,CM021102.1,3,29380207,125831390,1218524,239132,126070522,122920411
29378320_241015,CM021102.1,3,29378320,125834307,2082022,241015,126075322,122925211
29379620_352416,CM021102.1,3,29379620,125828987,817322,352416,126181403,123031292
29379620_352438,CM021102.1,3,29379620,125828987,817322,352438,126181425,123031314
29380916_357500,CM021102.1,3,29380916,125830963,2414875,357500,126188463,123038352
29380916_358201,CM021102.1,3,29380916,125830963,2414875,358201,126189164,123039053
29380916_358217,CM021102.1,3,29380916,125830963,2414875,358217,126189180,123039069
29380916_411564,CM021102.1,3,29380916,125830963,2414875,411564,126242527,123092416
29380916_411621,CM021102.1,3,29380916,125830963,2414875,411621,126242584,123092473
29380916_411622,CM021102.1,3,29380916,125830963,2414875,411622,126242585,123092474
29380167_423637,CM021102.1,3,29380167,125828982,3113460,423637,126252619,123102508
29378320_482797,CM021102.1,3,29378320,125834307,2082022,482797,126317104,123166993
29378320_482852,CM021102.1,3,29378320,125834307,2082022,482852,126317159,123167048
29380167_565544,CM021102.1,3,29380167,125828982,3113460,565544,126394526,123244415
29378320_649059,CM021102.1,3,29378320,125834307,2082022,649059,126483366,123333255
29380916_778268,CM021102.1,3,29380916,125830963,2414875,778268,126609231,123459120
29381547_886847,CM021102.1,3,29381547,125831852,3202559,886847,126718699,123568588
29380167_1420863,CM021102.1,3,29380167,125828982,3113460,1420863,127249845,124099734
29380167_1422163,CM021102.1,3,29380167,125828982,3113460,1422163,127251145,124101034
29380167_1422173,CM021102.1,3,29380167,125828982,3113460,1422173,127251155,124101044
29380167_1422216,CM021102.1,3,29380167,125828982,3113460,1422216,127251198,124101087
29380167_1422263,CM021102.1,3,29380167,125828982,3113460,1422263,127251245,124101134
29380167_1422297,CM021102.1,3,29380167,125828982,3113460,1422297,127251279,124101168
29380167_1424406,CM021102.1,3,29380167,125828982,3113460,1424406,127253388,124103277
29380167_1424409,CM021102.1,3,29380167,125828982,3113460,1424409,127253391,124103280
29380167_1424423,CM021102.1,3,29380167,125828982,3113460,1424423,127253405,124103294
29380167_1968120,CM021102.1,3,29380167,125828982,3113460,1968120,127797102,124646991
29380167_1968159,CM021102.1,3,29380167,125828982,3113460,1968159,127797141,124647030
29380167_1968210,CM021102.1,3,29380167,125828982,3113460,1968210,127797192,124647081
29380167_1968245,CM021102.1,3,29380167,125828982,3113460,1968245,127797227,124647116
29380167_1997157,CM021102.1,3,29380167,125828982,3113460,1997157,127826139,124676028
29380167_1997208,CM021102.1,3,29380167,125828982,3113460,1997208,127826190,124676079
29380167_1997247,CM021102.1,3,29380167,125828982,3113460,1997247,127826229,124676118
29380167_1997707,CM021102.1,3,29380167,125828982,3113460,1997707,127826689,124676578
29377179_256111,CM021102.1,3,29377179,152900430,1104509,256111,153156541,150006430
29377179_256119,CM021102.1,3,29377179,152900430,1104509,256119,153156549,150006438
29377179_256157,CM021102.1,3,29377179,152900430,1104509,256157,153156587,150006476
29377179_256168,CM021102.1,3,29377179,152900430,1104509,256168,153156598,150006487
29377179_513871,CM021102.1,3,29377179,152900430,1104509,513871,153414301,150264190
29377179_963790,CM021102.1,3,29377179,152900430,1104509,963790,153864220,150714109
29371468_3760,CM021102.1,3,29371468,157571164,89646,3760,157574924,154424813
29379818_229029,CM021102.1,3,29379818,157571164,844240,229029,157800193,154650082
29379818_229046,CM021102.1,3,29379818,157571164,844240,229046,157800210,154650099
29379818_229051,CM021102.1,3,29379818,157571164,844240,229051,157800215,154650104
29379818_229090,CM021102.1,3,29379818,157571164,844240,229090,157800254,154650143
29379818_229106,CM021102.1,3,29379818,157571164,844240,229106,157800270,154650159
29379818_229132,CM021102.1,3,29379818,157571164,844240,229132,157800296,154650185
29379818_229174,CM021102.1,3,29379818,157571164,844240,229174,157800338,154650227
29379818_229206,CM021102.1,3,29379818,157571164,844240,229206,157800370,154650259
29379818_229229,CM021102.1,3,29379818,157571164,844240,229229,157800393,154650282
29379818_229240,CM021102.1,3,29379818,157571164,844240,229240,157800404,154650293
29379818_229242,CM021102.1,3,29379818,157571164,844240,229242,157800406,154650295
29379818_274803,CM021102.1,3,29379818,157571164,844240,274803,157845967,154695856
29379818_274864,CM021102.1,3,29379818,157571164,844240,274864,157846028,154695917
29379818_274866,CM021102.1,3,29379818,157571164,844240,274866,157846030,154695919
29379818_274867,CM021102.1,3,29379818,157571164,844240,274867,157846031,154695920
29379818_274907,CM021102.1,3,29379818,157571164,844240,274907,157846071,154695960
29379818_274908,CM021102.1,3,29379818,157571164,844240,274908,157846072,154695961
29379818_274985,CM021102.1,3,29379818,157571164,844240,274985,157846149,154696038
29382103_670618,CM021102.1,3,29382103,157572815,713002,670618,158243433,155093322
29382103_670637,CM021102.1,3,29382103,157572815,713002,670637,158243452,155093341
29379711_132483,CM021102.1,3,29379711,168676116,304205,132483,168808599,165658488
29379711_132488,CM021102.1,3,29379711,168676116,304205,132488,168808604,165658493
29382380_192104,CM021102.1,3,29382380,168676121,454401,192104,168868225,165718114
29382380_192122,CM021102.1,3,29382380,168676121,454401,192122,168868243,165718132
29376488_407384,CM021102.1,3,29376488,168676113,1057714,407384,169083497,165933386
29377463_10859,CM021102.1,3,29377463,183532639,2250888,10859,183543498,180393387
29378137_43548,CM021102.1,3,29378137,183531686,2431609,43548,183575234,180425123
29378137_43622,CM021102.1,3,29378137,183531686,2431609,43622,183575308,180425197
29378137_43941,CM021102.1,3,29378137,183531686,2431609,43941,183575627,180425516
29378137_43952,CM021102.1,3,29378137,183531686,2431609,43952,183575638,180425527
29378137_43994,CM021102.1,3,29378137,183531686,2431609,43994,183575680,180425569
29377039_108441,CM021102.1,3,29377039,183519717,992290,108441,183628158,180478047
29378970_122959,CM021102.1,3,29378970,183519719,2075603,122959,183642678,180492567
29378137_119620,CM021102.1,3,29378137,183531686,2431609,119620,183651306,180501195
29378137_119685,CM021102.1,3,29378137,183531686,2431609,119685,183651371,180501260
29381814_138641,CM021102.1,3,29381814,183526775,288126,138641,183665416,180515305
29360327_174416,CM021102.1,3,29360327,183519719,222377,174416,183694135,180544024
29360327_174493,CM021102.1,3,29360327,183519719,222377,174493,183694212,180544101
29360327_174578,CM021102.1,3,29360327,183519719,222377,174578,183694297,180544186
29378970_189592,CM021102.1,3,29378970,183519719,2075603,189592,183709311,180559200
29378970_189628,CM021102.1,3,29378970,183519719,2075603,189628,183709347,180559236
29378827_218986,CM021102.1,3,29378827,183533373,3814512,218986,183752359,180602248
29381764_271516,CM021102.1,3,29381764,183519717,3819532,271516,183791233,180641122
29358265_287796,CM021102.1,3,29358265,183519719,970833,287796,183807515,180657404
29358265_288233,CM021102.1,3,29358265,183519719,970833,288233,183807952,180657841
29358265_288327,CM021102.1,3,29358265,183519719,970833,288327,183808046,180657935
29379424_283619,CM021102.1,3,29379424,183533273,3007754,283619,183816892,180666781
29378234_320426,CM021102.1,3,29378234,183519718,1006269,320426,183840144,180690033
29377034_327786,CM021102.1,3,29377034,183533211,7632151,327786,183860997,180710886
29377034_330197,CM021102.1,3,29377034,183533211,7632151,330197,183863408,180713297
29377034_330253,CM021102.1,3,29377034,183533211,7632151,330253,183863464,180713353
29377034_330260,CM021102.1,3,29377034,183533211,7632151,330260,183863471,180713360
29378970_480878,CM021102.1,3,29378970,183519719,2075603,480878,184000597,180850486
29377034_469105,CM021102.1,3,29377034,183533211,7632151,469105,184002316,180852205
29377034_469116,CM021102.1,3,29377034,183533211,7632151,469116,184002327,180852216
29377034_469217,CM021102.1,3,29377034,183533211,7632151,469217,184002428,180852317
29377034_469220,CM021102.1,3,29377034,183533211,7632151,469220,184002431,180852320
29377034_469254,CM021102.1,3,29377034,183533211,7632151,469254,184002465,180852354
29377034_469678,CM021102.1,3,29377034,183533211,7632151,469678,184002889,180852778
29377034_469708,CM021102.1,3,29377034,183533211,7632151,469708,184002919,180852808
29377034_469949,CM021102.1,3,29377034,183533211,7632151,469949,184003160,180853049
29377034_470035,CM021102.1,3,29377034,183533211,7632151,470035,184003246,180853135
29379424_483372,CM021102.1,3,29379424,183533273,3007754,483372,184016645,180866534
29379751_544352,CM021102.1,3,29379751,183533073,2037163,544352,184077425,180927314
29379751_544425,CM021102.1,3,29379751,183533073,2037163,544425,184077498,180927387
29379751_544455,CM021102.1,3,29379751,183533073,2037163,544455,184077528,180927417
29378970_590959,CM021102.1,3,29378970,183519719,2075603,590959,184110678,180960567
29378970_591214,CM021102.1,3,29378970,183519719,2075603,591214,184110933,180960822
29378970_610223,CM021102.1,3,29378970,183519719,2075603,610223,184129942,180979831
29379295_648767,CM021102.1,3,29379295,183519719,1633337,648767,184168486,181018375
29379295_648776,CM021102.1,3,29379295,183519719,1633337,648776,184168495,181018384
29379295_648818,CM021102.1,3,29379295,183519719,1633337,648818,184168537,181018426
29379295_648831,CM021102.1,3,29379295,183519719,1633337,648831,184168550,181018439
29379295_648841,CM021102.1,3,29379295,183519719,1633337,648841,184168560,181018449
29379644_684448,CM021102.1,3,29379644,183519719,1900238,684448,184204167,181054056
29358265_695373,CM021102.1,3,29358265,183519719,970833,695373,184215092,181064981
29378234_702496,CM021102.1,3,29378234,183519718,1006269,702496,184222214,181072103
29378234_702512,CM021102.1,3,29378234,183519718,1006269,702512,184222230,181072119
29378970_846784,CM021102.1,3,29378970,183519719,2075603,846784,184366503,181216392
29378970_858244,CM021102.1,3,29378970,183519719,2075603,858244,184377963,181227852
29378970_858379,CM021102.1,3,29378970,183519719,2075603,858379,184378098,181227987
29378970_860429,CM021102.1,3,29378970,183519719,2075603,860429,184380148,181230037
29378234_871500,CM021102.1,3,29378234,183519718,1006269,871500,184391218,181241107
29378234_871591,CM021102.1,3,29378234,183519718,1006269,871591,184391309,181241198
29378234_871697,CM021102.1,3,29378234,183519718,1006269,871697,184391415,181241304
29379644_872515,CM021102.1,3,29379644,183519719,1900238,872515,184392234,181242123
29379644_872526,CM021102.1,3,29379644,183519719,1900238,872526,184392245,181242134
29379644_872628,CM021102.1,3,29379644,183519719,1900238,872628,184392347,181242236
29378137_904300,CM021102.1,3,29378137,183531686,2431609,904300,184435986,181285875
29378137_904351,CM021102.1,3,29378137,183531686,2431609,904351,184436037,181285926
29378234_928173,CM021102.1,3,29378234,183519718,1006269,928173,184447891,181297780
29378234_928194,CM021102.1,3,29378234,183519718,1006269,928194,184447912,181297801
29378234_928248,CM021102.1,3,29378234,183519718,1006269,928248,184447966,181297855
29378234_928317,CM021102.1,3,29378234,183519718,1006269,928317,184448035,181297924
29378234_928414,CM021102.1,3,29378234,183519718,1006269,928414,184448132,181298021
29378234_928444,CM021102.1,3,29378234,183519718,1006269,928444,184448162,181298051
29378970_1147096,CM021102.1,3,29378970,183519719,2075603,1147096,184666815,181516704
29378970_1147144,CM021102.1,3,29378970,183519719,2075603,1147144,184666863,181516752
29380531_1163095,CM021102.1,3,29380531,183519719,3347250,1163095,184682814,181532703
29378970_1163388,CM021102.1,3,29378970,183519719,2075603,1163388,184683107,181532996
29377463_1160363,CM021102.1,3,29377463,183532639,2250888,1160363,184693002,181542891
29379081_1185532,CM021102.1,3,29379081,183519719,1293994,1185532,184705251,181555140
29381331_1230115,CM021102.1,3,29381331,183519711,6962119,1230115,184749826,181599715
29381331_1230223,CM021102.1,3,29381331,183519711,6962119,1230223,184749934,181599823
29378137_1292701,CM021102.1,3,29378137,183531686,2431609,1292701,184824387,181674276
29378137_1294981,CM021102.1,3,29378137,183531686,2431609,1294981,184826667,181676556
29379295_1342723,CM021102.1,3,29379295,183519719,1633337,1342723,184862442,181712331
29379295_1342798,CM021102.1,3,29379295,183519719,1633337,1342798,184862517,181712406
29377718_1379030,CM021102.1,3,29377718,183519719,1451227,1379030,184898749,181748638
29377718_1379036,CM021102.1,3,29377718,183519719,1451227,1379036,184898755,181748644
29377718_1379050,CM021102.1,3,29377718,183519719,1451227,1379050,184898769,181748658
29377718_1379103,CM021102.1,3,29377718,183519719,1451227,1379103,184898822,181748711
29377718_1379127,CM021102.1,3,29377718,183519719,1451227,1379127,184898846,181748735
29381764_1618101,CM021102.1,3,29381764,183519717,3819532,1618101,185137818,181987707
29378970_1621705,CM021102.1,3,29378970,183519719,2075603,1621705,185141424,181991313
29378970_1621770,CM021102.1,3,29378970,183519719,2075603,1621770,185141489,181991378
29378970_1621779,CM021102.1,3,29378970,183519719,2075603,1621779,185141498,181991387
29381764_1635770,CM021102.1,3,29381764,183519717,3819532,1635770,185155487,182005376
29381764_1635825,CM021102.1,3,29381764,183519717,3819532,1635825,185155542,182005431
29378970_1651099,CM021102.1,3,29378970,183519719,2075603,1651099,185170818,182020707
29381764_1651460,CM021102.1,3,29381764,183519717,3819532,1651460,185171177,182021066
29378162_1645663,CM021102.1,3,29378162,183532249,6448305,1645663,185177912,182027801
29378970_1769907,CM021102.1,3,29378970,183519719,2075603,1769907,185289626,182139515
29378970_1769926,CM021102.1,3,29378970,183519719,2075603,1769926,185289645,182139534
29378970_1850084,CM021102.1,3,29378970,183519719,2075603,1850084,185369803,182219692
29378970_1850147,CM021102.1,3,29378970,183519719,2075603,1850147,185369866,182219755
29378137_1925240,CM021102.1,3,29378137,183531686,2431609,1925240,185456926,182306815
29378137_1925260,CM021102.1,3,29378137,183531686,2431609,1925260,185456946,182306835
29378137_1925356,CM021102.1,3,29378137,183531686,2431609,1925356,185457042,182306931
29378970_1948849,CM021102.1,3,29378970,183519719,2075603,1948849,185468568,182318457
29378970_1948911,CM021102.1,3,29378970,183519719,2075603,1948911,185468630,182318519
29378970_2049576,CM021102.1,3,29378970,183519719,2075603,2049576,185569295,182419184
29378970_2049579,CM021102.1,3,29378970,183519719,2075603,2049579,185569298,182419187
29378970_2049630,CM021102.1,3,29378970,183519719,2075603,2049630,185569349,182419238
29378970_2050207,CM021102.1,3,29378970,183519719,2075603,2050207,185569926,182419815
29378970_2050268,CM021102.1,3,29378970,183519719,2075603,2050268,185569987,182419876
29378970_2051881,CM021102.1,3,29378970,183519719,2075603,2051881,185571600,182421489
29378970_2051899,CM021102.1,3,29378970,183519719,2075603,2051899,185571618,182421507
29381764_2132402,CM021102.1,3,29381764,183519717,3819532,2132402,185652119,182502008
29381764_2132479,CM021102.1,3,29381764,183519717,3819532,2132479,185652196,182502085
29381764_2132561,CM021102.1,3,29381764,183519717,3819532,2132561,185652278,182502167
29381764_2377022,CM021102.1,3,29381764,183519717,3819532,2377022,185896739,182746628
29381764_2377151,CM021102.1,3,29381764,183519717,3819532,2377151,185896868,182746757
29381764_2377153,CM021102.1,3,29381764,183519717,3819532,2377153,185896870,182746759
29381764_2678039,CM021102.1,3,29381764,183519717,3819532,2678039,186197756,183047645
29379424_2678789,CM021102.1,3,29379424,183533273,3007754,2678789,186212062,183061951
29379424_2681163,CM021102.1,3,29379424,183533273,3007754,2681163,186214436,183064325
29379424_2681285,CM021102.1,3,29379424,183533273,3007754,2681285,186214558,183064447
29379424_2681473,CM021102.1,3,29379424,183533273,3007754,2681473,186214746,183064635
29378827_2758901,CM021102.1,3,29378827,183533373,3814512,2758901,186292274,183142163
29379424_2847255,CM021102.1,3,29379424,183533273,3007754,2847255,186380528,183230417
29379424_2876336,CM021102.1,3,29379424,183533273,3007754,2876336,186409609,183259498
29380531_2910768,CM021102.1,3,29380531,183519719,3347250,2910768,186430487,183280376
29379424_2939043,CM021102.1,3,29379424,183533273,3007754,2939043,186472316,183322205
29378827_2957494,CM021102.1,3,29378827,183533373,3814512,2957494,186490867,183340756
29378827_2957517,CM021102.1,3,29378827,183533373,3814512,2957517,186490890,183340779
29379424_2962951,CM021102.1,3,29379424,183533273,3007754,2962951,186496224,183346113
29379424_2963714,CM021102.1,3,29379424,183533273,3007754,2963714,186496987,183346876
29379424_2963766,CM021102.1,3,29379424,183533273,3007754,2963766,186497039,183346928
29378162_3154255,CM021102.1,3,29378162,183532249,6448305,3154255,186686504,183536393
29378162_3154686,CM021102.1,3,29378162,183532249,6448305,3154686,186686935,183536824
29377880_3226691,CM021102.1,3,29377880,183519717,6075218,3226691,186746408,183596297
29377880_3264314,CM021102.1,3,29377880,183519717,6075218,3264314,186784031,183633920
29381764_3565442,CM021102.1,3,29381764,183519717,3819532,3565442,187085159,183935048
29377880_4078105,CM021102.1,3,29377880,183519717,6075218,4078105,187597822,184447711
29378162_4378991,CM021102.1,3,29378162,183532249,6448305,4378991,187911240,184761129
29378162_4477875,CM021102.1,3,29378162,183532249,6448305,4477875,188010124,184860013
29378162_4477917,CM021102.1,3,29378162,183532249,6448305,4477917,188010166,184860055
29378162_5363217,CM021102.1,3,29378162,183532249,6448305,5363217,188895466,185745355
29378162_5365341,CM021102.1,3,29378162,183532249,6448305,5365341,188897590,185747479
29378162_5367115,CM021102.1,3,29378162,183532249,6448305,5367115,188899364,185749253
29378162_5367121,CM021102.1,3,29378162,183532249,6448305,5367121,188899370,185749259
29378162_5367212,CM021102.1,3,29378162,183532249,6448305,5367212,188899461,185749350
29378162_5367233,CM021102.1,3,29378162,183532249,6448305,5367233,188899482,185749371
29378162_5367267,CM021102.1,3,29378162,183532249,6448305,5367267,188899516,185749405
29381331_5616048,CM021102.1,3,29381331,183519711,6962119,5616048,189135759,185985648
29381331_5704371,CM021102.1,3,29381331,183519711,6962119,5704371,189224082,186073971
29381331_5704487,CM021102.1,3,29381331,183519711,6962119,5704487,189224198,186074087
29377880_5746375,CM021102.1,3,29377880,183519717,6075218,5746375,189266092,186115981
29377880_5746384,CM021102.1,3,29377880,183519717,6075218,5746384,189266101,186115990
29377880_5746441,CM021102.1,3,29377880,183519717,6075218,5746441,189266158,186116047
29377880_5746477,CM021102.1,3,29377880,183519717,6075218,5746477,189266194,186116083
29377880_5746482,CM021102.1,3,29377880,183519717,6075218,5746482,189266199,186116088
29377880_5747984,CM021102.1,3,29377880,183519717,6075218,5747984,189267701,186117590
29377880_5748021,CM021102.1,3,29377880,183519717,6075218,5748021,189267738,186117627
29378162_5880298,CM021102.1,3,29378162,183532249,6448305,5880298,189412547,186262436
29378162_5880317,CM021102.1,3,29378162,183532249,6448305,5880317,189412566,186262455
29378162_5880425,CM021102.1,3,29378162,183532249,6448305,5880425,189412674,186262563
29378162_5880520,CM021102.1,3,29378162,183532249,6448305,5880520,189412769,186262658
29378162_5882950,CM021102.1,3,29378162,183532249,6448305,5882950,189415199,186265088
29378162_5882970,CM021102.1,3,29378162,183532249,6448305,5882970,189415219,186265108
29378162_5882987,CM021102.1,3,29378162,183532249,6448305,5882987,189415236,186265125
29378162_5884294,CM021102.1,3,29378162,183532249,6448305,5884294,189416543,186266432
29377835_366752,CM021102.1,3,29377835,191489678,1495652,366752,191856430,188706319
29377835_366812,CM021102.1,3,29377835,191489678,1495652,366812,191856490,188706379
29381556_374381,CM021102.1,3,29381556,191489676,2839073,374381,191864057,188713946
29377835_390004,CM021102.1,3,29377835,191489678,1495652,390004,191879682,188729571
29381556_677290,CM021102.1,3,29381556,191489676,2839073,677290,192166966,189016855
29381556_677479,CM021102.1,3,29381556,191489676,2839073,677479,192167155,189017044
29381728_857773,CM021102.1,3,29381728,191489677,1928620,857773,192347450,189197339
29381728_857776,CM021102.1,3,29381728,191489677,1928620,857776,192347453,189197342
29381728_857850,CM021102.1,3,29381728,191489677,1928620,857850,192347527,189197416
29381728_857857,CM021102.1,3,29381728,191489677,1928620,857857,192347534,189197423
29381728_857888,CM021102.1,3,29381728,191489677,1928620,857888,192347565,189197454
29381728_857889,CM021102.1,3,29381728,191489677,1928620,857889,192347566,189197455
29381728_857916,CM021102.1,3,29381728,191489677,1928620,857916,192347593,189197482
29381728_857934,CM021102.1,3,29381728,191489677,1928620,857934,192347611,189197500
29381728_857947,CM021102.1,3,29381728,191489677,1928620,857947,192347624,189197513
29381728_857948,CM021102.1,3,29381728,191489677,1928620,857948,192347625,189197514
29381728_857959,CM021102.1,3,29381728,191489677,1928620,857959,192347636,189197525
29381728_857960,CM021102.1,3,29381728,191489677,1928620,857960,192347637,189197526
29381728_857965,CM021102.1,3,29381728,191489677,1928620,857965,192347642,189197531
29381728_857973,CM021102.1,3,29381728,191489677,1928620,857973,192347650,189197539
29381728_857983,CM021102.1,3,29381728,191489677,1928620,857983,192347660,189197549
29381728_857987,CM021102.1,3,29381728,191489677,1928620,857987,192347664,189197553
29381728_858005,CM021102.1,3,29381728,191489677,1928620,858005,192347682,189197571
29381728_858021,CM021102.1,3,29381728,191489677,1928620,858021,192347698,189197587
29381728_858024,CM021102.1,3,29381728,191489677,1928620,858024,192347701,189197590
29377835_917675,CM021102.1,3,29377835,191489678,1495652,917675,192407353,189257242
29377835_917720,CM021102.1,3,29377835,191489678,1495652,917720,192407398,189257287
29381728_964165,CM021102.1,3,29381728,191489677,1928620,964165,192453842,189303731
29381728_964186,CM021102.1,3,29381728,191489677,1928620,964186,192453863,189303752
29381728_964212,CM021102.1,3,29381728,191489677,1928620,964212,192453889,189303778
29381728_964213,CM021102.1,3,29381728,191489677,1928620,964213,192453890,189303779
29381728_964218,CM021102.1,3,29381728,191489677,1928620,964218,192453895,189303784
29381728_964241,CM021102.1,3,29381728,191489677,1928620,964241,192453918,189303807
29381728_964264,CM021102.1,3,29381728,191489677,1928620,964264,192453941,189303830
29381728_964265,CM021102.1,3,29381728,191489677,1928620,964265,192453942,189303831
29381728_964299,CM021102.1,3,29381728,191489677,1928620,964299,192453976,189303865
29381728_964323,CM021102.1,3,29381728,191489677,1928620,964323,192454000,189303889
29381728_964330,CM021102.1,3,29381728,191489677,1928620,964330,192454007,189303896
29381728_1075668,CM021102.1,3,29381728,191489677,1928620,1075668,192565345,189415234
29381728_1075690,CM021102.1,3,29381728,191489677,1928620,1075690,192565367,189415256
29381556_1559986,CM021102.1,3,29381556,191489676,2839073,1559986,193049662,189899551
29381728_1615472,CM021102.1,3,29381728,191489677,1928620,1615472,193105149,189955038
29381728_1615474,CM021102.1,3,29381728,191489677,1928620,1615474,193105151,189955040
29381728_1615575,CM021102.1,3,29381728,191489677,1928620,1615575,193105252,189955141
29381556_1900259,CM021102.1,3,29381556,191489676,2839073,1900259,193389935,190239824
29381556_1900335,CM021102.1,3,29381556,191489676,2839073,1900335,193390011,190239900
29355029_70062,CM021102.1,3,29355029,213145775,214753,70062,213215837,210065726
29355029_70803,CM021102.1,3,29355029,213145775,214753,70803,213216578,210066467
29355029_88916,CM021102.1,3,29355029,213145775,214753,88916,213234691,210084580
29381774_18502,CM021102.1,3,29381774,217301713,429839,18502,217320215,214170104
29381774_18591,CM021102.1,3,29381774,217301713,429839,18591,217320304,214170193
29349220_287580,CM021102.1,3,29349220,217301717,467892,287580,217589297,214439186
29381774_386264,CM021102.1,3,29381774,217301713,429839,386264,217687977,214537866
29371894_8564,CM021102.1,3,29371894,254546788,208492,8564,254555352,251405241
29371894_8610,CM021102.1,3,29371894,254546788,208492,8610,254555398,251405287
29371894_8631,CM021102.1,3,29371894,254546788,208492,8631,254555419,251405308
29371894_8668,CM021102.1,3,29371894,254546788,208492,8668,254555456,251405345
29380777_377600,CM021102.1,3,29380777,268523012,3208500,377600,268900612,265750501
29380777_377845,CM021102.1,3,29380777,268523012,3208500,377845,268900857,265750746
29380777_438376,CM021102.1,3,29380777,268523012,3208500,438376,268961388,265811277
29380767_765011,CM021102.1,3,29380767,268510766,2563049,765011,269275777,266125666
29380777_2752163,CM021102.1,3,29380777,268523012,3208500,2752163,271275175,268125064
29382089_3267222,CM021102.1,3,29382089,268509617,5145285,3267222,271776839,268626728
29382089_3267225,CM021102.1,3,29382089,268509617,5145285,3267225,271776842,268626731
29382089_3267283,CM021102.1,3,29382089,268509617,5145285,3267283,271776900,268626789
29382089_3267329,CM021102.1,3,29382089,268509617,5145285,3267329,271776946,268626835
29382089_3267360,CM021102.1,3,29382089,268509617,5145285,3267360,271776977,268626866
29382089_3461734,CM021102.1,3,29382089,268509617,5145285,3461734,271971351,268821240
29382089_3598297,CM021102.1,3,29382089,268509617,5145285,3598297,272107914,268957803
29382089_4808521,CM021102.1,3,29382089,268509617,5145285,4808521,273318138,270168027
29382089_4808546,CM021102.1,3,29382089,268509617,5145285,4808546,273318163,270168052
29382089_4808548,CM021102.1,3,29382089,268509617,5145285,4808548,273318165,270168054
29346481_35121,CM021102.1,3,29346481,278034168,142338,35121,278069289,274919178
29343979_67856,CM021102.1,3,29343979,278034162,85082,67856,278102018,274951907
29343979_67863,CM021102.1,3,29343979,278034162,85082,67863,278102025,274951914
29343979_67990,CM021102.1,3,29343979,278034162,85082,67990,278102152,274952041
29343979_68054,CM021102.1,3,29343979,278034162,85082,68054,278102216,274952105
29382325_504792,CM021102.1,3,29382325,278034168,796006,504792,278538960,275388849
29382325_572243,CM021102.1,3,29382325,278034168,796006,572243,278606411,275456300
29382325_572323,CM021102.1,3,29382325,278034168,796006,572323,278606491,275456380
29382325_572333,CM021102.1,3,29382325,278034168,796006,572333,278606501,275456390
29382325_572334,CM021102.1,3,29382325,278034168,796006,572334,278606502,275456391
29382325_572335,CM021102.1,3,29382325,278034168,796006,572335,278606503,275456392
29382325_575236,CM021102.1,3,29382325,278034168,796006,575236,278609404,275459293
29382325_575274,CM021102.1,3,29382325,278034168,796006,575274,278609442,275459331
29382325_575294,CM021102.1,3,29382325,278034168,796006,575294,278609462,275459351
29382325_729110,CM021102.1,3,29382325,278034168,796006,729110,278763278,275613167
29382325_729112,CM021102.1,3,29382325,278034168,796006,729112,278763280,275613169
29382325_744344,CM021102.1,3,29382325,278034168,796006,744344,278778512,275628401
29381605_128015,CM021102.1,3,29381605,286082189,244611,128015,286210204,283060093
29381605_128056,CM021102.1,3,29381605,286082189,244611,128056,286210245,283060134
29381605_128074,CM021102.1,3,29381605,286082189,244611,128074,286210263,283060152
29381605_128128,CM021102.1,3,29381605,286082189,244611,128128,286210317,283060206
29381605_208361,CM021102.1,3,29381605,286082189,244611,208361,286290550,283140439
29381605_208499,CM021102.1,3,29381605,286082189,244611,208499,286290688,283140577
29381605_208655,CM021102.1,3,29381605,286082189,244611,208655,286290844,283140733
29381605_208661,CM021102.1,3,29381605,286082189,244611,208661,286290850,283140739
29377675_23638,CM021102.1,3,29377675,288357676,326476,23638,288381314,285231203
29377675_23686,CM021102.1,3,29377675,288357676,326476,23686,288381362,285231251
29377675_23903,CM021102.1,3,29377675,288357676,326476,23903,288381579,285231468
29377675_23955,CM021102.1,3,29377675,288357676,326476,23955,288381631,285231520
29377675_23993,CM021102.1,3,29377675,288357676,326476,23993,288381669,285231558
29377675_313388,CM021102.1,3,29377675,288357676,326476,313388,288671064,285520953
29377675_313394,CM021102.1,3,29377675,288357676,326476,313394,288671070,285520959
29377675_313448,CM021102.1,3,29377675,288357676,326476,313448,288671124,285521013
29377675_315499,CM021102.1,3,29377675,288357676,326476,315499,288673175,285523064
29344332_14597,CM021102.1,3,29344332,289146547,72501,14597,289161144,286011033
29344332_21137,CM021102.1,3,29344332,289146547,72501,21137,289167684,286017573
29377111_122203,CM021102.1,3,29377111,289146545,357023,122203,289268748,286118637
29377111_122205,CM021102.1,3,29377111,289146545,357023,122205,289268750,286118639
29377111_122206,CM021102.1,3,29377111,289146545,357023,122206,289268751,286118640
29377111_295471,CM021102.1,3,29377111,289146545,357023,295471,289442016,286291905
29378216_640504,CM021102.1,3,29378216,289146547,760823,640504,289787051,286636940
29378216_640555,CM021102.1,3,29378216,289146547,760823,640555,289787102,286636991
29377690_869280,CM021102.1,3,29377690,289146545,2040643,869280,290015825,286865714
29378932_1036708,CM021102.1,3,29378932,289146545,1727672,1036708,290183253,287033142
29378932_1036756,CM021102.1,3,29378932,289146545,1727672,1036756,290183301,287033190
29378932_1036778,CM021102.1,3,29378932,289146545,1727672,1036778,290183323,287033212
29377690_1154109,CM021102.1,3,29377690,289146545,2040643,1154109,290300654,287150543
29377690_1154182,CM021102.1,3,29377690,289146545,2040643,1154182,290300727,287150616
29377690_1154734,CM021102.1,3,29377690,289146545,2040643,1154734,290301279,287151168
29377690_1154746,CM021102.1,3,29377690,289146545,2040643,1154746,290301291,287151180
29377690_1862256,CM021102.1,3,29377690,289146545,2040643,1862256,291008801,287858690
29377690_1862278,CM021102.1,3,29377690,289146545,2040643,1862278,291008823,287858712
29377690_1862764,CM021102.1,3,29377690,289146545,2040643,1862764,291009309,287859198
29377690_1873463,CM021102.1,3,29377690,289146545,2040643,1873463,291020008,287869897
29377690_1873525,CM021102.1,3,29377690,289146545,2040643,1873525,291020070,287869959
29379649_178687,CM021102.1,3,29379649,299982787,550380,178687,300161474,297011363
29379649_190391,CM021102.1,3,29379649,299982787,550380,190391,300173178,297023067
29379649_394799,CM021102.1,3,29379649,299982787,550380,394799,300377586,297227475
29379649_394877,CM021102.1,3,29379649,299982787,550380,394877,300377664,297227553
29379649_395499,CM021102.1,3,29379649,299982787,550380,395499,300378286,297228175
29377612_12115,CM021102.1,3,29377612,350202638,694437,12115,350214753,347064642
29377160_59561,CM021102.1,3,29377160,350200736,1026345,59561,350260297,347110186
29377219_189052,CM021102.1,3,29377219,350200717,975750,189052,350389769,347239658
29379019_288651,CM021102.1,3,29379019,350200745,560263,288651,350489396,347339285
29379019_291302,CM021102.1,3,29379019,350200745,560263,291302,350492047,347341936
29379019_291370,CM021102.1,3,29379019,350200745,560263,291370,350492115,347342004
29379019_291406,CM021102.1,3,29379019,350200745,560263,291406,350492151,347342040
29379019_294282,CM021102.1,3,29379019,350200745,560263,294282,350495027,347344916
29379019_294292,CM021102.1,3,29379019,350200745,560263,294292,350495037,347344926
29379019_294307,CM021102.1,3,29379019,350200745,560263,294307,350495052,347344941
29379019_294633,CM021102.1,3,29379019,350200745,560263,294633,350495378,347345267
29380775_300005,CM021102.1,3,29380775,350200736,925808,300005,350500741,347350630
29379777_335563,CM021102.1,3,29379777,350200730,3607417,335563,350536293,347386182
29377612_351363,CM021102.1,3,29377612,350202638,694437,351363,350554001,347403890
29377612_351441,CM021102.1,3,29377612,350202638,694437,351441,350554079,347403968
29377612_351450,CM021102.1,3,29377612,350202638,694437,351450,350554088,347403977
29377612_351451,CM021102.1,3,29377612,350202638,694437,351451,350554089,347403978
29377612_351454,CM021102.1,3,29377612,350202638,694437,351454,350554092,347403981
29347179_373989,CM021102.1,3,29347179,350200728,628728,373989,350574717,347424606
29347179_374028,CM021102.1,3,29347179,350200728,628728,374028,350574756,347424645
29347179_374035,CM021102.1,3,29347179,350200728,628728,374035,350574763,347424652
29347179_374125,CM021102.1,3,29347179,350200728,628728,374125,350574853,347424742
29347179_374144,CM021102.1,3,29347179,350200728,628728,374144,350574872,347424761
29347179_374145,CM021102.1,3,29347179,350200728,628728,374145,350574873,347424762
29347179_374158,CM021102.1,3,29347179,350200728,628728,374158,350574886,347424775
29347179_374170,CM021102.1,3,29347179,350200728,628728,374170,350574898,347424787
29347179_374210,CM021102.1,3,29347179,350200728,628728,374210,350574938,347424827
29347179_374223,CM021102.1,3,29347179,350200728,628728,374223,350574951,347424840
29381661_374141,CM021102.1,3,29381661,350202206,1093364,374141,350576347,347426236
29378974_432044,CM021102.1,3,29378974,350200734,2938758,432044,350632778,347482667
29378974_432478,CM021102.1,3,29378974,350200734,2938758,432478,350633212,347483101
29378734_446212,CM021102.1,3,29378734,350200732,2655646,446212,350646944,347496833
29377160_576129,CM021102.1,3,29377160,350200736,1026345,576129,350776865,347626754
29377160_576151,CM021102.1,3,29377160,350200736,1026345,576151,350776887,347626776
29377160_576167,CM021102.1,3,29377160,350200736,1026345,576167,350776903,347626792
29378973_702923,CM021102.1,3,29378973,350200735,2632207,702923,350903658,347753547
29378973_702936,CM021102.1,3,29378973,350200735,2632207,702936,350903671,347753560
29378973_702978,CM021102.1,3,29378973,350200735,2632207,702978,350903713,347753602
29378973_703022,CM021102.1,3,29378973,350200735,2632207,703022,350903757,347753646
29378973_703890,CM021102.1,3,29378973,350200735,2632207,703890,350904625,347754514
29378973_714825,CM021102.1,3,29378973,350200735,2632207,714825,350915560,347765449
29378973_714896,CM021102.1,3,29378973,350200735,2632207,714896,350915631,347765520
29378973_714906,CM021102.1,3,29378973,350200735,2632207,714906,350915641,347765530
29380775_873210,CM021102.1,3,29380775,350200736,925808,873210,351073946,347923835
29380775_873238,CM021102.1,3,29380775,350200736,925808,873238,351073974,347923863
29380775_873262,CM021102.1,3,29380775,350200736,925808,873262,351073998,347923887
29378973_890363,CM021102.1,3,29378973,350200735,2632207,890363,351091098,347940987
29378973_890460,CM021102.1,3,29378973,350200735,2632207,890460,351091195,347941084
29378973_890474,CM021102.1,3,29378973,350200735,2632207,890474,351091209,347941098
29379407_1938159,CM021102.1,3,29379407,350200736,2604033,1938159,352138895,348988784
29379407_1938162,CM021102.1,3,29379407,350200736,2604033,1938162,352138898,348988787
29379407_1938225,CM021102.1,3,29379407,350200736,2604033,1938225,352138961,348988850
29378734_1970641,CM021102.1,3,29378734,350200732,2655646,1970641,352171373,349021262
29378734_1970682,CM021102.1,3,29378734,350200732,2655646,1970682,352171414,349021303
29378734_1970710,CM021102.1,3,29378734,350200732,2655646,1970710,352171442,349021331
29381786_32508,CM021102.1,3,29381786,352139609,702117,32508,352172117,349022006
29381786_32662,CM021102.1,3,29381786,352139609,702117,32662,352172271,349022160
29378973_1983258,CM021102.1,3,29378973,350200735,2632207,1983258,352183993,349033882
29381786_108795,CM021102.1,3,29381786,352139609,702117,108795,352248404,349098293
29381786_108798,CM021102.1,3,29381786,352139609,702117,108798,352248407,349098296
29381786_108806,CM021102.1,3,29381786,352139609,702117,108806,352248415,349098304
29381786_108833,CM021102.1,3,29381786,352139609,702117,108833,352248442,349098331
29378994_298412,CM021102.1,3,29378994,352139610,303871,298412,352438022,349287911
29381786_338756,CM021102.1,3,29381786,352139609,702117,338756,352478365,349328254
29379407_2284365,CM021102.1,3,29379407,350200736,2604033,2284365,352485101,349334990
29379407_2284399,CM021102.1,3,29379407,350200736,2604033,2284399,352485135,349335024
29380348_346759,CM021102.1,3,29380348,352139610,1944886,346759,352486369,349336258
29380348_346761,CM021102.1,3,29380348,352139610,1944886,346761,352486371,349336260
29380348_346781,CM021102.1,3,29380348,352139610,1944886,346781,352486391,349336280
29380348_346788,CM021102.1,3,29380348,352139610,1944886,346788,352486398,349336287
29380348_346800,CM021102.1,3,29380348,352139610,1944886,346800,352486410,349336299
29380348_346807,CM021102.1,3,29380348,352139610,1944886,346807,352486417,349336306
29380348_346811,CM021102.1,3,29380348,352139610,1944886,346811,352486421,349336310
29380348_346845,CM021102.1,3,29380348,352139610,1944886,346845,352486455,349336344
29380348_346846,CM021102.1,3,29380348,352139610,1944886,346846,352486456,349336345
29380348_346862,CM021102.1,3,29380348,352139610,1944886,346862,352486472,349336361
29380348_346876,CM021102.1,3,29380348,352139610,1944886,346876,352486486,349336375
29380348_346881,CM021102.1,3,29380348,352139610,1944886,346881,352486491,349336380
29380348_346894,CM021102.1,3,29380348,352139610,1944886,346894,352486504,349336393
29380348_346898,CM021102.1,3,29380348,352139610,1944886,346898,352486508,349336397
29380348_346901,CM021102.1,3,29380348,352139610,1944886,346901,352486511,349336400
29380348_346919,CM021102.1,3,29380348,352139610,1944886,346919,352486529,349336418
29380348_346939,CM021102.1,3,29380348,352139610,1944886,346939,352486549,349336438
29380348_346951,CM021102.1,3,29380348,352139610,1944886,346951,352486561,349336450
29380348_346966,CM021102.1,3,29380348,352139610,1944886,346966,352486576,349336465
29381786_363325,CM021102.1,3,29381786,352139609,702117,363325,352502934,349352823
29380134_380640,CM021102.1,3,29380134,352139746,1340813,380640,352520386,349370275
29380134_380691,CM021102.1,3,29380134,352139746,1340813,380691,352520437,349370326
29380134_389506,CM021102.1,3,29380134,352139746,1340813,389506,352529252,349379141
29381786_390001,CM021102.1,3,29381786,352139609,702117,390001,352529610,349379499
29381786_390076,CM021102.1,3,29381786,352139609,702117,390076,352529685,349379574
29381786_390097,CM021102.1,3,29381786,352139609,702117,390097,352529706,349379595
29380348_398805,CM021102.1,3,29380348,352139610,1944886,398805,352538415,349388304
29380348_398848,CM021102.1,3,29380348,352139610,1944886,398848,352538458,349388347
29380348_398915,CM021102.1,3,29380348,352139610,1944886,398915,352538525,349388414
29381786_414537,CM021102.1,3,29381786,352139609,702117,414537,352554146,349404035
29381786_414558,CM021102.1,3,29381786,352139609,702117,414558,352554167,349404056
29381786_414710,CM021102.1,3,29381786,352139609,702117,414710,352554319,349404208
29381786_414738,CM021102.1,3,29381786,352139609,702117,414738,352554347,349404236
29381786_414787,CM021102.1,3,29381786,352139609,702117,414787,352554396,349404285
29379777_2369052,CM021102.1,3,29379777,350200730,3607417,2369052,352569782,349419671
29379777_2369082,CM021102.1,3,29379777,350200730,3607417,2369082,352569812,349419701
29379777_2369130,CM021102.1,3,29379777,350200730,3607417,2369130,352569860,349419749
29379777_2369158,CM021102.1,3,29379777,350200730,3607417,2369158,352569888,349419777
29379777_2369238,CM021102.1,3,29379777,350200730,3607417,2369238,352569968,349419857
29379777_3015070,CM021102.1,3,29379777,350200730,3607417,3015070,353215800,350065689
29379777_3015109,CM021102.1,3,29379777,350200730,3607417,3015109,353215839,350065728
29379777_3015301,CM021102.1,3,29379777,350200730,3607417,3015301,353216031,350065920
29379777_3086620,CM021102.1,3,29379777,350200730,3607417,3086620,353287350,350137239
29379777_3086646,CM021102.1,3,29379777,350200730,3607417,3086646,353287376,350137265
29379777_3126794,CM021102.1,3,29379777,350200730,3607417,3126794,353327524,350177413
29379777_3126881,CM021102.1,3,29379777,350200730,3607417,3126881,353327611,350177500
29379777_3126935,CM021102.1,3,29379777,350200730,3607417,3126935,353327665,350177554
29380374_4380314,CM021102.1,3,29380374,350200736,4772679,4380314,354581050,351430939
29371780_43084,CM021102.1,3,29371780,367464165,206437,43084,367507249,364357138
29381036_57784,CM021102.1,3,29381036,374851213,173171,57784,374908997,371758886
29381773_626826,CM021102.1,3,29381773,374848436,2446875,626826,375475262,372325151
29381773_626919,CM021102.1,3,29381773,374848436,2446875,626919,375475355,372325244
29381773_626921,CM021102.1,3,29381773,374848436,2446875,626921,375475357,372325246
29381773_636403,CM021102.1,3,29381773,374848436,2446875,636403,375484839,372334728
29381773_636442,CM021102.1,3,29381773,374848436,2446875,636442,375484878,372334767
29381773_639109,CM021102.1,3,29381773,374848436,2446875,639109,375487545,372337434
29381773_859156,CM021102.1,3,29381773,374848436,2446875,859156,375707592,372557481
29381565_1388976,CM021102.1,3,29381565,374848374,1740439,1388976,376237350,373087239
29381773_1633038,CM021102.1,3,29381773,374848436,2446875,1633038,376481474,373331363
29380191_45734,CM021102.1,3,29380191,382378457,3659711,45734,382424191,379274080
29380191_45836,CM021102.1,3,29380191,382378457,3659711,45836,382424293,379274182
29380191_46093,CM021102.1,3,29380191,382378457,3659711,46093,382424550,379274439
29380191_46120,CM021102.1,3,29380191,382378457,3659711,46120,382424577,379274466
29380191_46204,CM021102.1,3,29380191,382378457,3659711,46204,382424661,379274550
29368046_70785,CM021102.1,3,29368046,382382694,171149,70785,382453479,379303368
29368046_70856,CM021102.1,3,29368046,382382694,171149,70856,382453550,379303439
29380540_92169,CM021102.1,3,29380540,382381850,1465642,92169,382474019,379323908
29377267_92383,CM021102.1,3,29377267,382383019,281956,92383,382475402,379325291
29377267_92439,CM021102.1,3,29377267,382383019,281956,92439,382475458,379325347
29377889_134225,CM021102.1,3,29377889,382381956,1151943,134225,382516181,379366070
29377889_134324,CM021102.1,3,29377889,382381956,1151943,134324,382516280,379366169
29377889_134325,CM021102.1,3,29377889,382381956,1151943,134325,382516281,379366170
29378097_154993,CM021102.1,3,29378097,382370892,345786,154993,382525885,379375774
29378097_155017,CM021102.1,3,29378097,382370892,345786,155017,382525909,379375798
29378097_155084,CM021102.1,3,29378097,382370892,345786,155084,382525976,379375865
29378097_155615,CM021102.1,3,29378097,382370892,345786,155615,382526507,379376396
29378097_155736,CM021102.1,3,29378097,382370892,345786,155736,382526628,379376517
29378097_183302,CM021102.1,3,29378097,382370892,345786,183302,382554194,379404083
29378097_183313,CM021102.1,3,29378097,382370892,345786,183313,382554205,379404094
29378097_183389,CM021102.1,3,29378097,382370892,345786,183389,382554281,379404170
29378097_183392,CM021102.1,3,29378097,382370892,345786,183392,382554284,379404173
29378097_183453,CM021102.1,3,29378097,382370892,345786,183453,382554345,379404234
29378097_183504,CM021102.1,3,29378097,382370892,345786,183504,382554396,379404285
29378097_186793,CM021102.1,3,29378097,382370892,345786,186793,382557685,379407574
29378097_186872,CM021102.1,3,29378097,382370892,345786,186872,382557764,379407653
29378914_201713,CM021102.1,3,29378914,382370894,1875817,201713,382572607,379422496
29381055_202832,CM021102.1,3,29381055,382370893,1203448,202832,382573725,379423614
29381055_222787,CM021102.1,3,29381055,382370893,1203448,222787,382593680,379443569
29381055_222843,CM021102.1,3,29381055,382370893,1203448,222843,382593736,379443625
29378097_224113,CM021102.1,3,29378097,382370892,345786,224113,382595005,379444894
29378097_224222,CM021102.1,3,29378097,382370892,345786,224222,382595114,379445003
29378097_224240,CM021102.1,3,29378097,382370892,345786,224240,382595132,379445021
29378097_224297,CM021102.1,3,29378097,382370892,345786,224297,382595189,379445078
29378097_224309,CM021102.1,3,29378097,382370892,345786,224309,382595201,379445090
29378097_224385,CM021102.1,3,29378097,382370892,345786,224385,382595277,379445166
29377537_237079,CM021102.1,3,29377537,382370892,4549370,237079,382607971,379457860
29378675_234570,CM021102.1,3,29378675,382383212,351831,234570,382617782,379467671
29378675_234661,CM021102.1,3,29378675,382383212,351831,234661,382617873,379467762
29380540_252349,CM021102.1,3,29380540,382381850,1465642,252349,382634199,379484088
29380540_252475,CM021102.1,3,29380540,382381850,1465642,252475,382634325,379484214
29380540_265642,CM021102.1,3,29380540,382381850,1465642,265642,382647492,379497381
29381533_294935,CM021102.1,3,29381533,382370891,502033,294935,382665826,379515715
29382434_379092,CM021102.1,3,29382434,382370888,554593,379092,382749980,379599869
29378914_399446,CM021102.1,3,29378914,382370894,1875817,399446,382770340,379620229
29378914_399488,CM021102.1,3,29378914,382370894,1875817,399488,382770382,379620271
29378914_399507,CM021102.1,3,29378914,382370894,1875817,399507,382770401,379620290
29378914_399523,CM021102.1,3,29378914,382370894,1875817,399523,382770417,379620306
29378914_399558,CM021102.1,3,29378914,382370894,1875817,399558,382770452,379620341
29378914_399580,CM021102.1,3,29378914,382370894,1875817,399580,382770474,379620363
29380191_448837,CM021102.1,3,29380191,382378457,3659711,448837,382827294,379677183
29380191_448839,CM021102.1,3,29380191,382378457,3659711,448839,382827296,379677185
29380191_448848,CM021102.1,3,29380191,382378457,3659711,448848,382827305,379677194
29380191_448887,CM021102.1,3,29380191,382378457,3659711,448887,382827344,379677233
29380191_448889,CM021102.1,3,29380191,382378457,3659711,448889,382827346,379677235
29380191_448894,CM021102.1,3,29380191,382378457,3659711,448894,382827351,379677240
29380191_454218,CM021102.1,3,29380191,382378457,3659711,454218,382832675,379682564
29380191_454233,CM021102.1,3,29380191,382378457,3659711,454233,382832690,379682579
29380191_454263,CM021102.1,3,29380191,382378457,3659711,454263,382832720,379682609
29381533_487438,CM021102.1,3,29381533,382370891,502033,487438,382858329,379708218
29381533_487450,CM021102.1,3,29381533,382370891,502033,487450,382858341,379708230
29381533_487454,CM021102.1,3,29381533,382370891,502033,487454,382858345,379708234
29381533_487466,CM021102.1,3,29381533,382370891,502033,487466,382858357,379708246
29381533_487506,CM021102.1,3,29381533,382370891,502033,487506,382858397,379708286
29381533_487509,CM021102.1,3,29381533,382370891,502033,487509,382858400,379708289
29381533_487511,CM021102.1,3,29381533,382370891,502033,487511,382858402,379708291
29381533_487516,CM021102.1,3,29381533,382370891,502033,487516,382858407,379708296
29381533_487536,CM021102.1,3,29381533,382370891,502033,487536,382858427,379708316
29381533_487548,CM021102.1,3,29381533,382370891,502033,487548,382858439,379708328
29381533_487552,CM021102.1,3,29381533,382370891,502033,487552,382858443,379708332
29381533_487577,CM021102.1,3,29381533,382370891,502033,487577,382858468,379708357
29377537_490950,CM021102.1,3,29377537,382370892,4549370,490950,382861842,379711731
29381533_500071,CM021102.1,3,29381533,382370891,502033,500071,382870962,379720851
29381055_543958,CM021102.1,3,29381055,382370893,1203448,543958,382914851,379764740
29381055_544054,CM021102.1,3,29381055,382370893,1203448,544054,382914947,379764836
29381055_544058,CM021102.1,3,29381055,382370893,1203448,544058,382914951,379764840
29381055_544059,CM021102.1,3,29381055,382370893,1203448,544059,382914952,379764841
29378914_545811,CM021102.1,3,29378914,382370894,1875817,545811,382916705,379766594
29378914_546342,CM021102.1,3,29378914,382370894,1875817,546342,382917236,379767125
29381055_568310,CM021102.1,3,29381055,382370893,1203448,568310,382939203,379789092
29378066_597430,CM021102.1,3,29378066,382370894,2318140,597430,382968324,379818213
29378066_597476,CM021102.1,3,29378066,382370894,2318140,597476,382968370,379818259
29378066_597584,CM021102.1,3,29378066,382370894,2318140,597584,382968478,379818367
29378102_704258,CM021102.1,3,29378102,382370892,1189020,704258,383075150,379925039
29378632_772508,CM021102.1,3,29378632,382370892,2335550,772508,383143400,379993289
29378632_773611,CM021102.1,3,29378632,382370892,2335550,773611,383144503,379994392
29378632_773627,CM021102.1,3,29378632,382370892,2335550,773627,383144519,379994408
29381420_838304,CM021102.1,3,29381420,382370888,4653901,838304,383209192,380059081
29381420_838409,CM021102.1,3,29381420,382370888,4653901,838409,383209297,380059186
29381420_838438,CM021102.1,3,29381420,382370888,4653901,838438,383209326,380059215
29378066_849996,CM021102.1,3,29378066,382370894,2318140,849996,383220890,380070779
29378066_850029,CM021102.1,3,29378066,382370894,2318140,850029,383220923,380070812
29380191_847538,CM021102.1,3,29380191,382378457,3659711,847538,383225995,380075884
29378914_907273,CM021102.1,3,29378914,382370894,1875817,907273,383278167,380128056
29378914_912951,CM021102.1,3,29378914,382370894,1875817,912951,383283845,380133734
29381055_1040126,CM021102.1,3,29381055,382370893,1203448,1040126,383411019,380260908
29381055_1040774,CM021102.1,3,29381055,382370893,1203448,1040774,383411667,380261556
29381055_1040811,CM021102.1,3,29381055,382370893,1203448,1040811,383411704,380261593
29378632_1067533,CM021102.1,3,29378632,382370892,2335550,1067533,383438425,380288314
29378632_1068690,CM021102.1,3,29378632,382370892,2335550,1068690,383439582,380289471
29378632_1068770,CM021102.1,3,29378632,382370892,2335550,1068770,383439662,380289551
29378632_1068828,CM021102.1,3,29378632,382370892,2335550,1068828,383439720,380289609
29378914_1104120,CM021102.1,3,29378914,382370894,1875817,1104120,383475014,380324903
29381187_1263841,CM021102.1,3,29381187,382382802,2945002,1263841,383646643,380496532
29381187_1263843,CM021102.1,3,29381187,382382802,2945002,1263843,383646645,380496534
29381187_1263962,CM021102.1,3,29381187,382382802,2945002,1263962,383646764,380496653
29381187_1263973,CM021102.1,3,29381187,382382802,2945002,1263973,383646775,380496664
29378351_1306776,CM021102.1,3,29378351,382382007,2726727,1306776,383688783,380538672
29378351_1310204,CM021102.1,3,29378351,382382007,2726727,1310204,383692211,380542100
29378351_1310219,CM021102.1,3,29378351,382382007,2726727,1310219,383692226,380542115
29378351_1319272,CM021102.1,3,29378351,382382007,2726727,1319272,383701279,380551168
29382054_1512656,CM021102.1,3,29382054,382370893,3799526,1512656,383883549,380733438
29381420_1586059,CM021102.1,3,29381420,382370888,4653901,1586059,383956947,380806836
29381420_1586192,CM021102.1,3,29381420,382370888,4653901,1586192,383957080,380806969
29381420_1586646,CM021102.1,3,29381420,382370888,4653901,1586646,383957534,380807423
29381420_1590317,CM021102.1,3,29381420,382370888,4653901,1590317,383961205,380811094
29381420_1590425,CM021102.1,3,29381420,382370888,4653901,1590425,383961313,380811202
29381420_1590435,CM021102.1,3,29381420,382370888,4653901,1590435,383961323,380811212
29380191_1590146,CM021102.1,3,29380191,382378457,3659711,1590146,383968603,380818492
29380191_1590202,CM021102.1,3,29380191,382378457,3659711,1590202,383968659,380818548
29380191_1590212,CM021102.1,3,29380191,382378457,3659711,1590212,383968669,380818558
29380191_1590223,CM021102.1,3,29380191,382378457,3659711,1590223,383968680,380818569
29380191_1590248,CM021102.1,3,29380191,382378457,3659711,1590248,383968705,380818594
29380191_1590252,CM021102.1,3,29380191,382378457,3659711,1590252,383968709,380818598
29380191_1590279,CM021102.1,3,29380191,382378457,3659711,1590279,383968736,380818625
29381420_1663103,CM021102.1,3,29381420,382370888,4653901,1663103,384033991,380883880
29382054_1756786,CM021102.1,3,29382054,382370893,3799526,1756786,384127679,380977568
29382054_1803604,CM021102.1,3,29382054,382370893,3799526,1803604,384174497,381024386
29382054_1804812,CM021102.1,3,29382054,382370893,3799526,1804812,384175705,381025594
29382054_1804963,CM021102.1,3,29382054,382370893,3799526,1804963,384175856,381025745
29382054_1804971,CM021102.1,3,29382054,382370893,3799526,1804971,384175864,381025753
29382054_1805012,CM021102.1,3,29382054,382370893,3799526,1805012,384175905,381025794
29378632_1888030,CM021102.1,3,29378632,382370892,2335550,1888030,384258922,381108811
29380489_2084812,CM021102.1,3,29380489,382370892,2650474,2084812,384455704,381305593
29380489_2085086,CM021102.1,3,29380489,382370892,2650474,2085086,384455978,381305867
29380489_2087176,CM021102.1,3,29380489,382370892,2650474,2087176,384458068,381307957
29381790_2162348,CM021102.1,3,29381790,382370894,2892027,2162348,384533242,381383131
29381790_2162542,CM021102.1,3,29381790,382370894,2892027,2162542,384533436,381383325
29381790_2162733,CM021102.1,3,29381790,382370894,2892027,2162733,384533627,381383516
29381790_2162831,CM021102.1,3,29381790,382370894,2892027,2162831,384533725,381383614
29381790_2162935,CM021102.1,3,29381790,382370894,2892027,2162935,384533829,381383718
29382054_2165176,CM021102.1,3,29382054,382370893,3799526,2165176,384536069,381385958
29380489_2217821,CM021102.1,3,29380489,382370892,2650474,2217821,384588713,381438602
29378351_2212319,CM021102.1,3,29378351,382382007,2726727,2212319,384594326,381444215
29378351_2212392,CM021102.1,3,29378351,382382007,2726727,2212392,384594399,381444288
29378351_2212393,CM021102.1,3,29378351,382382007,2726727,2212393,384594400,381444289
29381790_2227867,CM021102.1,3,29381790,382370894,2892027,2227867,384598761,381448650
29380489_2256035,CM021102.1,3,29380489,382370892,2650474,2256035,384626927,381476816
29381420_2285993,CM021102.1,3,29381420,382370888,4653901,2285993,384656881,381506770
29381420_2286017,CM021102.1,3,29381420,382370888,4653901,2286017,384656905,381506794
29381420_2286086,CM021102.1,3,29381420,382370888,4653901,2286086,384656974,381506863
29381420_2286118,CM021102.1,3,29381420,382370888,4653901,2286118,384657006,381506895
29381420_2286142,CM021102.1,3,29381420,382370888,4653901,2286142,384657030,381506919
29381420_2286257,CM021102.1,3,29381420,382370888,4653901,2286257,384657145,381507034
29381420_2286296,CM021102.1,3,29381420,382370888,4653901,2286296,384657184,381507073
29381420_2286355,CM021102.1,3,29381420,382370888,4653901,2286355,384657243,381507132
29381420_2286365,CM021102.1,3,29381420,382370888,4653901,2286365,384657253,381507142
29381420_2286380,CM021102.1,3,29381420,382370888,4653901,2286380,384657268,381507157
29381420_2400574,CM021102.1,3,29381420,382370888,4653901,2400574,384771462,381621351
29381420_2442815,CM021102.1,3,29381420,382370888,4653901,2442815,384813703,381663592
29381420_2442910,CM021102.1,3,29381420,382370888,4653901,2442910,384813798,381663687
29381420_2442945,CM021102.1,3,29381420,382370888,4653901,2442945,384813833,381663722
29381420_2442970,CM021102.1,3,29381420,382370888,4653901,2442970,384813858,381663747
29382054_2445154,CM021102.1,3,29382054,382370893,3799526,2445154,384816047,381665936
29382054_2445179,CM021102.1,3,29382054,382370893,3799526,2445179,384816072,381665961
29382054_2445215,CM021102.1,3,29382054,382370893,3799526,2445215,384816108,381665997
29382054_2445508,CM021102.1,3,29382054,382370893,3799526,2445508,384816401,381666290
29382054_2459782,CM021102.1,3,29382054,382370893,3799526,2459782,384830675,381680564
29382054_2459844,CM021102.1,3,29382054,382370893,3799526,2459844,384830737,381680626
29379370_2490143,CM021102.1,3,29379370,382383518,2511855,2490143,384873661,381723550
29381187_2492963,CM021102.1,3,29381187,382382802,2945002,2492963,384875765,381725654
29379370_2508583,CM021102.1,3,29379370,382383518,2511855,2508583,384892101,381741990
29379370_2508611,CM021102.1,3,29379370,382383518,2511855,2508611,384892129,381742018
29381033_2551564,CM021102.1,3,29381033,382382058,3914503,2551564,384933622,381783511
29377537_2578011,CM021102.1,3,29377537,382370892,4549370,2578011,384948903,381798792
29381420_2578838,CM021102.1,3,29381420,382370888,4653901,2578838,384949726,381799615
29381420_2578845,CM021102.1,3,29381420,382370888,4653901,2578845,384949733,381799622
29381420_2578851,CM021102.1,3,29381420,382370888,4653901,2578851,384949739,381799628
29381420_2578901,CM021102.1,3,29381420,382370888,4653901,2578901,384949789,381799678
29381420_2578928,CM021102.1,3,29381420,382370888,4653901,2578928,384949816,381799705
29381420_2612272,CM021102.1,3,29381420,382370888,4653901,2612272,384983160,381833049
29381420_2612383,CM021102.1,3,29381420,382370888,4653901,2612383,384983271,381833160
29381033_2652247,CM021102.1,3,29381033,382382058,3914503,2652247,385034305,381884194
29381033_2652301,CM021102.1,3,29381033,382382058,3914503,2652301,385034359,381884248
29382054_2807242,CM021102.1,3,29382054,382370893,3799526,2807242,385178135,382028024
29382054_2835719,CM021102.1,3,29382054,382370893,3799526,2835719,385206612,382056501
29380191_2998268,CM021102.1,3,29380191,382378457,3659711,2998268,385376725,382226614
29381033_3040582,CM021102.1,3,29381033,382382058,3914503,3040582,385422640,382272529
29381033_3040687,CM021102.1,3,29381033,382382058,3914503,3040687,385422745,382272634
29381033_3040918,CM021102.1,3,29381033,382382058,3914503,3040918,385422976,382272865
29381033_3040995,CM021102.1,3,29381033,382382058,3914503,3040995,385423053,382272942
29381033_3041063,CM021102.1,3,29381033,382382058,3914503,3041063,385423121,382273010
29381033_3041170,CM021102.1,3,29381033,382382058,3914503,3041170,385423228,382273117
29380191_3056534,CM021102.1,3,29380191,382378457,3659711,3056534,385434991,382284880
29380191_3085823,CM021102.1,3,29380191,382378457,3659711,3085823,385464280,382314169
29378637_3087752,CM021102.1,3,29378637,382382707,5402074,3087752,385470459,382320348
29378637_3087789,CM021102.1,3,29378637,382382707,5402074,3087789,385470496,382320385
29381033_3203790,CM021102.1,3,29381033,382382058,3914503,3203790,385585848,382435737
29381033_3213525,CM021102.1,3,29381033,382382058,3914503,3213525,385595583,382445472
29381033_3213635,CM021102.1,3,29381033,382382058,3914503,3213635,385595693,382445582
29378637_3245892,CM021102.1,3,29378637,382382707,5402074,3245892,385628599,382478488
29378637_3245945,CM021102.1,3,29378637,382382707,5402074,3245945,385628652,382478541
29378637_3246084,CM021102.1,3,29378637,382382707,5402074,3246084,385628791,382478680
29378637_3246513,CM021102.1,3,29378637,382382707,5402074,3246513,385629220,382479109
29378637_3246536,CM021102.1,3,29378637,382382707,5402074,3246536,385629243,382479132
29378637_3246600,CM021102.1,3,29378637,382382707,5402074,3246600,385629307,382479196
29378637_3246673,CM021102.1,3,29378637,382382707,5402074,3246673,385629380,382479269
29378637_3599563,CM021102.1,3,29378637,382382707,5402074,3599563,385982270,382832159
29378637_3599565,CM021102.1,3,29378637,382382707,5402074,3599565,385982272,382832161
29378637_3599598,CM021102.1,3,29378637,382382707,5402074,3599598,385982305,382832194
29378637_3675250,CM021102.1,3,29378637,382382707,5402074,3675250,386057957,382907846
29377537_4285073,CM021102.1,3,29377537,382370892,4549370,4285073,386655965,383505854
29377537_4285134,CM021102.1,3,29377537,382370892,4549370,4285134,386656026,383505915
29377537_4285153,CM021102.1,3,29377537,382370892,4549370,4285153,386656045,383505934
29377537_4285334,CM021102.1,3,29377537,382370892,4549370,4285334,386656226,383506115
29377537_4285353,CM021102.1,3,29377537,382370892,4549370,4285353,386656245,383506134
29377537_4285359,CM021102.1,3,29377537,382370892,4549370,4285359,386656251,383506140
29377537_4285385,CM021102.1,3,29377537,382370892,4549370,4285385,386656277,383506166
29377537_4285407,CM021102.1,3,29377537,382370892,4549370,4285407,386656299,383506188
29378637_4436867,CM021102.1,3,29378637,382382707,5402074,4436867,386819574,383669463
29378637_4701151,CM021102.1,3,29378637,382382707,5402074,4701151,387083858,383933747
29378637_4858059,CM021102.1,3,29378637,382382707,5402074,4858059,387240766,384090655
29350623_99610,CM021102.1,3,29350623,412134011,136089,99610,412233621,409083510
29350623_99635,CM021102.1,3,29350623,412134011,136089,99635,412233646,409083535
29350623_99675,CM021102.1,3,29350623,412134011,136089,99675,412233686,409083575
29350623_99717,CM021102.1,3,29350623,412134011,136089,99717,412233728,409083617
29381407_82207,CM021102.1,3,29381407,424752082,314689,82207,424834289,421684178
29381407_82210,CM021102.1,3,29381407,424752082,314689,82210,424834292,421684181
29381407_82219,CM021102.1,3,29381407,424752082,314689,82219,424834301,421684190
29381407_82221,CM021102.1,3,29381407,424752082,314689,82221,424834303,421684192
29381407_82226,CM021102.1,3,29381407,424752082,314689,82226,424834308,421684197
29381407_82227,CM021102.1,3,29381407,424752082,314689,82227,424834309,421684198
29381407_82233,CM021102.1,3,29381407,424752082,314689,82233,424834315,421684204
29381407_82235,CM021102.1,3,29381407,424752082,314689,82235,424834317,421684206
29381407_82242,CM021102.1,3,29381407,424752082,314689,82242,424834324,421684213
29381407_82266,CM021102.1,3,29381407,424752082,314689,82266,424834348,421684237
29381407_82294,CM021102.1,3,29381407,424752082,314689,82294,424834376,421684265
29381407_82570,CM021102.1,3,29381407,424752082,314689,82570,424834652,421684541
29372154_29199,CM021102.1,3,29372154,443699185,35515,29199,443728384,440578273
29372154_29226,CM021102.1,3,29372154,443699185,35515,29226,443728411,440578300
29372154_29239,CM021102.1,3,29372154,443699185,35515,29239,443728424,440578313
29372154_29365,CM021102.1,3,29372154,443699185,35515,29365,443728550,440578439
29372154_29484,CM021102.1,3,29372154,443699185,35515,29484,443728669,440578558
29379171_2769,CM021102.1,3,29379171,451655330,1267440,2769,451658099,448507988
29379171_2778,CM021102.1,3,29379171,451655330,1267440,2778,451658108,448507997
29379171_2794,CM021102.1,3,29379171,451655330,1267440,2794,451658124,448508013
29379814_8502,CM021102.1,3,29379814,451657251,1736045,8502,451665753,448515642
29379814_8534,CM021102.1,3,29379814,451657251,1736045,8534,451665785,448515674
29379814_8638,CM021102.1,3,29379814,451657251,1736045,8638,451665889,448515778
29379171_43558,CM021102.1,3,29379171,451655330,1267440,43558,451698888,448548777
29380752_58083,CM021102.1,3,29380752,451656668,1314157,58083,451714751,448564640
29380752_58119,CM021102.1,3,29380752,451656668,1314157,58119,451714787,448564676
29378811_60478,CM021102.1,3,29378811,451654973,3293145,60478,451715451,448565340
29382174_86668,CM021102.1,3,29382174,451656066,2630521,86668,451742734,448592623
29382174_86672,CM021102.1,3,29382174,451656066,2630521,86672,451742738,448592627
29382174_86847,CM021102.1,3,29382174,451656066,2630521,86847,451742913,448592802
29378811_113495,CM021102.1,3,29378811,451654973,3293145,113495,451768468,448618357
29378811_113570,CM021102.1,3,29378811,451654973,3293145,113570,451768543,448618432
29378811_113579,CM021102.1,3,29378811,451654973,3293145,113579,451768552,448618441
29378811_113695,CM021102.1,3,29378811,451654973,3293145,113695,451768668,448618557
29378811_113710,CM021102.1,3,29378811,451654973,3293145,113710,451768683,448618572
29378811_113898,CM021102.1,3,29378811,451654973,3293145,113898,451768871,448618760
29379171_120907,CM021102.1,3,29379171,451655330,1267440,120907,451776237,448626126
29379171_120980,CM021102.1,3,29379171,451655330,1267440,120980,451776310,448626199
29381926_121381,CM021102.1,3,29381926,451654976,965121,121381,451776357,448626246
29381926_121439,CM021102.1,3,29381926,451654976,965121,121439,451776415,448626304
29382174_131225,CM021102.1,3,29382174,451656066,2630521,131225,451787291,448637180
29382174_131379,CM021102.1,3,29382174,451656066,2630521,131379,451787445,448637334
29382174_131753,CM021102.1,3,29382174,451656066,2630521,131753,451787819,448637708
29382174_131830,CM021102.1,3,29382174,451656066,2630521,131830,451787896,448637785
29380752_147548,CM021102.1,3,29380752,451656668,1314157,147548,451804216,448654105
29380752_147574,CM021102.1,3,29380752,451656668,1314157,147574,451804242,448654131
29380575_203273,CM021102.1,3,29380575,451654973,453249,203273,451858246,448708135
29379171_210093,CM021102.1,3,29379171,451655330,1267440,210093,451865423,448715312
29381256_263469,CM021102.1,3,29381256,451654976,828930,263469,451918445,448768334
29381256_268545,CM021102.1,3,29381256,451654976,828930,268545,451923521,448773410
29381256_268568,CM021102.1,3,29381256,451654976,828930,268568,451923544,448773433
29379837_296466,CM021102.1,3,29379837,451657386,1000551,296466,451953852,448803741
29379837_296920,CM021102.1,3,29379837,451657386,1000551,296920,451954306,448804195
29379837_296923,CM021102.1,3,29379837,451657386,1000551,296923,451954309,448804198
29379837_296929,CM021102.1,3,29379837,451657386,1000551,296929,451954315,448804204
29379837_297001,CM021102.1,3,29379837,451657386,1000551,297001,451954387,448804276
29382174_320068,CM021102.1,3,29382174,451656066,2630521,320068,451976134,448826023
29382174_320111,CM021102.1,3,29382174,451656066,2630521,320111,451976177,448826066
29379171_322423,CM021102.1,3,29379171,451655330,1267440,322423,451977753,448827642
29379171_322437,CM021102.1,3,29379171,451655330,1267440,322437,451977767,448827656
29379837_326717,CM021102.1,3,29379837,451657386,1000551,326717,451984103,448833992
29379837_327001,CM021102.1,3,29379837,451657386,1000551,327001,451984387,448834276
29379837_327020,CM021102.1,3,29379837,451657386,1000551,327020,451984406,448834295
29382174_330270,CM021102.1,3,29382174,451656066,2630521,330270,451986336,448836225
29382174_330323,CM021102.1,3,29382174,451656066,2630521,330323,451986389,448836278
29382174_350505,CM021102.1,3,29382174,451656066,2630521,350505,452006571,448856460
29379192_374131,CM021102.1,3,29379192,451654973,1883591,374131,452029104,448878993
29379192_374132,CM021102.1,3,29379192,451654973,1883591,374132,452029105,448878994
29379192_374172,CM021102.1,3,29379192,451654973,1883591,374172,452029145,448879034
29379192_374199,CM021102.1,3,29379192,451654973,1883591,374199,452029172,448879061
29379192_374239,CM021102.1,3,29379192,451654973,1883591,374239,452029212,448879101
29379837_392708,CM021102.1,3,29379837,451657386,1000551,392708,452050094,448899983
29379837_392779,CM021102.1,3,29379837,451657386,1000551,392779,452050165,448900054
29379837_394351,CM021102.1,3,29379837,451657386,1000551,394351,452051737,448901626
29379837_394354,CM021102.1,3,29379837,451657386,1000551,394354,452051740,448901629
29379837_394369,CM021102.1,3,29379837,451657386,1000551,394369,452051755,448901644
29380575_428628,CM021102.1,3,29380575,451654973,453249,428628,452083601,448933490
29381881_479038,CM021102.1,3,29381881,451655020,6105143,479038,452134058,448983947
29381881_513816,CM021102.1,3,29381881,451655020,6105143,513816,452168836,449018725
29379814_518992,CM021102.1,3,29379814,451657251,1736045,518992,452176243,449026132
29382174_527856,CM021102.1,3,29382174,451656066,2630521,527856,452183922,449033811
29379837_527042,CM021102.1,3,29379837,451657386,1000551,527042,452184428,449034317
29379837_527115,CM021102.1,3,29379837,451657386,1000551,527115,452184501,449034390
29379837_527131,CM021102.1,3,29379837,451657386,1000551,527131,452184517,449034406
29380790_531191,CM021102.1,3,29380790,451654976,2460809,531191,452186167,449036056
29380790_537425,CM021102.1,3,29380790,451654976,2460809,537425,452192401,449042290
29380790_537517,CM021102.1,3,29380790,451654976,2460809,537517,452192493,449042382
29378215_546541,CM021102.1,3,29378215,451654976,4395712,546541,452201517,449051406
29378215_546555,CM021102.1,3,29378215,451654976,4395712,546555,452201531,449051420
29378215_546558,CM021102.1,3,29378215,451654976,4395712,546558,452201534,449051423
29378215_546563,CM021102.1,3,29378215,451654976,4395712,546563,452201539,449051428
29378215_546565,CM021102.1,3,29378215,451654976,4395712,546565,452201541,449051430
29378215_546647,CM021102.1,3,29378215,451654976,4395712,546647,452201623,449051512
29378215_546686,CM021102.1,3,29378215,451654976,4395712,546686,452201662,449051551
29380790_553434,CM021102.1,3,29380790,451654976,2460809,553434,452208410,449058299
29379837_563987,CM021102.1,3,29379837,451657386,1000551,563987,452221373,449071262
29379837_564429,CM021102.1,3,29379837,451657386,1000551,564429,452221815,449071704
29380790_589607,CM021102.1,3,29380790,451654976,2460809,589607,452244583,449094472
29379217_603873,CM021102.1,3,29379217,451657801,3707992,603873,452261674,449111563
29379171_606884,CM021102.1,3,29379171,451655330,1267440,606884,452262214,449112103
29380733_644166,CM021102.1,3,29380733,451654973,4299829,644166,452299139,449149028
29380733_644233,CM021102.1,3,29380733,451654973,4299829,644233,452299206,449149095
29379171_664564,CM021102.1,3,29379171,451655330,1267440,664564,452319894,449169783
29379840_666013,CM021102.1,3,29379840,451654976,1349691,666013,452320989,449170878
29379840_666049,CM021102.1,3,29379840,451654976,1349691,666049,452321025,449170914
29379840_666141,CM021102.1,3,29379840,451654976,1349691,666141,452321117,449171006
29379840_666164,CM021102.1,3,29379840,451654976,1349691,666164,452321140,449171029
29380790_682149,CM021102.1,3,29380790,451654976,2460809,682149,452337125,449187014
29379837_739423,CM021102.1,3,29379837,451657386,1000551,739423,452396809,449246698
29379171_750090,CM021102.1,3,29379171,451655330,1267440,750090,452405420,449255309
29379171_750161,CM021102.1,3,29379171,451655330,1267440,750161,452405491,449255380
29379171_750166,CM021102.1,3,29379171,451655330,1267440,750166,452405496,449255385
29379837_755808,CM021102.1,3,29379837,451657386,1000551,755808,452413194,449263083
29382174_829124,CM021102.1,3,29382174,451656066,2630521,829124,452485190,449335079
29382174_829143,CM021102.1,3,29382174,451656066,2630521,829143,452485209,449335098
29382174_833363,CM021102.1,3,29382174,451656066,2630521,833363,452489429,449339318
29382174_833436,CM021102.1,3,29382174,451656066,2630521,833436,452489502,449339391
29382174_833478,CM021102.1,3,29382174,451656066,2630521,833478,452489544,449339433
29379192_872508,CM021102.1,3,29379192,451654973,1883591,872508,452527481,449377370
29379192_872598,CM021102.1,3,29379192,451654973,1883591,872598,452527571,449377460
29379192_872605,CM021102.1,3,29379192,451654973,1883591,872605,452527578,449377467
29379192_872621,CM021102.1,3,29379192,451654973,1883591,872621,452527594,449377483
29379192_872632,CM021102.1,3,29379192,451654973,1883591,872632,452527605,449377494
29379192_872661,CM021102.1,3,29379192,451654973,1883591,872661,452527634,449377523
29379192_872668,CM021102.1,3,29379192,451654973,1883591,872668,452527641,449377530
29379192_872700,CM021102.1,3,29379192,451654973,1883591,872700,452527673,449377562
29379837_894833,CM021102.1,3,29379837,451657386,1000551,894833,452552219,449402108
29379837_894852,CM021102.1,3,29379837,451657386,1000551,894852,452552238,449402127
29381881_915790,CM021102.1,3,29381881,451655020,6105143,915790,452570810,449420699
29381881_915870,CM021102.1,3,29381881,451655020,6105143,915870,452570890,449420779
29380752_942948,CM021102.1,3,29380752,451656668,1314157,942948,452599616,449449505
29380752_942969,CM021102.1,3,29380752,451656668,1314157,942969,452599637,449449526
29380752_943079,CM021102.1,3,29380752,451656668,1314157,943079,452599747,449449636
29379217_1021292,CM021102.1,3,29379217,451657801,3707992,1021292,452679093,449528982
29379217_1021392,CM021102.1,3,29379217,451657801,3707992,1021392,452679193,449529082
29379217_1021453,CM021102.1,3,29379217,451657801,3707992,1021453,452679254,449529143
29379217_1021463,CM021102.1,3,29379217,451657801,3707992,1021463,452679264,449529153
29379217_1021471,CM021102.1,3,29379217,451657801,3707992,1021471,452679272,449529161
29379217_1021506,CM021102.1,3,29379217,451657801,3707992,1021506,452679307,449529196
29379217_1021536,CM021102.1,3,29379217,451657801,3707992,1021536,452679337,449529226
29379612_1063652,CM021102.1,3,29379612,451654973,3317721,1063652,452718625,449568514
29378811_1145268,CM021102.1,3,29378811,451654973,3293145,1145268,452800241,449650130
29379814_1150113,CM021102.1,3,29379814,451657251,1736045,1150113,452807364,449657253
29379814_1150132,CM021102.1,3,29379814,451657251,1736045,1150132,452807383,449657272
29379814_1150133,CM021102.1,3,29379814,451657251,1736045,1150133,452807384,449657273
29379814_1150171,CM021102.1,3,29379814,451657251,1736045,1150171,452807422,449657311
29379814_1150204,CM021102.1,3,29379814,451657251,1736045,1150204,452807455,449657344
29379814_1150223,CM021102.1,3,29379814,451657251,1736045,1150223,452807474,449657363
29379814_1150237,CM021102.1,3,29379814,451657251,1736045,1150237,452807488,449657377
29379814_1150243,CM021102.1,3,29379814,451657251,1736045,1150243,452807494,449657383
29379814_1150261,CM021102.1,3,29379814,451657251,1736045,1150261,452807512,449657401
29379814_1150274,CM021102.1,3,29379814,451657251,1736045,1150274,452807525,449657414
29381881_1222332,CM021102.1,3,29381881,451655020,6105143,1222332,452877352,449727241
29381881_1222333,CM021102.1,3,29381881,451655020,6105143,1222333,452877353,449727242
29381881_1222369,CM021102.1,3,29381881,451655020,6105143,1222369,452877389,449727278
29381881_1222385,CM021102.1,3,29381881,451655020,6105143,1222385,452877405,449727294
29381881_1222399,CM021102.1,3,29381881,451655020,6105143,1222399,452877419,449727308
29381881_1222443,CM021102.1,3,29381881,451655020,6105143,1222443,452877463,449727352
29381881_1263028,CM021102.1,3,29381881,451655020,6105143,1263028,452918048,449767937
29381881_1263043,CM021102.1,3,29381881,451655020,6105143,1263043,452918063,449767952
29381881_1263116,CM021102.1,3,29381881,451655020,6105143,1263116,452918136,449768025
29381881_1263151,CM021102.1,3,29381881,451655020,6105143,1263151,452918171,449768060
29381881_1263155,CM021102.1,3,29381881,451655020,6105143,1263155,452918175,449768064
29381881_1263208,CM021102.1,3,29381881,451655020,6105143,1263208,452918228,449768117
29381532_1285612,CM021102.1,3,29381532,451655865,5293243,1285612,452941477,449791366
29381532_1298403,CM021102.1,3,29381532,451655865,5293243,1298403,452954268,449804157
29381881_1302645,CM021102.1,3,29381881,451655020,6105143,1302645,452957665,449807554
29381881_1303367,CM021102.1,3,29381881,451655020,6105143,1303367,452958387,449808276
29379576_1387464,CM021102.1,3,29379576,451654976,1446056,1387464,453042440,449892329
29378215_1503742,CM021102.1,3,29378215,451654976,4395712,1503742,453158718,450008607
29378215_1503821,CM021102.1,3,29378215,451654976,4395712,1503821,453158797,450008686
29378215_1503878,CM021102.1,3,29378215,451654976,4395712,1503878,453158854,450008743
29378215_1503883,CM021102.1,3,29378215,451654976,4395712,1503883,453158859,450008748
29378215_1503894,CM021102.1,3,29378215,451654976,4395712,1503894,453158870,450008759
29378215_1503895,CM021102.1,3,29378215,451654976,4395712,1503895,453158871,450008760
29382174_1545733,CM021102.1,3,29382174,451656066,2630521,1545733,453201799,450051688
29382174_1562860,CM021102.1,3,29382174,451656066,2630521,1562860,453218926,450068815
29378811_1595820,CM021102.1,3,29378811,451654973,3293145,1595820,453250793,450100682
29379217_1758241,CM021102.1,3,29379217,451657801,3707992,1758241,453416042,450265931
29379217_1758405,CM021102.1,3,29379217,451657801,3707992,1758405,453416206,450266095
29379217_1794183,CM021102.1,3,29379217,451657801,3707992,1794183,453451984,450301873
29379217_1794213,CM021102.1,3,29379217,451657801,3707992,1794213,453452014,450301903
29379217_1794227,CM021102.1,3,29379217,451657801,3707992,1794227,453452028,450301917
29379612_1851370,CM021102.1,3,29379612,451654973,3317721,1851370,453506343,450356232
29379612_1851385,CM021102.1,3,29379612,451654973,3317721,1851385,453506358,450356247
29379217_1956816,CM021102.1,3,29379217,451657801,3707992,1956816,453614617,450464506
29379217_1956877,CM021102.1,3,29379217,451657801,3707992,1956877,453614678,450464567
29379217_1956927,CM021102.1,3,29379217,451657801,3707992,1956927,453614728,450464617
29379217_1956967,CM021102.1,3,29379217,451657801,3707992,1956967,453614768,450464657
29377381_2041567,CM021102.1,3,29377381,451654975,2814755,2041567,453696542,450546431
29377381_2061182,CM021102.1,3,29377381,451654975,2814755,2061182,453716157,450566046
29377381_2101014,CM021102.1,3,29377381,451654975,2814755,2101014,453755989,450605878
29377381_2101079,CM021102.1,3,29377381,451654975,2814755,2101079,453756054,450605943
29377381_2101521,CM021102.1,3,29377381,451654975,2814755,2101521,453756496,450606385
29377381_2101564,CM021102.1,3,29377381,451654975,2814755,2101564,453756539,450606428
29382174_2110321,CM021102.1,3,29382174,451656066,2630521,2110321,453766387,450616276
29382174_2110342,CM021102.1,3,29382174,451656066,2630521,2110342,453766408,450616297
29382174_2110534,CM021102.1,3,29382174,451656066,2630521,2110534,453766600,450616489
29382174_2110550,CM021102.1,3,29382174,451656066,2630521,2110550,453766616,450616505
29377381_2135129,CM021102.1,3,29377381,451654975,2814755,2135129,453790104,450639993
29377381_2135304,CM021102.1,3,29377381,451654975,2814755,2135304,453790279,450640168
29377381_2135320,CM021102.1,3,29377381,451654975,2814755,2135320,453790295,450640184
29379217_2146566,CM021102.1,3,29379217,451657801,3707992,2146566,453804367,450654256
29379217_2146588,CM021102.1,3,29379217,451657801,3707992,2146588,453804389,450654278
29379217_2146664,CM021102.1,3,29379217,451657801,3707992,2146664,453804465,450654354
29379612_2260298,CM021102.1,3,29379612,451654973,3317721,2260298,453915271,450765160
29379612_2265941,CM021102.1,3,29379612,451654973,3317721,2265941,453920914,450770803
29379612_2269005,CM021102.1,3,29379612,451654973,3317721,2269005,453923978,450773867
29380733_2306228,CM021102.1,3,29380733,451654973,4299829,2306228,453961201,450811090
29382174_2408727,CM021102.1,3,29382174,451656066,2630521,2408727,454064793,450914682
29382174_2408773,CM021102.1,3,29382174,451656066,2630521,2408773,454064839,450914728
29382174_2408782,CM021102.1,3,29382174,451656066,2630521,2408782,454064848,450914737
29382174_2409067,CM021102.1,3,29382174,451656066,2630521,2409067,454065133,450915022
29380733_2434446,CM021102.1,3,29380733,451654973,4299829,2434446,454089419,450939308
29380733_2434508,CM021102.1,3,29380733,451654973,4299829,2434508,454089481,450939370
29379612_2517800,CM021102.1,3,29379612,451654973,3317721,2517800,454172773,451022662
29382174_2564355,CM021102.1,3,29382174,451656066,2630521,2564355,454220421,451070310
29382174_2564390,CM021102.1,3,29382174,451656066,2630521,2564390,454220456,451070345
29382174_2564430,CM021102.1,3,29382174,451656066,2630521,2564430,454220496,451070385
29378215_2615681,CM021102.1,3,29378215,451654976,4395712,2615681,454270657,451120546
29381881_2615778,CM021102.1,3,29381881,451655020,6105143,2615778,454270798,451120687
29381881_2620189,CM021102.1,3,29381881,451655020,6105143,2620189,454275209,451125098
29381532_2665930,CM021102.1,3,29381532,451655865,5293243,2665930,454321795,451171684
29379217_2733392,CM021102.1,3,29379217,451657801,3707992,2733392,454391193,451241082
29379217_2733445,CM021102.1,3,29379217,451657801,3707992,2733445,454391246,451241135
29379217_2734149,CM021102.1,3,29379217,451657801,3707992,2734149,454391950,451241839
29379217_2734151,CM021102.1,3,29379217,451657801,3707992,2734151,454391952,451241841
29381881_2777247,CM021102.1,3,29381881,451655020,6105143,2777247,454432267,451282156
29381881_2777346,CM021102.1,3,29381881,451655020,6105143,2777346,454432366,451282255
29381881_2777640,CM021102.1,3,29381881,451655020,6105143,2777640,454432660,451282549
29379217_2867710,CM021102.1,3,29379217,451657801,3707992,2867710,454525511,451375400
29379217_2867802,CM021102.1,3,29379217,451657801,3707992,2867802,454525603,451375492
29378811_2889610,CM021102.1,3,29378811,451654973,3293145,2889610,454544583,451394472
29378811_2889628,CM021102.1,3,29378811,451654973,3293145,2889628,454544601,451394490
29379217_2913222,CM021102.1,3,29379217,451657801,3707992,2913222,454571023,451420912
29379217_2913228,CM021102.1,3,29379217,451657801,3707992,2913228,454571029,451420918
29379217_2913275,CM021102.1,3,29379217,451657801,3707992,2913275,454571076,451420965
29379217_2913348,CM021102.1,3,29379217,451657801,3707992,2913348,454571149,451421038
29379217_2913386,CM021102.1,3,29379217,451657801,3707992,2913386,454571187,451421076
29379217_2913438,CM021102.1,3,29379217,451657801,3707992,2913438,454571239,451421128
29381881_3045647,CM021102.1,3,29381881,451655020,6105143,3045647,454700667,451550556
29379217_3089397,CM021102.1,3,29379217,451657801,3707992,3089397,454747198,451597087
29379217_3089409,CM021102.1,3,29379217,451657801,3707992,3089409,454747210,451597099
29379217_3089479,CM021102.1,3,29379217,451657801,3707992,3089479,454747280,451597169
29379217_3089514,CM021102.1,3,29379217,451657801,3707992,3089514,454747315,451597204
29379217_3091565,CM021102.1,3,29379217,451657801,3707992,3091565,454749366,451599255
29379217_3091768,CM021102.1,3,29379217,451657801,3707992,3091768,454749569,451599458
29379217_3173542,CM021102.1,3,29379217,451657801,3707992,3173542,454831343,451681232
29378215_3560800,CM021102.1,3,29378215,451654976,4395712,3560800,455215776,452065665
29378215_3598793,CM021102.1,3,29378215,451654976,4395712,3598793,455253769,452103658
29378215_3598799,CM021102.1,3,29378215,451654976,4395712,3598799,455253775,452103664
29378215_3598845,CM021102.1,3,29378215,451654976,4395712,3598845,455253821,452103710
29378215_3753266,CM021102.1,3,29378215,451654976,4395712,3753266,455408242,452258131
29378215_3771595,CM021102.1,3,29378215,451654976,4395712,3771595,455426571,452276460
29378215_3771600,CM021102.1,3,29378215,451654976,4395712,3771600,455426576,452276465
29378215_3771612,CM021102.1,3,29378215,451654976,4395712,3771612,455426588,452276477
29378215_3771622,CM021102.1,3,29378215,451654976,4395712,3771622,455426598,452276487
29378215_3771669,CM021102.1,3,29378215,451654976,4395712,3771669,455426645,452276534
29378978_4810,CM021102.1,3,29378978,455431665,423226,4810,455436475,452286364
29378978_4819,CM021102.1,3,29378978,455431665,423226,4819,455436484,452286373
29379256_72783,CM021102.1,3,29379256,455431665,1383123,72783,455504448,452354337
29377507_88405,CM021102.1,3,29377507,455431665,1230207,88405,455520070,452369959
29382009_227853,CM021102.1,3,29382009,455431664,650240,227853,455659517,452509406
29382009_227870,CM021102.1,3,29382009,455431664,650240,227870,455659534,452509423
29382009_227917,CM021102.1,3,29382009,455431664,650240,227917,455659581,452509470
29382009_227943,CM021102.1,3,29382009,455431664,650240,227943,455659607,452509496
29378215_4269319,CM021102.1,3,29378215,451654976,4395712,4269319,455924295,452774184
29378215_4269320,CM021102.1,3,29378215,451654976,4395712,4269320,455924296,452774185
29378215_4269829,CM021102.1,3,29378215,451654976,4395712,4269829,455924805,452774694
29377262_523855,CM021102.1,3,29377262,455431664,6012552,523855,455955519,452805408
29377262_2283894,CM021102.1,3,29377262,455431664,6012552,2283894,457715558,454565447
29377262_2788051,CM021102.1,3,29377262,455431664,6012552,2788051,458219715,455069604
29377262_2788090,CM021102.1,3,29377262,455431664,6012552,2788090,458219754,455069643
29377262_2788658,CM021102.1,3,29377262,455431664,6012552,2788658,458220322,455070211
29377262_4356505,CM021102.1,3,29377262,455431664,6012552,4356505,459788169,456638058
29377262_4356520,CM021102.1,3,29377262,455431664,6012552,4356520,459788184,456638073
29377262_4356524,CM021102.1,3,29377262,455431664,6012552,4356524,459788188,456638077
29364843_38912,CM021102.1,3,29364843,464516993,68286,38912,464555905,461405794
29364843_38919,CM021102.1,3,29364843,464516993,68286,38919,464555912,461405801
29364843_38959,CM021102.1,3,29364843,464516993,68286,38959,464555952,461405841
29364843_38983,CM021102.1,3,29364843,464516993,68286,38983,464555976,461405865
29364843_38986,CM021102.1,3,29364843,464516993,68286,38986,464555979,461405868
29364843_39011,CM021102.1,3,29364843,464516993,68286,39011,464556004,461405893
29364843_39018,CM021102.1,3,29364843,464516993,68286,39018,464556011,461405900
29364843_39040,CM021102.1,3,29364843,464516993,68286,39040,464556033,461405922
29364843_39042,CM021102.1,3,29364843,464516993,68286,39042,464556035,461405924
29364843_39078,CM021102.1,3,29364843,464516993,68286,39078,464556071,461405960
29369402_12181,CM021102.1,3,29369402,493587027,14913,12181,493599208,490449097
29369402_12306,CM021102.1,3,29369402,493587027,14913,12306,493599333,490449222
29347853_13589,CM021102.1,3,29347853,493603612,32257,13589,493617201,490467090
29380931_140238,CM021102.1,3,29380931,493587026,7771211,140238,493727264,490577153
29380931_140255,CM021102.1,3,29380931,493587026,7771211,140255,493727281,490577170
29380931_162014,CM021102.1,3,29380931,493587026,7771211,162014,493749040,490598929
29380931_162017,CM021102.1,3,29380931,493587026,7771211,162017,493749043,490598932
29377178_150105,CM021102.1,3,29377178,493600396,285497,150105,493750501,490600390
29377178_150128,CM021102.1,3,29377178,493600396,285497,150128,493750524,490600413
29377992_151817,CM021102.1,3,29377992,493598786,900020,151817,493750603,490600492
29379933_214535,CM021102.1,3,29379933,493587031,4236918,214535,493801566,490651455
29379728_289711,CM021102.1,3,29379728,493587031,3079353,289711,493876742,490726631
29377178_280499,CM021102.1,3,29377178,493600396,285497,280499,493880895,490730784
29377178_280523,CM021102.1,3,29377178,493600396,285497,280523,493880919,490730808
29381242_323048,CM021102.1,3,29381242,493587027,4242046,323048,493910075,490759964
29378159_325720,CM021102.1,3,29378159,493587024,3056525,325720,493912744,490762633
29378480_370880,CM021102.1,3,29378480,493597415,1651650,370880,493968295,490818184
29378480_370890,CM021102.1,3,29378480,493597415,1651650,370890,493968305,490818194
29378480_370958,CM021102.1,3,29378480,493597415,1651650,370958,493968373,490818262
29378480_370959,CM021102.1,3,29378480,493597415,1651650,370959,493968374,490818263
29378480_370966,CM021102.1,3,29378480,493597415,1651650,370966,493968381,490818270
29378480_370992,CM021102.1,3,29378480,493597415,1651650,370992,493968407,490818296
29378480_371004,CM021102.1,3,29378480,493597415,1651650,371004,493968419,490818308
29379728_438425,CM021102.1,3,29379728,493587031,3079353,438425,494025456,490875345
29370944_433992,CM021102.1,3,29370944,493598556,510972,433992,494032548,490882437
29370944_434037,CM021102.1,3,29370944,493598556,510972,434037,494032593,490882482
29370944_434038,CM021102.1,3,29370944,493598556,510972,434038,494032594,490882483
29378480_450636,CM021102.1,3,29378480,493597415,1651650,450636,494048051,490897940
29378480_450737,CM021102.1,3,29378480,493597415,1651650,450737,494048152,490898041
29380931_476004,CM021102.1,3,29380931,493587026,7771211,476004,494063030,490912919
29380931_476129,CM021102.1,3,29380931,493587026,7771211,476129,494063155,490913044
29380931_476195,CM021102.1,3,29380931,493587026,7771211,476195,494063221,490913110
29380931_536614,CM021102.1,3,29380931,493587026,7771211,536614,494123640,490973529
29380931_536691,CM021102.1,3,29380931,493587026,7771211,536691,494123717,490973606
29380931_540154,CM021102.1,3,29380931,493587026,7771211,540154,494127180,490977069
29378159_544355,CM021102.1,3,29378159,493587024,3056525,544355,494131379,490981268
29378159_544359,CM021102.1,3,29378159,493587024,3056525,544359,494131383,490981272
29378159_544362,CM021102.1,3,29378159,493587024,3056525,544362,494131386,490981275
29378159_544377,CM021102.1,3,29378159,493587024,3056525,544377,494131401,490981290
29378159_544430,CM021102.1,3,29378159,493587024,3056525,544430,494131454,490981343
29378159_544440,CM021102.1,3,29378159,493587024,3056525,544440,494131464,490981353
29378159_544488,CM021102.1,3,29378159,493587024,3056525,544488,494131512,490981401
29380931_559822,CM021102.1,3,29380931,493587026,7771211,559822,494146848,490996737
29380931_559887,CM021102.1,3,29380931,493587026,7771211,559887,494146913,490996802
29378480_554520,CM021102.1,3,29378480,493597415,1651650,554520,494151935,491001824
29378480_558647,CM021102.1,3,29378480,493597415,1651650,558647,494156062,491005951
29378480_558698,CM021102.1,3,29378480,493597415,1651650,558698,494156113,491006002
29378480_558704,CM021102.1,3,29378480,493597415,1651650,558704,494156119,491006008
29378480_558713,CM021102.1,3,29378480,493597415,1651650,558713,494156128,491006017
29378480_558725,CM021102.1,3,29378480,493597415,1651650,558725,494156140,491006029
29378480_558776,CM021102.1,3,29378480,493597415,1651650,558776,494156191,491006080
29378480_558897,CM021102.1,3,29378480,493597415,1651650,558897,494156312,491006201
29380023_576113,CM021102.1,3,29380023,493598111,774650,576113,494174224,491024113
29380023_576181,CM021102.1,3,29380023,493598111,774650,576181,494174292,491024181
29381242_608335,CM021102.1,3,29381242,493587027,4242046,608335,494195362,491045251
29377992_611312,CM021102.1,3,29377992,493598786,900020,611312,494210098,491059987
29377992_611726,CM021102.1,3,29377992,493598786,900020,611726,494210512,491060401
29380931_625541,CM021102.1,3,29380931,493587026,7771211,625541,494212567,491062456
29381242_639629,CM021102.1,3,29381242,493587027,4242046,639629,494226656,491076545
29377992_646990,CM021102.1,3,29377992,493598786,900020,646990,494245776,491095665
29377992_647002,CM021102.1,3,29377992,493598786,900020,647002,494245788,491095677
29377992_647269,CM021102.1,3,29377992,493598786,900020,647269,494246055,491095944
29377992_647532,CM021102.1,3,29377992,493598786,900020,647532,494246318,491096207
29377992_651201,CM021102.1,3,29377992,493598786,900020,651201,494249987,491099876
29377992_676085,CM021102.1,3,29377992,493598786,900020,676085,494274871,491124760
29377992_676439,CM021102.1,3,29377992,493598786,900020,676439,494275225,491125114
29377992_680500,CM021102.1,3,29377992,493598786,900020,680500,494279286,491129175
29377992_680902,CM021102.1,3,29377992,493598786,900020,680902,494279688,491129577
29377992_680969,CM021102.1,3,29377992,493598786,900020,680969,494279755,491129644
29378184_891793,CM021102.1,3,29378184,493598197,1927642,891793,494489990,491339879
29381564_957416,CM021102.1,3,29381564,493599875,1445938,957416,494557291,491407180
29379728_1162666,CM021102.1,3,29379728,493587031,3079353,1162666,494749697,491599586
29378184_1163386,CM021102.1,3,29378184,493598197,1927642,1163386,494761583,491611472
29378184_1163626,CM021102.1,3,29378184,493598197,1927642,1163626,494761823,491611712
29378480_1189031,CM021102.1,3,29378480,493597415,1651650,1189031,494786446,491636335
29378480_1307569,CM021102.1,3,29378480,493597415,1651650,1307569,494904984,491754873
29378480_1307698,CM021102.1,3,29378480,493597415,1651650,1307698,494905113,491755002
29378480_1307770,CM021102.1,3,29378480,493597415,1651650,1307770,494905185,491755074
29378480_1307821,CM021102.1,3,29378480,493597415,1651650,1307821,494905236,491755125
29378480_1307966,CM021102.1,3,29378480,493597415,1651650,1307966,494905381,491755270
29379728_1410142,CM021102.1,3,29379728,493587031,3079353,1410142,494997173,491847062
29380238_1744605,CM021102.1,3,29380238,493592268,1929325,1744605,495336873,492186762
29380238_1747097,CM021102.1,3,29380238,493592268,1929325,1747097,495339365,492189254
29380238_1747124,CM021102.1,3,29380238,493592268,1929325,1747124,495339392,492189281
29380238_1747892,CM021102.1,3,29380238,493592268,1929325,1747892,495340160,492190049
29380238_1747922,CM021102.1,3,29380238,493592268,1929325,1747922,495340190,492190079
29380238_1753089,CM021102.1,3,29380238,493592268,1929325,1753089,495345357,492195246
29381852_1773286,CM021102.1,3,29381852,493587031,2881866,1773286,495360317,492210206
29378184_1887318,CM021102.1,3,29378184,493598197,1927642,1887318,495485515,492335404
29380931_1916014,CM021102.1,3,29380931,493587026,7771211,1916014,495503040,492352929
29380931_1996422,CM021102.1,3,29380931,493587026,7771211,1996422,495583448,492433337
29380931_1997137,CM021102.1,3,29380931,493587026,7771211,1997137,495584163,492434052
29379933_2009404,CM021102.1,3,29379933,493587031,4236918,2009404,495596435,492446324
29379933_2009426,CM021102.1,3,29379933,493587031,4236918,2009426,495596457,492446346
29379933_2009541,CM021102.1,3,29379933,493587031,4236918,2009541,495596572,492446461
29379933_2019020,CM021102.1,3,29379933,493587031,4236918,2019020,495606051,492455940
29381242_2543706,CM021102.1,3,29381242,493587027,4242046,2543706,496130733,492980622
29380278_601751,CM021102.1,3,29380278,495587406,1472547,601751,496189157,493039046
29380278_604790,CM021102.1,3,29380278,495587406,1472547,604790,496192196,493042085
29380278_604814,CM021102.1,3,29380278,495587406,1472547,604814,496192220,493042109
29379728_2667100,CM021102.1,3,29379728,493587031,3079353,2667100,496254131,493104020
29379728_2667146,CM021102.1,3,29379728,493587031,3079353,2667146,496254177,493104066
29380278_694760,CM021102.1,3,29380278,495587406,1472547,694760,496282166,493132055
29380278_771661,CM021102.1,3,29380278,495587406,1472547,771661,496359067,493208956
29380278_771667,CM021102.1,3,29380278,495587406,1472547,771667,496359073,493208962
29380278_771904,CM021102.1,3,29380278,495587406,1472547,771904,496359310,493209199
29379933_2852003,CM021102.1,3,29379933,493587031,4236918,2852003,496439034,493288923
29378159_2933900,CM021102.1,3,29378159,493587024,3056525,2933900,496520924,493370813
29378159_2933944,CM021102.1,3,29378159,493587024,3056525,2933944,496520968,493370857
29378159_2933947,CM021102.1,3,29378159,493587024,3056525,2933947,496520971,493370860
29378159_2934242,CM021102.1,3,29378159,493587024,3056525,2934242,496521266,493371155
29378159_2934263,CM021102.1,3,29378159,493587024,3056525,2934263,496521287,493371176
29378159_2934305,CM021102.1,3,29378159,493587024,3056525,2934305,496521329,493371218
29378159_2934348,CM021102.1,3,29378159,493587024,3056525,2934348,496521372,493371261
29378159_2942359,CM021102.1,3,29378159,493587024,3056525,2942359,496529383,493379272
29380278_1053367,CM021102.1,3,29380278,495587406,1472547,1053367,496640773,493490662
29380278_1059042,CM021102.1,3,29380278,495587406,1472547,1059042,496646448,493496337
29379933_3361215,CM021102.1,3,29379933,493587031,4236918,3361215,496948246,493798135
29379933_3361228,CM021102.1,3,29379933,493587031,4236918,3361228,496948259,493798148
29379933_3361314,CM021102.1,3,29379933,493587031,4236918,3361314,496948345,493798234
29379933_3361436,CM021102.1,3,29379933,493587031,4236918,3361436,496948467,493798356
29380931_4143765,CM021102.1,3,29380931,493587026,7771211,4143765,497730791,494580680
29380931_4144510,CM021102.1,3,29380931,493587026,7771211,4144510,497731536,494581425
29380931_6765297,CM021102.1,3,29380931,493587026,7771211,6765297,500352323,497202212
29380931_7599147,CM021102.1,3,29380931,493587026,7771211,7599147,501186173,498036062
29380931_7599308,CM021102.1,3,29380931,493587026,7771211,7599308,501186334,498036223
29379023_521,CM021102.1,3,29379023,508820777,3651961,521,508821298,505671187
29342185_12181,CM021102.1,3,29342185,508816825,27169,12181,508829006,505678895
29342185_12232,CM021102.1,3,29342185,508816825,27169,12232,508829057,505678946
29382290_20019,CM021102.1,3,29382290,508816826,3499087,20019,508836845,505686734
29382290_20025,CM021102.1,3,29382290,508816826,3499087,20025,508836851,505686740
29382290_20437,CM021102.1,3,29382290,508816826,3499087,20437,508837263,505687152
29382222_56042,CM021102.1,3,29382222,508816827,521794,56042,508872869,505722758
29382222_56126,CM021102.1,3,29382222,508816827,521794,56126,508872953,505722842
29382222_56294,CM021102.1,3,29382222,508816827,521794,56294,508873121,505723010
29382222_56297,CM021102.1,3,29382222,508816827,521794,56297,508873124,505723013
29377608_61196,CM021102.1,3,29377608,508816827,97331,61196,508878023,505727912
29377608_61203,CM021102.1,3,29377608,508816827,97331,61203,508878030,505727919
29377608_61208,CM021102.1,3,29377608,508816827,97331,61208,508878035,505727924
29377608_61260,CM021102.1,3,29377608,508816827,97331,61260,508878087,505727976
29377608_61264,CM021102.1,3,29377608,508816827,97331,61264,508878091,505727980
29377608_61308,CM021102.1,3,29377608,508816827,97331,61308,508878135,505728024
29377608_61343,CM021102.1,3,29377608,508816827,97331,61343,508878170,505728059
29377608_61347,CM021102.1,3,29377608,508816827,97331,61347,508878174,505728063
29341468_93084,CM021102.1,3,29341468,508816824,216571,93084,508909908,505759797
29341468_93096,CM021102.1,3,29341468,508816824,216571,93096,508909920,505759809
29341468_93148,CM021102.1,3,29341468,508816824,216571,93148,508909972,505759861
29381860_114812,CM021102.1,3,29381860,508816825,1182195,114812,508931637,505781526
29381860_115017,CM021102.1,3,29381860,508816825,1182195,115017,508931842,505781731
29381860_115061,CM021102.1,3,29381860,508816825,1182195,115061,508931886,505781775
29378418_116152,CM021102.1,3,29378418,508816827,827256,116152,508932979,505782868
29382371_123830,CM021102.1,3,29382371,508816826,3554722,123830,508940656,505790545
29382290_143986,CM021102.1,3,29382290,508816826,3499087,143986,508960812,505810701
29382290_144042,CM021102.1,3,29382290,508816826,3499087,144042,508960868,505810757
29382290_144046,CM021102.1,3,29382290,508816826,3499087,144046,508960872,505810761
29382290_144080,CM021102.1,3,29382290,508816826,3499087,144080,508960906,505810795
29382290_144101,CM021102.1,3,29382290,508816826,3499087,144101,508960927,505810816
29382290_144121,CM021102.1,3,29382290,508816826,3499087,144121,508960947,505810836
29382290_146562,CM021102.1,3,29382290,508816826,3499087,146562,508963388,505813277
29382290_146563,CM021102.1,3,29382290,508816826,3499087,146563,508963389,505813278
29382371_153689,CM021102.1,3,29382371,508816826,3554722,153689,508970515,505820404
29379857_163491,CM021102.1,3,29379857,508816827,1411066,163491,508980318,505830207
29379857_163553,CM021102.1,3,29379857,508816827,1411066,163553,508980380,505830269
29378537_176818,CM021102.1,3,29378537,508816827,732638,176818,508993645,505843534
29378537_177117,CM021102.1,3,29378537,508816827,732638,177117,508993944,505843833
29378537_222338,CM021102.1,3,29378537,508816827,732638,222338,509039165,505889054
29378537_249671,CM021102.1,3,29378537,508816827,732638,249671,509066498,505916387
29378537_249685,CM021102.1,3,29378537,508816827,732638,249685,509066512,505916401
29378537_249687,CM021102.1,3,29378537,508816827,732638,249687,509066514,505916403
29378537_249770,CM021102.1,3,29378537,508816827,732638,249770,509066597,505916486
29378418_254484,CM021102.1,3,29378418,508816827,827256,254484,509071311,505921200
29380988_331564,CM021102.1,3,29380988,508819271,717018,331564,509150835,506000724
29380988_331649,CM021102.1,3,29380988,508819271,717018,331649,509150920,506000809
29380988_331650,CM021102.1,3,29380988,508819271,717018,331650,509150921,506000810
29380988_331683,CM021102.1,3,29380988,508819271,717018,331683,509150954,506000843
29380988_331699,CM021102.1,3,29380988,508819271,717018,331699,509150970,506000859
29380988_331726,CM021102.1,3,29380988,508819271,717018,331726,509150997,506000886
29380988_331749,CM021102.1,3,29380988,508819271,717018,331749,509151020,506000909
29380988_331753,CM021102.1,3,29380988,508819271,717018,331753,509151024,506000913
29380988_331791,CM021102.1,3,29380988,508819271,717018,331791,509151062,506000951
29380988_331798,CM021102.1,3,29380988,508819271,717018,331798,509151069,506000958
29382222_358038,CM021102.1,3,29382222,508816827,521794,358038,509174865,506024754
29382222_358050,CM021102.1,3,29382222,508816827,521794,358050,509174877,506024766
29382222_358072,CM021102.1,3,29382222,508816827,521794,358072,509174899,506024788
29382371_390912,CM021102.1,3,29382371,508816826,3554722,390912,509207738,506057627
29378537_403332,CM021102.1,3,29378537,508816827,732638,403332,509220159,506070048
29378537_403351,CM021102.1,3,29378537,508816827,732638,403351,509220178,506070067
29378537_403539,CM021102.1,3,29378537,508816827,732638,403539,509220366,506070255
29380884_410231,CM021102.1,3,29380884,508820197,690864,410231,509230428,506080317
29380884_410241,CM021102.1,3,29380884,508820197,690864,410241,509230438,506080327
29380884_410281,CM021102.1,3,29380884,508820197,690864,410281,509230478,506080367
29380884_410311,CM021102.1,3,29380884,508820197,690864,410311,509230508,506080397
29380884_410359,CM021102.1,3,29380884,508820197,690864,410359,509230556,506080445
29380884_410748,CM021102.1,3,29380884,508820197,690864,410748,509230945,506080834
29380884_410790,CM021102.1,3,29380884,508820197,690864,410790,509230987,506080876
29380884_412405,CM021102.1,3,29380884,508820197,690864,412405,509232602,506082491
29380884_412467,CM021102.1,3,29380884,508820197,690864,412467,509232664,506082553
29378418_472348,CM021102.1,3,29378418,508816827,827256,472348,509289175,506139064
29382371_472536,CM021102.1,3,29382371,508816826,3554722,472536,509289362,506139251
29381613_475693,CM021102.1,3,29381613,508816825,759153,475693,509292518,506142407
29377407_481609,CM021102.1,3,29377407,508816825,1440806,481609,509298434,506148323
29380884_502903,CM021102.1,3,29380884,508820197,690864,502903,509323100,506172989
29380884_502909,CM021102.1,3,29380884,508820197,690864,502909,509323106,506172995
29380884_502927,CM021102.1,3,29380884,508820197,690864,502927,509323124,506173013
29382290_509010,CM021102.1,3,29382290,508816826,3499087,509010,509325836,506175725
29382290_509036,CM021102.1,3,29382290,508816826,3499087,509036,509325862,506175751
29382290_509129,CM021102.1,3,29382290,508816826,3499087,509129,509325955,506175844
29382371_532817,CM021102.1,3,29382371,508816826,3554722,532817,509349643,506199532
29380884_543330,CM021102.1,3,29380884,508820197,690864,543330,509363527,506213416
29380884_544193,CM021102.1,3,29380884,508820197,690864,544193,509364390,506214279
29380884_544200,CM021102.1,3,29380884,508820197,690864,544200,509364397,506214286
29379023_556163,CM021102.1,3,29379023,508820777,3651961,556163,509376940,506226829
29379023_556248,CM021102.1,3,29379023,508820777,3651961,556248,509377025,506226914
29380875_577300,CM021102.1,3,29380875,508816823,2367138,577300,509394123,506244012
29380884_580565,CM021102.1,3,29380884,508820197,690864,580565,509400762,506250651
29380988_600418,CM021102.1,3,29380988,508819271,717018,600418,509419689,506269578
29380988_600444,CM021102.1,3,29380988,508819271,717018,600444,509419715,506269604
29380884_644454,CM021102.1,3,29380884,508820197,690864,644454,509464651,506314540
29380884_644533,CM021102.1,3,29380884,508820197,690864,644533,509464730,506314619
29380884_679701,CM021102.1,3,29380884,508820197,690864,679701,509499898,506349787
29380884_679704,CM021102.1,3,29380884,508820197,690864,679704,509499901,506349790
29380884_679783,CM021102.1,3,29380884,508820197,690864,679783,509499980,506349869
29380884_679813,CM021102.1,3,29380884,508820197,690864,679813,509500010,506349899
29380884_679814,CM021102.1,3,29380884,508820197,690864,679814,509500011,506349900
29380884_679815,CM021102.1,3,29380884,508820197,690864,679815,509500012,506349901
29380884_679841,CM021102.1,3,29380884,508820197,690864,679841,509500038,506349927
29380884_679925,CM021102.1,3,29380884,508820197,690864,679925,509500122,506350011
29380884_679964,CM021102.1,3,29380884,508820197,690864,679964,509500161,506350050
29380884_680015,CM021102.1,3,29380884,508820197,690864,680015,509500212,506350101
29380884_680033,CM021102.1,3,29380884,508820197,690864,680033,509500230,506350119
29380884_680059,CM021102.1,3,29380884,508820197,690864,680059,509500256,506350145
29380884_680078,CM021102.1,3,29380884,508820197,690864,680078,509500275,506350164
29380884_680116,CM021102.1,3,29380884,508820197,690864,680116,509500313,506350202
29380884_680133,CM021102.1,3,29380884,508820197,690864,680133,509500330,506350219
29379023_681675,CM021102.1,3,29379023,508820777,3651961,681675,509502452,506352341
29379023_681677,CM021102.1,3,29379023,508820777,3651961,681677,509502454,506352343
29379023_682217,CM021102.1,3,29379023,508820777,3651961,682217,509502994,506352883
29380884_687823,CM021102.1,3,29380884,508820197,690864,687823,509508020,506357909
29380884_687855,CM021102.1,3,29380884,508820197,690864,687855,509508052,506357941
29380884_687896,CM021102.1,3,29380884,508820197,690864,687896,509508093,506357982
29380884_687910,CM021102.1,3,29380884,508820197,690864,687910,509508107,506357996
29380884_687962,CM021102.1,3,29380884,508820197,690864,687962,509508159,506358048
29378550_737848,CM021102.1,3,29378550,508820046,2616105,737848,509557894,506407783
29378550_737885,CM021102.1,3,29378550,508820046,2616105,737885,509557931,506407820
29379523_789764,CM021102.1,3,29379523,508821687,3685114,789764,509611451,506461340
29379523_790474,CM021102.1,3,29379523,508821687,3685114,790474,509612161,506462050
29379523_790530,CM021102.1,3,29379523,508821687,3685114,790530,509612217,506462106
29379023_815921,CM021102.1,3,29379023,508820777,3651961,815921,509636698,506486587
29379023_815937,CM021102.1,3,29379023,508820777,3651961,815937,509636714,506486603
29379023_815993,CM021102.1,3,29379023,508820777,3651961,815993,509636770,506486659
29379023_815994,CM021102.1,3,29379023,508820777,3651961,815994,509636771,506486660
29381860_847340,CM021102.1,3,29381860,508816825,1182195,847340,509664165,506514054
29381860_847360,CM021102.1,3,29381860,508816825,1182195,847360,509664185,506514074
29381860_847396,CM021102.1,3,29381860,508816825,1182195,847396,509664221,506514110
29381860_847407,CM021102.1,3,29381860,508816825,1182195,847407,509664232,506514121
29381860_873539,CM021102.1,3,29381860,508816825,1182195,873539,509690364,506540253
29381860_873644,CM021102.1,3,29381860,508816825,1182195,873644,509690469,506540358
29382371_907138,CM021102.1,3,29382371,508816826,3554722,907138,509723964,506573853
29377407_929923,CM021102.1,3,29377407,508816825,1440806,929923,509746748,506596637
29379523_934488,CM021102.1,3,29379523,508821687,3685114,934488,509756175,506606064
29379523_934551,CM021102.1,3,29379523,508821687,3685114,934551,509756238,506606127
29381082_946783,CM021102.1,3,29381082,508820997,5391541,946783,509767780,506617669
29378550_988043,CM021102.1,3,29378550,508820046,2616105,988043,509808089,506657978
29378550_988277,CM021102.1,3,29378550,508820046,2616105,988277,509808323,506658212
29379523_1007855,CM021102.1,3,29379523,508821687,3685114,1007855,509829542,506679431
29379523_1008192,CM021102.1,3,29379523,508821687,3685114,1008192,509829879,506679768
29380016_1038765,CM021102.1,3,29380016,508820738,6105153,1038765,509859503,506709392
29380016_1055514,CM021102.1,3,29380016,508820738,6105153,1055514,509876252,506726141
29380016_1055610,CM021102.1,3,29380016,508820738,6105153,1055610,509876348,506726237
29379523_1061144,CM021102.1,3,29379523,508821687,3685114,1061144,509882831,506732720
29377407_1084949,CM021102.1,3,29377407,508816825,1440806,1084949,509901774,506751663
29379523_1080297,CM021102.1,3,29379523,508821687,3685114,1080297,509901984,506751873
29379523_1080348,CM021102.1,3,29379523,508821687,3685114,1080348,509902035,506751924
29379023_1096630,CM021102.1,3,29379023,508820777,3651961,1096630,509917407,506767296
29379023_1096772,CM021102.1,3,29379023,508820777,3651961,1096772,509917549,506767438
29379023_1096794,CM021102.1,3,29379023,508820777,3651961,1096794,509917571,506767460
29381082_1131871,CM021102.1,3,29381082,508820997,5391541,1131871,509952868,506802757
29379523_1273413,CM021102.1,3,29379523,508821687,3685114,1273413,510095100,506944989
29379523_1273416,CM021102.1,3,29379523,508821687,3685114,1273416,510095103,506944992
29379523_1273462,CM021102.1,3,29379523,508821687,3685114,1273462,510095149,506945038
29379523_1273463,CM021102.1,3,29379523,508821687,3685114,1273463,510095150,506945039
29379523_1273498,CM021102.1,3,29379523,508821687,3685114,1273498,510095185,506945074
29379523_1273554,CM021102.1,3,29379523,508821687,3685114,1273554,510095241,506945130
29379857_1311292,CM021102.1,3,29379857,508816827,1411066,1311292,510128119,506978008
29379857_1311419,CM021102.1,3,29379857,508816827,1411066,1311419,510128246,506978135
29379857_1311861,CM021102.1,3,29379857,508816827,1411066,1311861,510128688,506978577
29379857_1311932,CM021102.1,3,29379857,508816827,1411066,1311932,510128759,506978648
29378550_1314842,CM021102.1,3,29378550,508820046,2616105,1314842,510134888,506984777
29378550_1314925,CM021102.1,3,29378550,508820046,2616105,1314925,510134971,506984860
29378550_1360254,CM021102.1,3,29378550,508820046,2616105,1360254,510180300,507030189
29378550_1360341,CM021102.1,3,29378550,508820046,2616105,1360341,510180387,507030276
29379857_1405112,CM021102.1,3,29379857,508816827,1411066,1405112,510221939,507071828
29379857_1405170,CM021102.1,3,29379857,508816827,1411066,1405170,510221997,507071886
29379857_1406428,CM021102.1,3,29379857,508816827,1411066,1406428,510223255,507073144
29379857_1406515,CM021102.1,3,29379857,508816827,1411066,1406515,510223342,507073231
29379857_1406521,CM021102.1,3,29379857,508816827,1411066,1406521,510223348,507073237
29379857_1406946,CM021102.1,3,29379857,508816827,1411066,1406946,510223773,507073662
29379857_1406951,CM021102.1,3,29379857,508816827,1411066,1406951,510223778,507073667
29379857_1406979,CM021102.1,3,29379857,508816827,1411066,1406979,510223806,507073695
29379857_1407032,CM021102.1,3,29379857,508816827,1411066,1407032,510223859,507073748
29379857_1407086,CM021102.1,3,29379857,508816827,1411066,1407086,510223913,507073802
29380016_1476754,CM021102.1,3,29380016,508820738,6105153,1476754,510297492,507147381
29380016_1476811,CM021102.1,3,29380016,508820738,6105153,1476811,510297549,507147438
29380016_1479847,CM021102.1,3,29380016,508820738,6105153,1479847,510300585,507150474
29380016_1479853,CM021102.1,3,29380016,508820738,6105153,1479853,510300591,507150480
29380016_1482070,CM021102.1,3,29380016,508820738,6105153,1482070,510302808,507152697
29378550_1493524,CM021102.1,3,29378550,508820046,2616105,1493524,510313570,507163459
29378550_1493619,CM021102.1,3,29378550,508820046,2616105,1493619,510313665,507163554
29378550_1493774,CM021102.1,3,29378550,508820046,2616105,1493774,510313820,507163709
29378550_1493815,CM021102.1,3,29378550,508820046,2616105,1493815,510313861,507163750
29381082_1503072,CM021102.1,3,29381082,508820997,5391541,1503072,510324069,507173958
29381082_1503102,CM021102.1,3,29381082,508820997,5391541,1503102,510324099,507173988
29381082_1503107,CM021102.1,3,29381082,508820997,5391541,1503107,510324104,507173993
29381082_1503118,CM021102.1,3,29381082,508820997,5391541,1503118,510324115,507174004
29381082_1503136,CM021102.1,3,29381082,508820997,5391541,1503136,510324133,507174022
29381082_1503171,CM021102.1,3,29381082,508820997,5391541,1503171,510324168,507174057
29381082_1503174,CM021102.1,3,29381082,508820997,5391541,1503174,510324171,507174060
29381082_1503190,CM021102.1,3,29381082,508820997,5391541,1503190,510324187,507174076
29381082_1503198,CM021102.1,3,29381082,508820997,5391541,1503198,510324195,507174084
29381082_1503220,CM021102.1,3,29381082,508820997,5391541,1503220,510324217,507174106
29378550_1667611,CM021102.1,3,29378550,508820046,2616105,1667611,510487657,507337546
29378550_1702249,CM021102.1,3,29378550,508820046,2616105,1702249,510522295,507372184
29378550_1702304,CM021102.1,3,29378550,508820046,2616105,1702304,510522350,507372239
29378550_1702328,CM021102.1,3,29378550,508820046,2616105,1702328,510522374,507372263
29378550_1702600,CM021102.1,3,29378550,508820046,2616105,1702600,510522646,507372535
29378550_1724207,CM021102.1,3,29378550,508820046,2616105,1724207,510544253,507394142
29377209_1773743,CM021102.1,3,29377209,508819519,3358593,1773743,510593262,507443151
29382290_1860487,CM021102.1,3,29382290,508816826,3499087,1860487,510677313,507527202
29382290_1860607,CM021102.1,3,29382290,508816826,3499087,1860607,510677433,507527322
29382290_1860664,CM021102.1,3,29382290,508816826,3499087,1860664,510677490,507527379
29382439_1903645,CM021102.1,3,29382439,508819827,2699750,1903645,510723472,507573361
29382439_1903675,CM021102.1,3,29382439,508819827,2699750,1903675,510723502,507573391
29382439_1905293,CM021102.1,3,29382439,508819827,2699750,1905293,510725120,507575009
29382439_1905325,CM021102.1,3,29382439,508819827,2699750,1905325,510725152,507575041
29378550_1907018,CM021102.1,3,29378550,508820046,2616105,1907018,510727064,507576953
29378550_1907127,CM021102.1,3,29378550,508820046,2616105,1907127,510727173,507577062
29378550_1907183,CM021102.1,3,29378550,508820046,2616105,1907183,510727229,507577118
29377578_2205427,CM021102.1,3,29377578,508819986,2258946,2205427,511025413,507875302
29377578_2209297,CM021102.1,3,29377578,508819986,2258946,2209297,511029283,507879172
29377578_2239841,CM021102.1,3,29377578,508819986,2258946,2239841,511059827,507909716
29377578_2239859,CM021102.1,3,29377578,508819986,2258946,2239859,511059845,507909734
29377647_51963,CM021102.1,3,29377647,511042490,1529838,51963,511094453,507944342
29381082_2279083,CM021102.1,3,29381082,508820997,5391541,2279083,511100080,507949969
29381082_2279131,CM021102.1,3,29381082,508820997,5391541,2279131,511100128,507950017
29381082_2279245,CM021102.1,3,29381082,508820997,5391541,2279245,511100242,507950131
29381082_2279249,CM021102.1,3,29381082,508820997,5391541,2279249,511100246,507950135
29381082_2316827,CM021102.1,3,29381082,508820997,5391541,2316827,511137824,507987713
29382371_2474904,CM021102.1,3,29382371,508816826,3554722,2474904,511291730,508141619
29382371_2475846,CM021102.1,3,29382371,508816826,3554722,2475846,511292672,508142561
29378611_2514199,CM021102.1,3,29378611,508820883,3012294,2514199,511335082,508184971
29377647_653459,CM021102.1,3,29377647,511042490,1529838,653459,511695949,508545838
29377647_653500,CM021102.1,3,29377647,511042490,1529838,653500,511695990,508545879
29377647_653502,CM021102.1,3,29377647,511042490,1529838,653502,511695992,508545881
29377647_653513,CM021102.1,3,29377647,511042490,1529838,653513,511696003,508545892
29377647_653522,CM021102.1,3,29377647,511042490,1529838,653522,511696012,508545901
29377647_653527,CM021102.1,3,29377647,511042490,1529838,653527,511696017,508545906
29377647_653528,CM021102.1,3,29377647,511042490,1529838,653528,511696018,508545907
29377647_653533,CM021102.1,3,29377647,511042490,1529838,653533,511696023,508545912
29377647_653539,CM021102.1,3,29377647,511042490,1529838,653539,511696029,508545918
29377647_655542,CM021102.1,3,29377647,511042490,1529838,655542,511698032,508547921
29377647_656035,CM021102.1,3,29377647,511042490,1529838,656035,511698525,508548414
29377647_656041,CM021102.1,3,29377647,511042490,1529838,656041,511698531,508548420
29377647_673604,CM021102.1,3,29377647,511042490,1529838,673604,511716094,508565983
29379023_3075397,CM021102.1,3,29379023,508820777,3651961,3075397,511896174,508746063
29377647_893324,CM021102.1,3,29377647,511042490,1529838,893324,511935814,508785703
29377647_893334,CM021102.1,3,29377647,511042490,1529838,893334,511935824,508785713
29377647_893446,CM021102.1,3,29377647,511042490,1529838,893446,511935936,508785825
29379660_3360508,CM021102.1,3,29379660,508816825,3875263,3360508,512177333,509027222
29377647_1210685,CM021102.1,3,29377647,511042490,1529838,1210685,512253175,509103064
29377647_1301860,CM021102.1,3,29377647,511042490,1529838,1301860,512344350,509194239
29377647_1301922,CM021102.1,3,29377647,511042490,1529838,1301922,512344412,509194301
29379660_3573394,CM021102.1,3,29379660,508816825,3875263,3573394,512390219,509240108
29381082_3591222,CM021102.1,3,29381082,508820997,5391541,3591222,512412219,509262108
29381082_3591271,CM021102.1,3,29381082,508820997,5391541,3591271,512412268,509262157
29381082_3591282,CM021102.1,3,29381082,508820997,5391541,3591282,512412279,509262168
29381082_3591284,CM021102.1,3,29381082,508820997,5391541,3591284,512412281,509262170
29381082_3591302,CM021102.1,3,29381082,508820997,5391541,3591302,512412299,509262188
29381082_3591314,CM021102.1,3,29381082,508820997,5391541,3591314,512412311,509262200
29381082_3694271,CM021102.1,3,29381082,508820997,5391541,3694271,512515268,509365157
29381082_3694288,CM021102.1,3,29381082,508820997,5391541,3694288,512515285,509365174
29381082_3694322,CM021102.1,3,29381082,508820997,5391541,3694322,512515319,509365208
29381082_4518725,CM021102.1,3,29381082,508820997,5391541,4518725,513339722,510189611
29381082_4518742,CM021102.1,3,29381082,508820997,5391541,4518742,513339739,510189628
29381082_4699565,CM021102.1,3,29381082,508820997,5391541,4699565,513520562,510370451
29381082_4699645,CM021102.1,3,29381082,508820997,5391541,4699645,513520642,510370531
29381082_5130321,CM021102.1,3,29381082,508820997,5391541,5130321,513951318,510801207
29381082_5130409,CM021102.1,3,29381082,508820997,5391541,5130409,513951406,510801295
29381082_5130589,CM021102.1,3,29381082,508820997,5391541,5130589,513951586,510801475
29381082_5130729,CM021102.1,3,29381082,508820997,5391541,5130729,513951726,510801615
29380041_56642,CM021102.1,3,29380041,516849246,607153,56642,516905888,513755777
29380041_56781,CM021102.1,3,29380041,516849246,607153,56781,516906027,513755916
29380041_58393,CM021102.1,3,29380041,516849246,607153,58393,516907639,513757528
29380041_58423,CM021102.1,3,29380041,516849246,607153,58423,516907669,513757558
29380041_100153,CM021102.1,3,29380041,516849246,607153,100153,516949399,513799288
29380041_100203,CM021102.1,3,29380041,516849246,607153,100203,516949449,513799338
29380041_344937,CM021102.1,3,29380041,516849246,607153,344937,517194183,514044072
29380041_409711,CM021102.1,3,29380041,516849246,607153,409711,517258957,514108846
29380041_409770,CM021102.1,3,29380041,516849246,607153,409770,517259016,514108905
29380041_409786,CM021102.1,3,29380041,516849246,607153,409786,517259032,514108921
29380041_409801,CM021102.1,3,29380041,516849246,607153,409801,517259047,514108936
29380041_421457,CM021102.1,3,29380041,516849246,607153,421457,517270703,514120592
29380041_421491,CM021102.1,3,29380041,516849246,607153,421491,517270737,514120626
29380041_421520,CM021102.1,3,29380041,516849246,607153,421520,517270766,514120655
29380041_421569,CM021102.1,3,29380041,516849246,607153,421569,517270815,514120704
29382452_24248,CM021102.1,3,29382452,541104774,556630,24248,541129022,537978911
29377120_114106,CM021102.1,3,29377120,541104023,1971431,114106,541218129,538068018
29377120_114130,CM021102.1,3,29377120,541104023,1971431,114130,541218153,538068042
29377120_126337,CM021102.1,3,29377120,541104023,1971431,126337,541230360,538080249
29379591_163174,CM021102.1,3,29379591,541104022,2187718,163174,541267196,538117085
29379591_163181,CM021102.1,3,29379591,541104022,2187718,163181,541267203,538117092
29379591_163236,CM021102.1,3,29379591,541104022,2187718,163236,541267258,538117147
29377120_209260,CM021102.1,3,29377120,541104023,1971431,209260,541313283,538163172
29382452_251386,CM021102.1,3,29382452,541104774,556630,251386,541356160,538206049
29382452_251440,CM021102.1,3,29382452,541104774,556630,251440,541356214,538206103
29378366_263808,CM021102.1,3,29378366,541105280,1249398,263808,541369088,538218977
29379591_280395,CM021102.1,3,29379591,541104022,2187718,280395,541384417,538234306
29382452_280290,CM021102.1,3,29382452,541104774,556630,280290,541385064,538234953
29382452_286752,CM021102.1,3,29382452,541104774,556630,286752,541391526,538241415
29382452_286793,CM021102.1,3,29382452,541104774,556630,286793,541391567,538241456
29382452_286897,CM021102.1,3,29382452,541104774,556630,286897,541391671,538241560
29382452_286917,CM021102.1,3,29382452,541104774,556630,286917,541391691,538241580
29382452_286943,CM021102.1,3,29382452,541104774,556630,286943,541391717,538241606
29382452_287005,CM021102.1,3,29382452,541104774,556630,287005,541391779,538241668
29379591_289590,CM021102.1,3,29379591,541104022,2187718,289590,541393612,538243501
29379591_289623,CM021102.1,3,29379591,541104022,2187718,289623,541393645,538243534
29343385_315337,CM021102.1,3,29343385,541104019,411854,315337,541419356,538269245
29377949_370338,CM021102.1,3,29377949,541107076,655041,370338,541477414,538327303
29350804_444488,CM021102.1,3,29350804,541104022,618752,444488,541548510,538398399
29350804_444902,CM021102.1,3,29350804,541104022,618752,444902,541548924,538398813
29379768_488819,CM021102.1,3,29379768,541106268,835992,488819,541595087,538444976
29379768_488828,CM021102.1,3,29379768,541106268,835992,488828,541595096,538444985
29379768_488853,CM021102.1,3,29379768,541106268,835992,488853,541595121,538445010
29379768_488897,CM021102.1,3,29379768,541106268,835992,488897,541595165,538445054
29379768_488936,CM021102.1,3,29379768,541106268,835992,488936,541595204,538445093
29379768_488999,CM021102.1,3,29379768,541106268,835992,488999,541595267,538445156
29379662_608334,CM021102.1,3,29379662,541104023,985172,608334,541712357,538562246
29378366_717302,CM021102.1,3,29378366,541105280,1249398,717302,541822582,538672471
29378366_717338,CM021102.1,3,29378366,541105280,1249398,717338,541822618,538672507
29379591_720819,CM021102.1,3,29379591,541104022,2187718,720819,541824841,538674730
29379591_720852,CM021102.1,3,29379591,541104022,2187718,720852,541824874,538674763
29377446_1329635,CM021102.1,3,29377446,541104022,2625434,1329635,542433657,539283546
29377120_1469089,CM021102.1,3,29377120,541104023,1971431,1469089,542573112,539423001
29377287_1762399,CM021102.1,3,29377287,541104022,2930733,1762399,542866421,539716310
29377287_1762677,CM021102.1,3,29377287,541104022,2930733,1762677,542866699,539716588
29377287_1762783,CM021102.1,3,29377287,541104022,2930733,1762783,542866805,539716694
29377287_1762887,CM021102.1,3,29377287,541104022,2930733,1762887,542866909,539716798
29377287_1765443,CM021102.1,3,29377287,541104022,2930733,1765443,542869465,539719354
29377446_1835078,CM021102.1,3,29377446,541104022,2625434,1835078,542939100,539788989
29378340_2213256,CM021102.1,3,29378340,541105523,2648444,2213256,543318779,540168668
29377446_2267687,CM021102.1,3,29377446,541104022,2625434,2267687,543371709,540221598
29377446_2267773,CM021102.1,3,29377446,541104022,2625434,2267773,543371795,540221684
29377287_2406985,CM021102.1,3,29377287,541104022,2930733,2406985,543511007,540360896
29377287_2408572,CM021102.1,3,29377287,541104022,2930733,2408572,543512594,540362483
28727121_732,CM021102.1,3,28727121,545592469,2496,732,545593201,542443090
28727121_743,CM021102.1,3,28727121,545592469,2496,743,545593212,542443101
28727121_785,CM021102.1,3,28727121,545592469,2496,785,545593254,542443143
28727121_791,CM021102.1,3,28727121,545592469,2496,791,545593260,542443149
28727121_796,CM021102.1,3,28727121,545592469,2496,796,545593265,542443154
28727121_834,CM021102.1,3,28727121,545592469,2496,834,545593303,542443192
28727121_861,CM021102.1,3,28727121,545592469,2496,861,545593330,542443219
29372677_14926,CM021102.1,3,29372677,574153516,203338,14926,574168442,571018331
29372677_82660,CM021102.1,3,29372677,574153516,203338,82660,574236176,571086065
29378177_83956,CM021102.1,3,29378177,574154364,371904,83956,574238320,571088209
29381179_85427,CM021102.1,3,29381179,574154475,355363,85427,574239902,571089791
29381179_85504,CM021102.1,3,29381179,574154475,355363,85504,574239979,571089868
29381179_85767,CM021102.1,3,29381179,574154475,355363,85767,574240242,571090131
29381179_85789,CM021102.1,3,29381179,574154475,355363,85789,574240264,571090153
29381179_85828,CM021102.1,3,29381179,574154475,355363,85828,574240303,571090192
29381179_87894,CM021102.1,3,29381179,574154475,355363,87894,574242369,571092258
29381179_87952,CM021102.1,3,29381179,574154475,355363,87952,574242427,571092316
29381179_87953,CM021102.1,3,29381179,574154475,355363,87953,574242428,571092317
29381615_90877,CM021102.1,3,29381615,574153512,212020,90877,574244389,571094278
29381615_90878,CM021102.1,3,29381615,574153512,212020,90878,574244390,571094279
29381615_93117,CM021102.1,3,29381615,574153512,212020,93117,574246629,571096518
29381615_93217,CM021102.1,3,29381615,574153512,212020,93217,574246729,571096618
29381615_93312,CM021102.1,3,29381615,574153512,212020,93312,574246824,571096713
29381615_93322,CM021102.1,3,29381615,574153512,212020,93322,574246834,571096723
29381615_94260,CM021102.1,3,29381615,574153512,212020,94260,574247772,571097661
29381615_94339,CM021102.1,3,29381615,574153512,212020,94339,574247851,571097740
29381179_97492,CM021102.1,3,29381179,574154475,355363,97492,574251967,571101856
29381179_97502,CM021102.1,3,29381179,574154475,355363,97502,574251977,571101866
29381179_97516,CM021102.1,3,29381179,574154475,355363,97516,574251991,571101880
29381179_97632,CM021102.1,3,29381179,574154475,355363,97632,574252107,571101996
29378177_108082,CM021102.1,3,29378177,574154364,371904,108082,574262446,571112335
29380741_119660,CM021102.1,3,29380741,574153520,930940,119660,574273180,571123069
29376125_215921,CM021102.1,3,29376125,574155273,481278,215921,574371194,571221083
29376125_215922,CM021102.1,3,29376125,574155273,481278,215922,574371195,571221084
29376125_215989,CM021102.1,3,29376125,574155273,481278,215989,574371262,571221151
29376125_215994,CM021102.1,3,29376125,574155273,481278,215994,574371267,571221156
29376125_216028,CM021102.1,3,29376125,574155273,481278,216028,574371301,571221190
29376125_216029,CM021102.1,3,29376125,574155273,481278,216029,574371302,571221191
29376125_216035,CM021102.1,3,29376125,574155273,481278,216035,574371308,571221197
29376125_216087,CM021102.1,3,29376125,574155273,481278,216087,574371360,571221249
29344390_17300,CM021102.1,3,29344390,574436847,245033,17300,574454147,571304036
29380542_409746,CM021102.1,3,29380542,574153520,489302,409746,574563266,571413155
29344046_2306,CM021102.1,3,29344046,592649112,2888,2306,592651418,589501307
29379190_180835,CM021102.1,3,29379190,602727006,431072,180835,602907841,599757730
29379190_180865,CM021102.1,3,29379190,602727006,431072,180865,602907871,599757760
29379190_274616,CM021102.1,3,29379190,602727006,431072,274616,603001622,599851511
29343615_65982,CM021102.1,3,29343615,614138149,81898,65982,614204131,611054020
29343615_65996,CM021102.1,3,29343615,614138149,81898,65996,614204145,611054034
29343615_66001,CM021102.1,3,29343615,614138149,81898,66001,614204150,611054039
29343615_66061,CM021102.1,3,29343615,614138149,81898,66061,614204210,611054099
29343615_66085,CM021102.1,3,29343615,614138149,81898,66085,614204234,611054123
29343615_66091,CM021102.1,3,29343615,614138149,81898,66091,614204240,611054129
29380702_64298,CM021102.1,3,29380702,616255721,443363,64298,616320019,613169908
29380702_64306,CM021102.1,3,29380702,616255721,443363,64306,616320027,613169916
29380702_64388,CM021102.1,3,29380702,616255721,443363,64388,616320109,613169998
29380702_64431,CM021102.1,3,29380702,616255721,443363,64431,616320152,613170041
29380702_64432,CM021102.1,3,29380702,616255721,443363,64432,616320153,613170042
29380702_64441,CM021102.1,3,29380702,616255721,443363,64441,616320162,613170051
29380702_64446,CM021102.1,3,29380702,616255721,443363,64446,616320167,613170056
29380702_64533,CM021102.1,3,29380702,616255721,443363,64533,616320254,613170143
29380702_213015,CM021102.1,3,29380702,616255721,443363,213015,616468736,613318625
29349190_3526,CM021102.1,3,29349190,637342924,165203,3526,637346450,634196339
29382217_8014,CM021102.1,3,29382217,637342932,128953,8014,637350946,634200835
29382217_8048,CM021102.1,3,29382217,637342932,128953,8048,637350980,634200869
29382217_61075,CM021102.1,3,29382217,637342932,128953,61075,637404007,634253896
29382217_61096,CM021102.1,3,29382217,637342932,128953,61096,637404028,634253917
29349190_85756,CM021102.1,3,29349190,637342924,165203,85756,637428680,634278569
29349190_85809,CM021102.1,3,29349190,637342924,165203,85809,637428733,634278622
29379353_99883,CM021102.1,3,29379353,637342932,534225,99883,637442815,634292704
29379353_99933,CM021102.1,3,29379353,637342932,534225,99933,637442865,634292754
29379353_99946,CM021102.1,3,29379353,637342932,534225,99946,637442878,634292767
29379353_99973,CM021102.1,3,29379353,637342932,534225,99973,637442905,634292794
29379353_100041,CM021102.1,3,29379353,637342932,534225,100041,637442973,634292862
29379353_100046,CM021102.1,3,29379353,637342932,534225,100046,637442978,634292867
29379353_100074,CM021102.1,3,29379353,637342932,534225,100074,637443006,634292895
29379353_100075,CM021102.1,3,29379353,637342932,534225,100075,637443007,634292896
29379353_101005,CM021102.1,3,29379353,637342932,534225,101005,637443937,634293826
29379353_101028,CM021102.1,3,29379353,637342932,534225,101028,637443960,634293849
29379353_101076,CM021102.1,3,29379353,637342932,534225,101076,637444008,634293897
29379353_101109,CM021102.1,3,29379353,637342932,534225,101109,637444041,634293930
29379353_101160,CM021102.1,3,29379353,637342932,534225,101160,637444092,634293981
29379353_103812,CM021102.1,3,29379353,637342932,534225,103812,637446744,634296633
29379353_103813,CM021102.1,3,29379353,637342932,534225,103813,637446745,634296634
29379353_103945,CM021102.1,3,29379353,637342932,534225,103945,637446877,634296766
29379353_103970,CM021102.1,3,29379353,637342932,534225,103970,637446902,634296791
29379353_103984,CM021102.1,3,29379353,637342932,534225,103984,637446916,634296805
29379353_104040,CM021102.1,3,29379353,637342932,534225,104040,637446972,634296861
29379353_104069,CM021102.1,3,29379353,637342932,534225,104069,637447001,634296890
29379353_104075,CM021102.1,3,29379353,637342932,534225,104075,637447007,634296896
29379353_104116,CM021102.1,3,29379353,637342932,534225,104116,637447048,634296937
29379353_104154,CM021102.1,3,29379353,637342932,534225,104154,637447086,634296975
29379353_104164,CM021102.1,3,29379353,637342932,534225,104164,637447096,634296985
29379353_104174,CM021102.1,3,29379353,637342932,534225,104174,637447106,634296995
29381715_168160,CM021102.1,3,29381715,637342932,930086,168160,637511092,634360981
29381715_433900,CM021102.1,3,29381715,637342932,930086,433900,637776832,634626721
29381715_433949,CM021102.1,3,29381715,637342932,930086,433949,637776881,634626770
29381715_544174,CM021102.1,3,29381715,637342932,930086,544174,637887106,634736995
29381715_585729,CM021102.1,3,29381715,637342932,930086,585729,637928661,634778550
29381715_585760,CM021102.1,3,29381715,637342932,930086,585760,637928692,634778581
29381715_585763,CM021102.1,3,29381715,637342932,930086,585763,637928695,634778584
29381715_658100,CM021102.1,3,29381715,637342932,930086,658100,638001032,634850921
29381226_743595,CM021102.1,3,29381226,637342932,1083959,743595,638086527,634936416
29381226_743598,CM021102.1,3,29381226,637342932,1083959,743598,638086530,634936419
29381226_743640,CM021102.1,3,29381226,637342932,1083959,743640,638086572,634936461
29381226_743642,CM021102.1,3,29381226,637342932,1083959,743642,638086574,634936463
29381226_743659,CM021102.1,3,29381226,637342932,1083959,743659,638086591,634936480
29381226_743667,CM021102.1,3,29381226,637342932,1083959,743667,638086599,634936488
29381715_877379,CM021102.1,3,29381715,637342932,930086,877379,638220311,635070200
29381715_877431,CM021102.1,3,29381715,637342932,930086,877431,638220363,635070252
29381715_892049,CM021102.1,3,29381715,637342932,930086,892049,638234981,635084870
29381715_892918,CM021102.1,3,29381715,637342932,930086,892918,638235850,635085739
29348210_62675,CM021102.1,3,29348210,646979898,250527,62675,647042573,643892462
29377735_116636,CM021102.1,3,29377735,646979901,304770,116636,647096537,643946426
29348210_119907,CM021102.1,3,29348210,646979898,250527,119907,647099805,643949694
29348210_120026,CM021102.1,3,29348210,646979898,250527,120026,647099924,643949813
29351512_121758,CM021102.1,3,29351512,646979898,408496,121758,647101656,643951545
29351512_121778,CM021102.1,3,29351512,646979898,408496,121778,647101676,643951565
29351512_121791,CM021102.1,3,29351512,646979898,408496,121791,647101689,643951578
29377133_217056,CM021102.1,3,29377133,646979898,720847,217056,647196954,644046843
29377133_217224,CM021102.1,3,29377133,646979898,720847,217224,647197122,644047011
29377133_217231,CM021102.1,3,29377133,646979898,720847,217231,647197129,644047018
29378910_332600,CM021102.1,3,29378910,646979898,1398989,332600,647312498,644162387
29378910_332675,CM021102.1,3,29378910,646979898,1398989,332675,647312573,644162462
29378910_332677,CM021102.1,3,29378910,646979898,1398989,332677,647312575,644162464
29378910_332766,CM021102.1,3,29378910,646979898,1398989,332766,647312664,644162553
29378910_499907,CM021102.1,3,29378910,646979898,1398989,499907,647479805,644329694
29378910_548296,CM021102.1,3,29378910,646979898,1398989,548296,647528194,644378083
29378910_571125,CM021102.1,3,29378910,646979898,1398989,571125,647551023,644400912
29381595_589826,CM021102.1,3,29381595,646979896,953323,589826,647569722,644419611
29381595_589827,CM021102.1,3,29381595,646979896,953323,589827,647569723,644419612
29381521_709823,CM021102.1,3,29381521,646980097,2194582,709823,647689920,644539809
29381521_709845,CM021102.1,3,29381521,646980097,2194582,709845,647689942,644539831
29381521_710228,CM021102.1,3,29381521,646980097,2194582,710228,647690325,644540214
29381521_759229,CM021102.1,3,29381521,646980097,2194582,759229,647739326,644589215
29381521_792431,CM021102.1,3,29381521,646980097,2194582,792431,647772528,644622417
29378910_841857,CM021102.1,3,29378910,646979898,1398989,841857,647821755,644671644
29378910_842106,CM021102.1,3,29378910,646979898,1398989,842106,647822004,644671893
29378910_842108,CM021102.1,3,29378910,646979898,1398989,842108,647822006,644671895
29378910_842113,CM021102.1,3,29378910,646979898,1398989,842113,647822011,644671900
29378910_843962,CM021102.1,3,29378910,646979898,1398989,843962,647823860,644673749
29378910_844048,CM021102.1,3,29378910,646979898,1398989,844048,647823946,644673835
29378910_844054,CM021102.1,3,29378910,646979898,1398989,844054,647823952,644673841
29378910_844233,CM021102.1,3,29378910,646979898,1398989,844233,647824131,644674020
29378910_844259,CM021102.1,3,29378910,646979898,1398989,844259,647824157,644674046
29378910_844260,CM021102.1,3,29378910,646979898,1398989,844260,647824158,644674047
29378910_844392,CM021102.1,3,29378910,646979898,1398989,844392,647824290,644674179
29378910_844431,CM021102.1,3,29378910,646979898,1398989,844431,647824329,644674218
29378910_846367,CM021102.1,3,29378910,646979898,1398989,846367,647826265,644676154
29378910_846386,CM021102.1,3,29378910,646979898,1398989,846386,647826284,644676173
29378910_846466,CM021102.1,3,29378910,646979898,1398989,846466,647826364,644676253
29378910_846492,CM021102.1,3,29378910,646979898,1398989,846492,647826390,644676279
29378910_846594,CM021102.1,3,29378910,646979898,1398989,846594,647826492,644676381
29378910_846729,CM021102.1,3,29378910,646979898,1398989,846729,647826627,644676516
29381521_906486,CM021102.1,3,29381521,646980097,2194582,906486,647886583,644736472
29381521_906507,CM021102.1,3,29381521,646980097,2194582,906507,647886604,644736493
29381521_906515,CM021102.1,3,29381521,646980097,2194582,906515,647886612,644736501
29381521_1064265,CM021102.1,3,29381521,646980097,2194582,1064265,648044362,644894251
29381521_1098631,CM021102.1,3,29381521,646980097,2194582,1098631,648078728,644928617
29381521_1336514,CM021102.1,3,29381521,646980097,2194582,1336514,648316611,645166500
29381521_1503882,CM021102.1,3,29381521,646980097,2194582,1503882,648483979,645333868
29381521_1503939,CM021102.1,3,29381521,646980097,2194582,1503939,648484036,645333925
29381521_1503948,CM021102.1,3,29381521,646980097,2194582,1503948,648484045,645333934
29381521_1503985,CM021102.1,3,29381521,646980097,2194582,1503985,648484082,645333971
29381521_1503990,CM021102.1,3,29381521,646980097,2194582,1503990,648484087,645333976
29381521_1548716,CM021102.1,3,29381521,646980097,2194582,1548716,648528813,645378702
29381521_1549437,CM021102.1,3,29381521,646980097,2194582,1549437,648529534,645379423
29381521_1549440,CM021102.1,3,29381521,646980097,2194582,1549440,648529537,645379426
29381521_1549488,CM021102.1,3,29381521,646980097,2194582,1549488,648529585,645379474
29372657_223824,CM021102.1,3,29372657,657851742,377563,223824,658075566,654925455
29372657_224384,CM021102.1,3,29372657,657851742,377563,224384,658076126,654926015
29372657_228235,CM021102.1,3,29372657,657851742,377563,228235,658079977,654929866
29372657_230387,CM021102.1,3,29372657,657851742,377563,230387,658082129,654932018
29377779_270573,CM021102.1,3,29377779,657851747,846685,270573,658122320,654972209
29377779_469746,CM021102.1,3,29377779,657851747,846685,469746,658321493,655171382
29377779_494863,CM021102.1,3,29377779,657851747,846685,494863,658346610,655196499
29377779_495572,CM021102.1,3,29377779,657851747,846685,495572,658347319,655197208
29377779_496474,CM021102.1,3,29377779,657851747,846685,496474,658348221,655198110
29377779_496531,CM021102.1,3,29377779,657851747,846685,496531,658348278,655198167
29377779_613030,CM021102.1,3,29377779,657851747,846685,613030,658464777,655314666
29377779_613107,CM021102.1,3,29377779,657851747,846685,613107,658464854,655314743
29377779_695398,CM021102.1,3,29377779,657851747,846685,695398,658547145,655397034
29380504_34774,CM021102.1,3,29380504,685265978,166922,34774,685300752,682150641
29380504_34797,CM021102.1,3,29380504,685265978,166922,34797,685300775,682150664
29380504_34917,CM021102.1,3,29380504,685265978,166922,34917,685300895,682150784
29381779_160905,CM021102.1,3,29381779,685266648,739499,160905,685427553,682277442
29181914_676,CM021102.1,3,29181914,722232955,6037,676,722233631,719083520
28186905_395,CM021102.1,3,28186905,727012993,1738,395,727013388,723863277
28186905_396,CM021102.1,3,28186905,727012993,1738,396,727013389,723863278
29359065_39634,CM021102.1,3,29359065,728871754,456437,39634,728911388,725761277
29359065_39640,CM021102.1,3,29359065,728871754,456437,39640,728911394,725761283
29359065_39642,CM021102.1,3,29359065,728871754,456437,39642,728911396,725761285
29359065_39644,CM021102.1,3,29359065,728871754,456437,39644,728911398,725761287
29359065_39645,CM021102.1,3,29359065,728871754,456437,39645,728911399,725761288
29359065_39680,CM021102.1,3,29359065,728871754,456437,39680,728911434,725761323
29359065_39683,CM021102.1,3,29359065,728871754,456437,39683,728911437,725761326
29359065_39685,CM021102.1,3,29359065,728871754,456437,39685,728911439,725761328
29359065_39706,CM021102.1,3,29359065,728871754,456437,39706,728911460,725761349
29359065_39735,CM021102.1,3,29359065,728871754,456437,39735,728911489,725761378
29359065_39737,CM021102.1,3,29359065,728871754,456437,39737,728911491,725761380
29359065_39739,CM021102.1,3,29359065,728871754,456437,39739,728911493,725761382
29359065_39741,CM021102.1,3,29359065,728871754,456437,39741,728911495,725761384
29359065_39758,CM021102.1,3,29359065,728871754,456437,39758,728911512,725761401
29359065_39759,CM021102.1,3,29359065,728871754,456437,39759,728911513,725761402
29359065_39767,CM021102.1,3,29359065,728871754,456437,39767,728911521,725761410
29359065_39805,CM021102.1,3,29359065,728871754,456437,39805,728911559,725761448
29359065_39830,CM021102.1,3,29359065,728871754,456437,39830,728911584,725761473
29359065_39846,CM021102.1,3,29359065,728871754,456437,39846,728911600,725761489
29359065_39859,CM021102.1,3,29359065,728871754,456437,39859,728911613,725761502
29378002_25952,CM021102.1,3,29378002,739450464,276329,25952,739476416,736326305
29378002_25982,CM021102.1,3,29378002,739450464,276329,25982,739476446,736326335
29378002_25985,CM021102.1,3,29378002,739450464,276329,25985,739476449,736326338
29381980_57171,CM021102.1,3,29381980,739450468,207392,57171,739507639,736357528
29378002_58056,CM021102.1,3,29378002,739450464,276329,58056,739508520,736358409
29378002_58123,CM021102.1,3,29378002,739450464,276329,58123,739508587,736358476
29378002_82353,CM021102.1,3,29378002,739450464,276329,82353,739532817,736382706
29378002_82432,CM021102.1,3,29378002,739450464,276329,82432,739532896,736382785
29377606_95383,CM021102.1,3,29377606,739451254,982187,95383,739546637,736396526
29377606_95813,CM021102.1,3,29377606,739451254,982187,95813,739547067,736396956
29377606_95865,CM021102.1,3,29377606,739451254,982187,95865,739547119,736397008
29377606_95877,CM021102.1,3,29377606,739451254,982187,95877,739547131,736397020
29377606_95889,CM021102.1,3,29377606,739451254,982187,95889,739547143,736397032
29377606_95909,CM021102.1,3,29377606,739451254,982187,95909,739547163,736397052
29380323_201973,CM021102.1,3,29380323,739450468,378388,201973,739652441,736502330
29380323_201999,CM021102.1,3,29380323,739450468,378388,201999,739652467,736502356
29380323_202013,CM021102.1,3,29380323,739450468,378388,202013,739652481,736502370
29380323_202018,CM021102.1,3,29380323,739450468,378388,202018,739652486,736502375
29380323_202045,CM021102.1,3,29380323,739450468,378388,202045,739652513,736502402
29380323_202101,CM021102.1,3,29380323,739450468,378388,202101,739652569,736502458
29378002_266353,CM021102.1,3,29378002,739450464,276329,266353,739716817,736566706
29378002_268484,CM021102.1,3,29378002,739450464,276329,268484,739718948,736568837
29378002_270465,CM021102.1,3,29378002,739450464,276329,270465,739720929,736570818
29378002_270490,CM021102.1,3,29378002,739450464,276329,270490,739720954,736570843
29378002_270550,CM021102.1,3,29378002,739450464,276329,270550,739721014,736570903
29378002_270748,CM021102.1,3,29378002,739450464,276329,270748,739721212,736571101
29378002_271293,CM021102.1,3,29378002,739450464,276329,271293,739721757,736571646
29357119_249813,CM021102.1,3,29357119,740945940,1270133,249813,741195753,738045642
29378183_401356,CM021102.1,3,29378183,740945941,444190,401356,741347297,738197186
29378183_401363,CM021102.1,3,29378183,740945941,444190,401363,741347304,738197193
29378183_401404,CM021102.1,3,29378183,740945941,444190,401404,741347345,738197234
29379275_12782,CM021102.1,3,29379275,744032855,461501,12782,744045637,740895526
29378656_40171,CM021102.1,3,29378656,744032858,414633,40171,744073029,740922918
29378656_40228,CM021102.1,3,29378656,744032858,414633,40228,744073086,740922975
29381392_35608,CM021102.1,3,29381392,744037624,253977,35608,744073232,740923121
29381392_35638,CM021102.1,3,29381392,744037624,253977,35638,744073262,740923151
29381392_35736,CM021102.1,3,29381392,744037624,253977,35736,744073360,740923249
29381392_35751,CM021102.1,3,29381392,744037624,253977,35751,744073375,740923264
29381392_35765,CM021102.1,3,29381392,744037624,253977,35765,744073389,740923278
29381392_35779,CM021102.1,3,29381392,744037624,253977,35779,744073403,740923292
29381392_35806,CM021102.1,3,29381392,744037624,253977,35806,744073430,740923319
29381392_35813,CM021102.1,3,29381392,744037624,253977,35813,744073437,740923326
29381392_35833,CM021102.1,3,29381392,744037624,253977,35833,744073457,740923346
29381392_35836,CM021102.1,3,29381392,744037624,253977,35836,744073460,740923349
29381392_35873,CM021102.1,3,29381392,744037624,253977,35873,744073497,740923386
29382455_44190,CM021102.1,3,29382455,744032858,368694,44190,744077048,740926937
29382455_44203,CM021102.1,3,29382455,744032858,368694,44203,744077061,740926950
29382455_44283,CM021102.1,3,29382455,744032858,368694,44283,744077141,740927030
29382455_44369,CM021102.1,3,29382455,744032858,368694,44369,744077227,740927116
29377528_82085,CM021102.1,3,29377528,744032858,1500515,82085,744114943,740964832
29377528_82086,CM021102.1,3,29377528,744032858,1500515,82086,744114944,740964833
29377528_82199,CM021102.1,3,29377528,744032858,1500515,82199,744115057,740964946
29377528_82229,CM021102.1,3,29377528,744032858,1500515,82229,744115087,740964976
29379189_138418,CM021102.1,3,29379189,744032858,3161687,138418,744171276,741021165
29379189_139210,CM021102.1,3,29379189,744032858,3161687,139210,744172068,741021957
29379189_139230,CM021102.1,3,29379189,744032858,3161687,139230,744172088,741021977
29380942_144305,CM021102.1,3,29380942,744037740,307440,144305,744182045,741031934
29380942_144310,CM021102.1,3,29380942,744037740,307440,144310,744182050,741031939
29380942_144362,CM021102.1,3,29380942,744037740,307440,144362,744182102,741031991
29382455_152419,CM021102.1,3,29382455,744032858,368694,152419,744185277,741035166
29382455_152448,CM021102.1,3,29382455,744032858,368694,152448,744185306,741035195
29382455_152453,CM021102.1,3,29382455,744032858,368694,152453,744185311,741035200
29382455_152506,CM021102.1,3,29382455,744032858,368694,152506,744185364,741035253
29382455_152514,CM021102.1,3,29382455,744032858,368694,152514,744185372,741035261
29382455_152540,CM021102.1,3,29382455,744032858,368694,152540,744185398,741035287
29382455_152625,CM021102.1,3,29382455,744032858,368694,152625,744185483,741035372
29382455_169331,CM021102.1,3,29382455,744032858,368694,169331,744202189,741052078
29382455_169364,CM021102.1,3,29382455,744032858,368694,169364,744202222,741052111
29382455_169521,CM021102.1,3,29382455,744032858,368694,169521,744202379,741052268
29382455_169532,CM021102.1,3,29382455,744032858,368694,169532,744202390,741052279
29382455_169924,CM021102.1,3,29382455,744032858,368694,169924,744202782,741052671
29377676_177714,CM021102.1,3,29377676,744032853,401567,177714,744210567,741060456
29377676_177747,CM021102.1,3,29377676,744032853,401567,177747,744210600,741060489
29377676_177802,CM021102.1,3,29377676,744032853,401567,177802,744210655,741060544
29377676_179077,CM021102.1,3,29377676,744032853,401567,179077,744211930,741061819
29377676_179149,CM021102.1,3,29377676,744032853,401567,179149,744212002,741061891
29377676_179153,CM021102.1,3,29377676,744032853,401567,179153,744212006,741061895
29377676_179185,CM021102.1,3,29377676,744032853,401567,179185,744212038,741061927
29377676_179234,CM021102.1,3,29377676,744032853,401567,179234,744212087,741061976
29377676_179271,CM021102.1,3,29377676,744032853,401567,179271,744212124,741062013
29377350_183457,CM021102.1,3,29377350,744032858,354240,183457,744216315,741066204
29377676_265078,CM021102.1,3,29377676,744032853,401567,265078,744297931,741147820
29377676_265117,CM021102.1,3,29377676,744032853,401567,265117,744297970,741147859
29377676_265142,CM021102.1,3,29377676,744032853,401567,265142,744297995,741147884
29377676_265153,CM021102.1,3,29377676,744032853,401567,265153,744298006,741147895
29377676_265275,CM021102.1,3,29377676,744032853,401567,265275,744298128,741148017
29377676_265320,CM021102.1,3,29377676,744032853,401567,265320,744298173,741148062
29379672_266992,CM021102.1,3,29379672,744032858,1156244,266992,744299850,741149739
29379672_267129,CM021102.1,3,29379672,744032858,1156244,267129,744299987,741149876
29378657_335189,CM021102.1,3,29378657,744032858,3837914,335189,744368047,741217936
29377648_354675,CM021102.1,3,29377648,744037379,453918,354675,744392054,741241943
29377648_354718,CM021102.1,3,29377648,744037379,453918,354718,744392097,741241986
29377648_354749,CM021102.1,3,29377648,744037379,453918,354749,744392128,741242017
29377648_438247,CM021102.1,3,29377648,744037379,453918,438247,744475626,741325515
29377648_438321,CM021102.1,3,29377648,744037379,453918,438321,744475700,741325589
29378657_451678,CM021102.1,3,29378657,744032858,3837914,451678,744484536,741334425
29377648_453102,CM021102.1,3,29377648,744037379,453918,453102,744490481,741340370
29377648_453137,CM021102.1,3,29377648,744037379,453918,453137,744490516,741340405
29377648_453180,CM021102.1,3,29377648,744037379,453918,453180,744490559,741340448
29377648_453186,CM021102.1,3,29377648,744037379,453918,453186,744490565,741340454
29377648_453194,CM021102.1,3,29377648,744037379,453918,453194,744490573,741340462
29378657_463727,CM021102.1,3,29378657,744032858,3837914,463727,744496585,741346474
29378657_463752,CM021102.1,3,29378657,744032858,3837914,463752,744496610,741346499
29378657_463818,CM021102.1,3,29378657,744032858,3837914,463818,744496676,741346565
29379454_542553,CM021102.1,3,29379454,744032858,5063749,542553,744575411,741425300
29379454_542558,CM021102.1,3,29379454,744032858,5063749,542558,744575416,741425305
29379248_573111,CM021102.1,3,29379248,744038557,1036251,573111,744611668,741461557
29379248_573118,CM021102.1,3,29379248,744038557,1036251,573118,744611675,741461564
29377584_596250,CM021102.1,3,29377584,744032858,3295726,596250,744629108,741478997
29377584_596289,CM021102.1,3,29377584,744032858,3295726,596289,744629147,741479036
29377584_596370,CM021102.1,3,29377584,744032858,3295726,596370,744629228,741479117
29378657_625841,CM021102.1,3,29378657,744032858,3837914,625841,744658699,741508588
29377584_628181,CM021102.1,3,29377584,744032858,3295726,628181,744661039,741510928
29378474_683556,CM021102.1,3,29378474,744032853,1611035,683556,744716409,741566298
29378474_684020,CM021102.1,3,29378474,744032853,1611035,684020,744716873,741566762
29378691_724532,CM021102.1,3,29378691,744032857,1585852,724532,744757389,741607278
29378691_724577,CM021102.1,3,29378691,744032857,1585852,724577,744757434,741607323
29378691_724679,CM021102.1,3,29378691,744032857,1585852,724679,744757536,741607425
29378657_733474,CM021102.1,3,29378657,744032858,3837914,733474,744766332,741616221
29379454_777306,CM021102.1,3,29379454,744032858,5063749,777306,744810164,741660053
29380803_948622,CM021102.1,3,29380803,744034290,2298108,948622,744982912,741832801
29379227_1020499,CM021102.1,3,29379227,744037723,1378680,1020499,745058222,741908111
29379227_1101546,CM021102.1,3,29379227,744037723,1378680,1101546,745139269,741989158
29379454_1155930,CM021102.1,3,29379454,744032858,5063749,1155930,745188788,742038677
29379454_1155939,CM021102.1,3,29379454,744032858,5063749,1155939,745188797,742038686
29379454_1156036,CM021102.1,3,29379454,744032858,5063749,1156036,745188894,742038783
29379454_1156416,CM021102.1,3,29379454,744032858,5063749,1156416,745189274,742039163
29379227_1173798,CM021102.1,3,29379227,744037723,1378680,1173798,745211521,742061410
29379227_1173819,CM021102.1,3,29379227,744037723,1378680,1173819,745211542,742061431
29379454_1233987,CM021102.1,3,29379454,744032858,5063749,1233987,745266845,742116734
29379454_1266216,CM021102.1,3,29379454,744032858,5063749,1266216,745299074,742148963
29378657_1389482,CM021102.1,3,29378657,744032858,3837914,1389482,745422340,742272229
29378657_1389522,CM021102.1,3,29378657,744032858,3837914,1389522,745422380,742272269
29381398_1453733,CM021102.1,3,29381398,744032860,1493207,1453733,745486593,742336482
29381398_1453746,CM021102.1,3,29381398,744032860,1493207,1453746,745486606,742336495
29381398_1453747,CM021102.1,3,29381398,744032860,1493207,1453747,745486607,742336496
29381398_1456059,CM021102.1,3,29381398,744032860,1493207,1456059,745488919,742338808
29380803_1916141,CM021102.1,3,29380803,744034290,2298108,1916141,745950431,742800320
29379716_2221920,CM021102.1,3,29379716,744032858,2481204,2221920,746254778,743104667
29379716_2242949,CM021102.1,3,29379716,744032858,2481204,2242949,746275807,743125696
29377584_2307985,CM021102.1,3,29377584,744032858,3295726,2307985,746340843,743190732
29377584_2308001,CM021102.1,3,29377584,744032858,3295726,2308001,746340859,743190748
29377584_2308007,CM021102.1,3,29377584,744032858,3295726,2308007,746340865,743190754
29379339_2664079,CM021102.1,3,29379339,744036884,5893233,2664079,746700963,743550852
29377584_2862115,CM021102.1,3,29377584,744032858,3295726,2862115,746894973,743744862
29377584_2862136,CM021102.1,3,29377584,744032858,3295726,2862136,746894994,743744883
29377584_2862203,CM021102.1,3,29377584,744032858,3295726,2862203,746895061,743744950
29377584_3181803,CM021102.1,3,29377584,744032858,3295726,3181803,747214661,744064550
29377584_3213554,CM021102.1,3,29377584,744032858,3295726,3213554,747246412,744096301
29377584_3236150,CM021102.1,3,29377584,744032858,3295726,3236150,747269008,744118897
29379454_3774675,CM021102.1,3,29379454,744032858,5063749,3774675,747807533,744657422
29379454_3774714,CM021102.1,3,29379454,744032858,5063749,3774714,747807572,744657461
29379454_3784345,CM021102.1,3,29379454,744032858,5063749,3784345,747817203,744667092
29379454_3784385,CM021102.1,3,29379454,744032858,5063749,3784385,747817243,744667132
29379454_3810673,CM021102.1,3,29379454,744032858,5063749,3810673,747843531,744693420
29379454_3811130,CM021102.1,3,29379454,744032858,5063749,3811130,747843988,744693877
29379454_3817491,CM021102.1,3,29379454,744032858,5063749,3817491,747850349,744700238
29379454_3817549,CM021102.1,3,29379454,744032858,5063749,3817549,747850407,744700296
29379454_3817631,CM021102.1,3,29379454,744032858,5063749,3817631,747850489,744700378
29379454_3837868,CM021102.1,3,29379454,744032858,5063749,3837868,747870726,744720615
29379454_3837871,CM021102.1,3,29379454,744032858,5063749,3837871,747870729,744720618
29379454_3838264,CM021102.1,3,29379454,744032858,5063749,3838264,747871122,744721011
29379454_3838309,CM021102.1,3,29379454,744032858,5063749,3838309,747871167,744721056
29379454_3841231,CM021102.1,3,29379454,744032858,5063749,3841231,747874089,744723978
29379454_3841275,CM021102.1,3,29379454,744032858,5063749,3841275,747874133,744724022
29379454_4218803,CM021102.1,3,29379454,744032858,5063749,4218803,748251661,745101550
29379454_4218870,CM021102.1,3,29379454,744032858,5063749,4218870,748251728,745101617
29379454_4220492,CM021102.1,3,29379454,744032858,5063749,4220492,748253350,745103239
29379454_4445852,CM021102.1,3,29379454,744032858,5063749,4445852,748478710,745328599
29379454_4446001,CM021102.1,3,29379454,744032858,5063749,4446001,748478859,745328748
29379339_4579963,CM021102.1,3,29379339,744036884,5893233,4579963,748616847,745466736
29379339_5476470,CM021102.1,3,29379339,744036884,5893233,5476470,749513354,746363243
29382182_3680,CM021102.1,3,29382182,816857818,36701,3680,816861498,813711387
29382182_3731,CM021102.1,3,29382182,816857818,36701,3731,816861549,813711438
29382182_3964,CM021102.1,3,29382182,816857818,36701,3964,816861782,813711671
28664203_6724,CM021102.1,3,28664203,836796101,9052,6724,836802825,833652714
29380029_60872,CM021102.1,3,29380029,841785280,3395661,60872,841846152,838696041
29380029_63437,CM021102.1,3,29380029,841785280,3395661,63437,841848717,838698606
29380029_63514,CM021102.1,3,29380029,841785280,3395661,63514,841848794,838698683
29379439_261666,CM021102.1,3,29379439,841788631,791694,261666,842050297,838900186
29379439_261857,CM021102.1,3,29379439,841788631,791694,261857,842050488,838900377
29382403_282265,CM021102.1,3,29382403,841785281,1853237,282265,842067546,838917435
29382403_282332,CM021102.1,3,29382403,841785281,1853237,282332,842067613,838917502
29381576_305305,CM021102.1,3,29381576,841785282,852153,305305,842090587,838940476
29381576_305395,CM021102.1,3,29381576,841785282,852153,305395,842090677,838940566
29380029_319279,CM021102.1,3,29380029,841785280,3395661,319279,842104559,838954448
29380029_320911,CM021102.1,3,29380029,841785280,3395661,320911,842106191,838956080
29380029_321037,CM021102.1,3,29380029,841785280,3395661,321037,842106317,838956206
29380029_321065,CM021102.1,3,29380029,841785280,3395661,321065,842106345,838956234
29380029_321144,CM021102.1,3,29380029,841785280,3395661,321144,842106424,838956313
29380029_412222,CM021102.1,3,29380029,841785280,3395661,412222,842197502,839047391
29379439_412379,CM021102.1,3,29379439,841788631,791694,412379,842201010,839050899
29379439_458482,CM021102.1,3,29379439,841788631,791694,458482,842247113,839097002
29379439_458596,CM021102.1,3,29379439,841788631,791694,458596,842247227,839097116
29380029_493584,CM021102.1,3,29380029,841785280,3395661,493584,842278864,839128753
29380029_493613,CM021102.1,3,29380029,841785280,3395661,493613,842278893,839128782
29380029_507233,CM021102.1,3,29380029,841785280,3395661,507233,842292513,839142402
29380029_507245,CM021102.1,3,29380029,841785280,3395661,507245,842292525,839142414
29380029_507475,CM021102.1,3,29380029,841785280,3395661,507475,842292755,839142644
29380454_658828,CM021102.1,3,29380454,841785278,1139053,658828,842444106,839293995
29380029_684471,CM021102.1,3,29380029,841785280,3395661,684471,842469751,839319640
29380029_722708,CM021102.1,3,29380029,841785280,3395661,722708,842507988,839357877
29380029_722771,CM021102.1,3,29380029,841785280,3395661,722771,842508051,839357940
29379942_741509,CM021102.1,3,29379942,841787453,857162,741509,842528962,839378851
29379942_741601,CM021102.1,3,29379942,841787453,857162,741601,842529054,839378943
29379439_771050,CM021102.1,3,29379439,841788631,791694,771050,842559681,839409570
29379439_771088,CM021102.1,3,29379439,841788631,791694,771088,842559719,839409608
29379439_771129,CM021102.1,3,29379439,841788631,791694,771129,842559760,839409649
29379439_773196,CM021102.1,3,29379439,841788631,791694,773196,842561827,839411716
29379439_773230,CM021102.1,3,29379439,841788631,791694,773230,842561861,839411750
29379439_775967,CM021102.1,3,29379439,841788631,791694,775967,842564598,839414487
29377438_806925,CM021102.1,3,29377438,841785276,2066309,806925,842592201,839442090
29377438_817980,CM021102.1,3,29377438,841785276,2066309,817980,842603256,839453145
29382011_834753,CM021102.1,3,29382011,841785281,1239824,834753,842620034,839469923
29382011_834794,CM021102.1,3,29382011,841785281,1239824,834794,842620075,839469964
29382011_834816,CM021102.1,3,29382011,841785281,1239824,834816,842620097,839469986
29382011_834821,CM021102.1,3,29382011,841785281,1239824,834821,842620102,839469991
29382011_834897,CM021102.1,3,29382011,841785281,1239824,834897,842620178,839470067
29382011_834918,CM021102.1,3,29382011,841785281,1239824,834918,842620199,839470088
29382011_834934,CM021102.1,3,29382011,841785281,1239824,834934,842620215,839470104
29382403_865947,CM021102.1,3,29382403,841785281,1853237,865947,842651228,839501117
29380029_903150,CM021102.1,3,29380029,841785280,3395661,903150,842688430,839538319
29380029_903176,CM021102.1,3,29380029,841785280,3395661,903176,842688456,839538345
29380029_1074163,CM021102.1,3,29380029,841785280,3395661,1074163,842859443,839709332
29380029_1074191,CM021102.1,3,29380029,841785280,3395661,1074191,842859471,839709360
29380029_1074218,CM021102.1,3,29380029,841785280,3395661,1074218,842859498,839709387
29380029_1074850,CM021102.1,3,29380029,841785280,3395661,1074850,842860130,839710019
29381238_1081392,CM021102.1,3,29381238,841786775,2357739,1081392,842868167,839718056
29377438_1240306,CM021102.1,3,29377438,841785276,2066309,1240306,843025582,839875471
29377438_1244327,CM021102.1,3,29377438,841785276,2066309,1244327,843029603,839879492
29377438_1245512,CM021102.1,3,29377438,841785276,2066309,1245512,843030788,839880677
29377438_1245564,CM021102.1,3,29377438,841785276,2066309,1245564,843030840,839880729
29377438_1585436,CM021102.1,3,29377438,841785276,2066309,1585436,843370712,840220601
29377758_1658982,CM021102.1,3,29377758,841785618,3148238,1658982,843444600,840294489
29380029_1706738,CM021102.1,3,29380029,841785280,3395661,1706738,843492018,840341907
29380029_1706788,CM021102.1,3,29380029,841785280,3395661,1706788,843492068,840341957
29380029_1706865,CM021102.1,3,29380029,841785280,3395661,1706865,843492145,840342034
29380029_1744585,CM021102.1,3,29380029,841785280,3395661,1744585,843529865,840379754
29380029_1744672,CM021102.1,3,29380029,841785280,3395661,1744672,843529952,840379841
29380029_1745933,CM021102.1,3,29380029,841785280,3395661,1745933,843531213,840381102
29380029_1745938,CM021102.1,3,29380029,841785280,3395661,1745938,843531218,840381107
29380029_1745957,CM021102.1,3,29380029,841785280,3395661,1745957,843531237,840381126
29377438_1765984,CM021102.1,3,29377438,841785276,2066309,1765984,843551260,840401149
29377438_1766008,CM021102.1,3,29377438,841785276,2066309,1766008,843551284,840401173
29380029_1982683,CM021102.1,3,29380029,841785280,3395661,1982683,843767963,840617852
29380029_1982723,CM021102.1,3,29380029,841785280,3395661,1982723,843768003,840617892
29380029_1982724,CM021102.1,3,29380029,841785280,3395661,1982724,843768004,840617893
29380029_1982758,CM021102.1,3,29380029,841785280,3395661,1982758,843768038,840617927
28516380_7127,CM021103.1,4,28516380,29976512,7660,7127,29983639,2198708
28516380_7150,CM021103.1,4,28516380,29976512,7660,7150,29983662,2198731
29381873_296210,CM021103.1,4,29381873,36895623,674984,296210,37191833,9406902
29350442_2430,CM021103.1,4,29350442,63048264,11890,2430,63050694,35265763
29350442_2453,CM021103.1,4,29350442,63048264,11890,2453,63050717,35265786
29350442_2497,CM021103.1,4,29350442,63048264,11890,2497,63050761,35265830
29350442_2670,CM021103.1,4,29350442,63048264,11890,2670,63050934,35266003
29350442_2672,CM021103.1,4,29350442,63048264,11890,2672,63050936,35266005
29381144_57677,CM021103.1,4,29381144,76360813,535177,57677,76418490,48633559
29381144_57678,CM021103.1,4,29381144,76360813,535177,57678,76418491,48633560
29381144_207561,CM021103.1,4,29381144,76360813,535177,207561,76568374,48783443
29381144_207595,CM021103.1,4,29381144,76360813,535177,207595,76568408,48783477
29382029_333957,CM021103.1,4,29382029,76361822,372458,333957,76695779,48910848
29382029_333969,CM021103.1,4,29382029,76361822,372458,333969,76695791,48910860
29382029_334004,CM021103.1,4,29382029,76361822,372458,334004,76695826,48910895
29380674_635261,CM021103.1,4,29380674,76360823,1298170,635261,76996084,49211153
29380674_1208240,CM021103.1,4,29380674,76360823,1298170,1208240,77569063,49784132
29380674_1208251,CM021103.1,4,29380674,76360823,1298170,1208251,77569074,49784143
29344020_15251,CM021103.1,4,29344020,86069055,22284,15251,86084306,58299375
28711358_5329,CM021103.1,4,28711358,94531613,7774,5329,94536942,66752011
28711358_5343,CM021103.1,4,28711358,94531613,7774,5343,94536956,66752025
29335267_33808,CM021103.1,4,29335267,96070442,48361,33808,96104250,68319319
29335267_33835,CM021103.1,4,29335267,96070442,48361,33835,96104277,68319346
29335267_33981,CM021103.1,4,29335267,96070442,48361,33981,96104423,68319492
29377604_712741,CM021103.1,4,29377604,100051679,965403,712741,100764420,72979489
29377604_712766,CM021103.1,4,29377604,100051679,965403,712766,100764445,72979514
29377604_712797,CM021103.1,4,29377604,100051679,965403,712797,100764476,72979545
29377604_712862,CM021103.1,4,29377604,100051679,965403,712862,100764541,72979610
29377604_712959,CM021103.1,4,29377604,100051679,965403,712959,100764638,72979707
29334873_165013,CM021103.1,4,29334873,104880509,517872,165013,105045522,77260591
29334873_165070,CM021103.1,4,29334873,104880509,517872,165070,105045579,77260648
29334873_165105,CM021103.1,4,29334873,104880509,517872,165105,105045614,77260683
29334873_165149,CM021103.1,4,29334873,104880509,517872,165149,105045658,77260727
29379790_168794,CM021103.1,4,29379790,104880509,2432040,168794,105049303,77264372
29382194_209793,CM021103.1,4,29382194,104880952,574204,209793,105090745,77305814
29382194_209856,CM021103.1,4,29382194,104880952,574204,209856,105090808,77305877
29382194_209921,CM021103.1,4,29382194,104880952,574204,209921,105090873,77305942
29377280_242212,CM021103.1,4,29377280,104880509,3674097,242212,105122721,77337790
29377280_242241,CM021103.1,4,29377280,104880509,3674097,242241,105122750,77337819
29377280_242273,CM021103.1,4,29377280,104880509,3674097,242273,105122782,77337851
29377280_242278,CM021103.1,4,29377280,104880509,3674097,242278,105122787,77337856
29377280_242288,CM021103.1,4,29377280,104880509,3674097,242288,105122797,77337866
29377280_242309,CM021103.1,4,29377280,104880509,3674097,242309,105122818,77337887
29377280_242327,CM021103.1,4,29377280,104880509,3674097,242327,105122836,77337905
29377280_242360,CM021103.1,4,29377280,104880509,3674097,242360,105122869,77337938
29377280_242362,CM021103.1,4,29377280,104880509,3674097,242362,105122871,77337940
29377280_242391,CM021103.1,4,29377280,104880509,3674097,242391,105122900,77337969
29379790_305918,CM021103.1,4,29379790,104880509,2432040,305918,105186427,77401496
29379790_306006,CM021103.1,4,29379790,104880509,2432040,306006,105186515,77401584
29379790_306011,CM021103.1,4,29379790,104880509,2432040,306011,105186520,77401589
29379790_306015,CM021103.1,4,29379790,104880509,2432040,306015,105186524,77401593
29379790_306081,CM021103.1,4,29379790,104880509,2432040,306081,105186590,77401659
29381428_309037,CM021103.1,4,29381428,104880663,1862728,309037,105189700,77404769
29381428_400520,CM021103.1,4,29381428,104880663,1862728,400520,105281183,77496252
29381428_400533,CM021103.1,4,29381428,104880663,1862728,400533,105281196,77496265
29381428_400534,CM021103.1,4,29381428,104880663,1862728,400534,105281197,77496266
29381428_400601,CM021103.1,4,29381428,104880663,1862728,400601,105281264,77496333
29381428_400678,CM021103.1,4,29381428,104880663,1862728,400678,105281341,77496410
29381428_400712,CM021103.1,4,29381428,104880663,1862728,400712,105281375,77496444
29381174_403112,CM021103.1,4,29381174,104881249,2357739,403112,105284361,77499430
29381174_403278,CM021103.1,4,29381174,104881249,2357739,403278,105284527,77499596
29381174_403324,CM021103.1,4,29381174,104881249,2357739,403324,105284573,77499642
29381174_403327,CM021103.1,4,29381174,104881249,2357739,403327,105284576,77499645
29379790_418464,CM021103.1,4,29379790,104880509,2432040,418464,105298973,77514042
29379790_418485,CM021103.1,4,29379790,104880509,2432040,418485,105298994,77514063
29379790_418518,CM021103.1,4,29379790,104880509,2432040,418518,105299027,77514096
29381174_417886,CM021103.1,4,29381174,104881249,2357739,417886,105299135,77514204
29379790_497788,CM021103.1,4,29379790,104880509,2432040,497788,105378297,77593366
29379790_507414,CM021103.1,4,29379790,104880509,2432040,507414,105387923,77602992
29379790_543879,CM021103.1,4,29379790,104880509,2432040,543879,105424388,77639457
29379790_543941,CM021103.1,4,29379790,104880509,2432040,543941,105424450,77639519
29379790_543945,CM021103.1,4,29379790,104880509,2432040,543945,105424454,77639523
29379790_560297,CM021103.1,4,29379790,104880509,2432040,560297,105440806,77655875
29381904_572289,CM021103.1,4,29381904,104880504,1650220,572289,105452793,77667862
29379790_601600,CM021103.1,4,29379790,104880509,2432040,601600,105482109,77697178
29379790_601742,CM021103.1,4,29379790,104880509,2432040,601742,105482251,77697320
29381428_845347,CM021103.1,4,29381428,104880663,1862728,845347,105726010,77941079
29379790_863838,CM021103.1,4,29379790,104880509,2432040,863838,105744347,77959416
29381174_938756,CM021103.1,4,29381174,104881249,2357739,938756,105820005,78035074
29381428_958054,CM021103.1,4,29381428,104880663,1862728,958054,105838717,78053786
29382282_1053599,CM021103.1,4,29382282,104880504,1575643,1053599,105934103,78149172
29381428_1088070,CM021103.1,4,29381428,104880663,1862728,1088070,105968733,78183802
29382282_1196805,CM021103.1,4,29382282,104880504,1575643,1196805,106077309,78292378
29382282_1196816,CM021103.1,4,29382282,104880504,1575643,1196816,106077320,78292389
29382282_1196868,CM021103.1,4,29382282,104880504,1575643,1196868,106077372,78292441
29381428_1253785,CM021103.1,4,29381428,104880663,1862728,1253785,106134448,78349517
29381428_1254380,CM021103.1,4,29381428,104880663,1862728,1254380,106135043,78350112
29381428_1255277,CM021103.1,4,29381428,104880663,1862728,1255277,106135940,78351009
29382282_1476171,CM021103.1,4,29382282,104880504,1575643,1476171,106356675,78571744
29382282_1562416,CM021103.1,4,29382282,104880504,1575643,1562416,106442920,78657989
29382282_1562450,CM021103.1,4,29382282,104880504,1575643,1562450,106442954,78658023
29382282_1562475,CM021103.1,4,29382282,104880504,1575643,1562475,106442979,78658048
29382282_1562493,CM021103.1,4,29382282,104880504,1575643,1562493,106442997,78658066
29382282_1562509,CM021103.1,4,29382282,104880504,1575643,1562509,106443013,78658082
29382282_1562520,CM021103.1,4,29382282,104880504,1575643,1562520,106443024,78658093
29382282_1562534,CM021103.1,4,29382282,104880504,1575643,1562534,106443038,78658107
29382282_1562535,CM021103.1,4,29382282,104880504,1575643,1562535,106443039,78658108
29382282_1562565,CM021103.1,4,29382282,104880504,1575643,1562565,106443069,78658138
29382282_1562572,CM021103.1,4,29382282,104880504,1575643,1562572,106443076,78658145
29382282_1562576,CM021103.1,4,29382282,104880504,1575643,1562576,106443080,78658149
29382282_1562610,CM021103.1,4,29382282,104880504,1575643,1562610,106443114,78658183
29379790_2123994,CM021103.1,4,29379790,104880509,2432040,2123994,107004503,79219572
29379790_2316466,CM021103.1,4,29379790,104880509,2432040,2316466,107196975,79412044
29379790_2316704,CM021103.1,4,29379790,104880509,2432040,2316704,107197213,79412282
29375414_12322,CM021103.1,4,29375414,118428172,24252,12322,118440494,90655563
29375414_12325,CM021103.1,4,29375414,118428172,24252,12325,118440497,90655566
29381648_168777,CM021103.1,4,29381648,132932650,1462033,168777,133101427,105316496
29381648_168783,CM021103.1,4,29381648,132932650,1462033,168783,133101433,105316502
29381648_170486,CM021103.1,4,29381648,132932650,1462033,170486,133103136,105318205
29381501_32654,CM021103.1,4,29381501,136870515,2005932,32654,136903169,109118238
29378567_117017,CM021103.1,4,29378567,136870515,866325,117017,136987532,109202601
29378567_117144,CM021103.1,4,29378567,136870515,866325,117144,136987659,109202728
29380533_128092,CM021103.1,4,29380533,136873369,2179942,128092,137001461,109216530
29380533_128103,CM021103.1,4,29380533,136873369,2179942,128103,137001472,109216541
29380533_128128,CM021103.1,4,29380533,136873369,2179942,128128,137001497,109216566
29380533_141720,CM021103.1,4,29380533,136873369,2179942,141720,137015089,109230158
29380533_141768,CM021103.1,4,29380533,136873369,2179942,141768,137015137,109230206
29380533_142175,CM021103.1,4,29380533,136873369,2179942,142175,137015544,109230613
29380533_142181,CM021103.1,4,29380533,136873369,2179942,142181,137015550,109230619
29380533_142204,CM021103.1,4,29380533,136873369,2179942,142204,137015573,109230642
29380533_142238,CM021103.1,4,29380533,136873369,2179942,142238,137015607,109230676
29380533_142769,CM021103.1,4,29380533,136873369,2179942,142769,137016138,109231207
29380533_142899,CM021103.1,4,29380533,136873369,2179942,142899,137016268,109231337
29380533_142999,CM021103.1,4,29380533,136873369,2179942,142999,137016368,109231437
29381200_275586,CM021103.1,4,29381200,136877778,1374763,275586,137153364,109368433
29366658_280745,CM021103.1,4,29366658,136877961,582756,280745,137158706,109373775
29381200_287036,CM021103.1,4,29381200,136877778,1374763,287036,137164814,109379883
29381200_287350,CM021103.1,4,29381200,136877778,1374763,287350,137165128,109380197
29381200_287362,CM021103.1,4,29381200,136877778,1374763,287362,137165140,109380209
29381200_287363,CM021103.1,4,29381200,136877778,1374763,287363,137165141,109380210
29381200_302440,CM021103.1,4,29381200,136877778,1374763,302440,137180218,109395287
29378567_358636,CM021103.1,4,29378567,136870515,866325,358636,137229151,109444220
29378567_361349,CM021103.1,4,29378567,136870515,866325,361349,137231864,109446933
29378567_361370,CM021103.1,4,29378567,136870515,866325,361370,137231885,109446954
29378567_361438,CM021103.1,4,29378567,136870515,866325,361438,137231953,109447022
29378567_361458,CM021103.1,4,29378567,136870515,866325,361458,137231973,109447042
29378567_361480,CM021103.1,4,29378567,136870515,866325,361480,137231995,109447064
29378567_361539,CM021103.1,4,29378567,136870515,866325,361539,137232054,109447123
29378567_411658,CM021103.1,4,29378567,136870515,866325,411658,137282173,109497242
29378567_411661,CM021103.1,4,29378567,136870515,866325,411661,137282176,109497245
29378567_420573,CM021103.1,4,29378567,136870515,866325,420573,137291088,109506157
29378567_420794,CM021103.1,4,29378567,136870515,866325,420794,137291309,109506378
29378567_420851,CM021103.1,4,29378567,136870515,866325,420851,137291366,109506435
29366658_565907,CM021103.1,4,29366658,136877961,582756,565907,137443868,109658937
29381185_582947,CM021103.1,4,29381185,136870515,1435263,582947,137453462,109668531
29381185_583162,CM021103.1,4,29381185,136870515,1435263,583162,137453677,109668746
29381501_812296,CM021103.1,4,29381501,136870515,2005932,812296,137682811,109897880
29381501_812353,CM021103.1,4,29381501,136870515,2005932,812353,137682868,109897937
29380715_906262,CM021103.1,4,29380715,136874709,1316292,906262,137780971,109996040
29380715_906301,CM021103.1,4,29380715,136874709,1316292,906301,137781010,109996079
29380715_1015461,CM021103.1,4,29380715,136874709,1316292,1015461,137890170,110105239
29380715_1016555,CM021103.1,4,29380715,136874709,1316292,1016555,137891264,110106333
29381501_1033952,CM021103.1,4,29381501,136870515,2005932,1033952,137904467,110119536
29377109_1244499,CM021103.1,4,29377109,136870516,2879361,1244499,138115015,110330084
29380533_1365708,CM021103.1,4,29380533,136873369,2179942,1365708,138239077,110454146
29380533_1365712,CM021103.1,4,29380533,136873369,2179942,1365712,138239081,110454150
29380533_1365737,CM021103.1,4,29380533,136873369,2179942,1365737,138239106,110454175
29380533_1365778,CM021103.1,4,29380533,136873369,2179942,1365778,138239147,110454216
29380533_1365831,CM021103.1,4,29380533,136873369,2179942,1365831,138239200,110454269
29380533_1368121,CM021103.1,4,29380533,136873369,2179942,1368121,138241490,110456559
29380533_1368194,CM021103.1,4,29380533,136873369,2179942,1368194,138241563,110456632
29380533_1368229,CM021103.1,4,29380533,136873369,2179942,1368229,138241598,110456667
29380533_1368305,CM021103.1,4,29380533,136873369,2179942,1368305,138241674,110456743
29381185_1382155,CM021103.1,4,29381185,136870515,1435263,1382155,138252670,110467739
29381501_1662236,CM021103.1,4,29381501,136870515,2005932,1662236,138532751,110747820
29381501_1662258,CM021103.1,4,29381501,136870515,2005932,1662258,138532773,110747842
29381501_1662269,CM021103.1,4,29381501,136870515,2005932,1662269,138532784,110747853
29381501_1801244,CM021103.1,4,29381501,136870515,2005932,1801244,138671759,110886828
29381501_1801443,CM021103.1,4,29381501,136870515,2005932,1801443,138671958,110887027
29381501_1801460,CM021103.1,4,29381501,136870515,2005932,1801460,138671975,110887044
29381501_1801464,CM021103.1,4,29381501,136870515,2005932,1801464,138671979,110887048
29381501_1801467,CM021103.1,4,29381501,136870515,2005932,1801467,138671982,110887051
29381501_1801468,CM021103.1,4,29381501,136870515,2005932,1801468,138671983,110887052
29381501_1801484,CM021103.1,4,29381501,136870515,2005932,1801484,138671999,110887068
29381501_1801488,CM021103.1,4,29381501,136870515,2005932,1801488,138672003,110887072
29381501_1801533,CM021103.1,4,29381501,136870515,2005932,1801533,138672048,110887117
29378621_1819553,CM021103.1,4,29378621,136870517,6322254,1819553,138690070,110905139
29378621_1819554,CM021103.1,4,29378621,136870517,6322254,1819554,138690071,110905140
29378621_1819557,CM021103.1,4,29378621,136870517,6322254,1819557,138690074,110905143
29378621_1819629,CM021103.1,4,29378621,136870517,6322254,1819629,138690146,110905215
29378621_1819734,CM021103.1,4,29378621,136870517,6322254,1819734,138690251,110905320
29378621_1819761,CM021103.1,4,29378621,136870517,6322254,1819761,138690278,110905347
29378621_1976872,CM021103.1,4,29378621,136870517,6322254,1976872,138847389,111062458
29378621_1976914,CM021103.1,4,29378621,136870517,6322254,1976914,138847431,111062500
29378621_1977156,CM021103.1,4,29378621,136870517,6322254,1977156,138847673,111062742
29380533_2134600,CM021103.1,4,29380533,136873369,2179942,2134600,139007969,111223038
29380533_2134675,CM021103.1,4,29380533,136873369,2179942,2134675,139008044,111223113
29377109_2333244,CM021103.1,4,29377109,136870516,2879361,2333244,139203760,111418829
29377109_2355440,CM021103.1,4,29377109,136870516,2879361,2355440,139225956,111441025
29377109_2355503,CM021103.1,4,29377109,136870516,2879361,2355503,139226019,111441088
29377109_2370930,CM021103.1,4,29377109,136870516,2879361,2370930,139241446,111456515
29377109_2370967,CM021103.1,4,29377109,136870516,2879361,2370967,139241483,111456552
29377109_2371092,CM021103.1,4,29377109,136870516,2879361,2371092,139241608,111456677
29377109_2371223,CM021103.1,4,29377109,136870516,2879361,2371223,139241739,111456808
29377109_2371263,CM021103.1,4,29377109,136870516,2879361,2371263,139241779,111456848
29377109_2371292,CM021103.1,4,29377109,136870516,2879361,2371292,139241808,111456877
29377109_2371301,CM021103.1,4,29377109,136870516,2879361,2371301,139241817,111456886
29378621_2399658,CM021103.1,4,29378621,136870517,6322254,2399658,139270175,111485244
29378621_2399692,CM021103.1,4,29378621,136870517,6322254,2399692,139270209,111485278
29378621_2399724,CM021103.1,4,29378621,136870517,6322254,2399724,139270241,111485310
29378519_2497390,CM021103.1,4,29378519,136870518,4928760,2497390,139367908,111582977
29378519_2497436,CM021103.1,4,29378519,136870518,4928760,2497436,139367954,111583023
29378519_2497468,CM021103.1,4,29378519,136870518,4928760,2497468,139367986,111583055
29378519_2497486,CM021103.1,4,29378519,136870518,4928760,2497486,139368004,111583073
29378519_2497487,CM021103.1,4,29378519,136870518,4928760,2497487,139368005,111583074
29378519_2497491,CM021103.1,4,29378519,136870518,4928760,2497491,139368009,111583078
29378519_2497522,CM021103.1,4,29378519,136870518,4928760,2497522,139368040,111583109
29378519_2497523,CM021103.1,4,29378519,136870518,4928760,2497523,139368041,111583110
29378519_2497538,CM021103.1,4,29378519,136870518,4928760,2497538,139368056,111583125
29378621_2503204,CM021103.1,4,29378621,136870517,6322254,2503204,139373721,111588790
29378621_2503261,CM021103.1,4,29378621,136870517,6322254,2503261,139373778,111588847
29378621_2503301,CM021103.1,4,29378621,136870517,6322254,2503301,139373818,111588887
29378621_2503324,CM021103.1,4,29378621,136870517,6322254,2503324,139373841,111588910
29378621_2503341,CM021103.1,4,29378621,136870517,6322254,2503341,139373858,111588927
293365701_68310,CM021103.1,4,293365701,139311210,298810,68310,139379520,111594589
293365701_68340,CM021103.1,4,293365701,139311210,298810,68340,139379550,111594619
293365701_68363,CM021103.1,4,293365701,139311210,298810,68363,139379573,111594642
29378642_153048,CM021103.1,4,29378642,139309038,626150,153048,139462086,111677155
29378642_153110,CM021103.1,4,29378642,139309038,626150,153110,139462148,111677217
29378642_153126,CM021103.1,4,29378642,139309038,626150,153126,139462164,111677233
29378642_153146,CM021103.1,4,29378642,139309038,626150,153146,139462184,111677253
29378642_153180,CM021103.1,4,29378642,139309038,626150,153180,139462218,111677287
29378642_153195,CM021103.1,4,29378642,139309038,626150,153195,139462233,111677302
29378642_153196,CM021103.1,4,29378642,139309038,626150,153196,139462234,111677303
29378621_2646485,CM021103.1,4,29378621,136870517,6322254,2646485,139517002,111732071
29378621_2646545,CM021103.1,4,29378621,136870517,6322254,2646545,139517062,111732131
29378621_2646676,CM021103.1,4,29378621,136870517,6322254,2646676,139517193,111732262
29378411_246347,CM021103.1,4,29378411,139309032,455521,246347,139555379,111770448
29378411_246371,CM021103.1,4,29378411,139309032,455521,246371,139555403,111770472
29378411_246385,CM021103.1,4,29378411,139309032,455521,246385,139555417,111770486
29378411_246397,CM021103.1,4,29378411,139309032,455521,246397,139555429,111770498
29377109_2752321,CM021103.1,4,29377109,136870516,2879361,2752321,139622837,111837906
29377109_2752343,CM021103.1,4,29377109,136870516,2879361,2752343,139622859,111837928
29377109_2752344,CM021103.1,4,29377109,136870516,2879361,2752344,139622860,111837929
29377109_2752357,CM021103.1,4,29377109,136870516,2879361,2752357,139622873,111837942
29377109_2752507,CM021103.1,4,29377109,136870516,2879361,2752507,139623023,111838092
29380612_335771,CM021103.1,4,29380612,139309034,1840709,335771,139644805,111859874
29380612_335861,CM021103.1,4,29380612,139309034,1840709,335861,139644895,111859964
29377109_2873361,CM021103.1,4,29377109,136870516,2879361,2873361,139743877,111958946
29378411_436724,CM021103.1,4,29378411,139309032,455521,436724,139745756,111960825
29378621_2920059,CM021103.1,4,29378621,136870517,6322254,2920059,139790576,112005645
29378621_2923561,CM021103.1,4,29378621,136870517,6322254,2923561,139794078,112009147
29378621_2923579,CM021103.1,4,29378621,136870517,6322254,2923579,139794096,112009165
29378621_2923615,CM021103.1,4,29378621,136870517,6322254,2923615,139794132,112009201
29378621_2924734,CM021103.1,4,29378621,136870517,6322254,2924734,139795251,112010320
29378621_2924739,CM021103.1,4,29378621,136870517,6322254,2924739,139795256,112010325
29378621_2924749,CM021103.1,4,29378621,136870517,6322254,2924749,139795266,112010335
29378621_2924773,CM021103.1,4,29378621,136870517,6322254,2924773,139795290,112010359
29378621_2924880,CM021103.1,4,29378621,136870517,6322254,2924880,139795397,112010466
29378621_2925144,CM021103.1,4,29378621,136870517,6322254,2925144,139795661,112010730
29378621_2925267,CM021103.1,4,29378621,136870517,6322254,2925267,139795784,112010853
29381762_530366,CM021103.1,4,29381762,139309039,5544081,530366,139839405,112054474
29381762_530611,CM021103.1,4,29381762,139309039,5544081,530611,139839650,112054719
29379114_530962,CM021103.1,4,29379114,139309039,744534,530962,139840001,112055070
29379114_546868,CM021103.1,4,29379114,139309039,744534,546868,139855907,112070976
29379114_564275,CM021103.1,4,29379114,139309039,744534,564275,139873314,112088383
29380094_580758,CM021103.1,4,29380094,139309033,1730161,580758,139889791,112104860
29381762_629270,CM021103.1,4,29381762,139309039,5544081,629270,139938309,112153378
29381762_629365,CM021103.1,4,29381762,139309039,5544081,629365,139938404,112153473
29381762_629403,CM021103.1,4,29381762,139309039,5544081,629403,139938442,112153511
29380612_694200,CM021103.1,4,29380612,139309034,1840709,694200,140003234,112218303
29380612_694214,CM021103.1,4,29380612,139309034,1840709,694214,140003248,112218317
29380612_694215,CM021103.1,4,29380612,139309034,1840709,694215,140003249,112218318
29380612_694218,CM021103.1,4,29380612,139309034,1840709,694218,140003252,112218321
29380612_694254,CM021103.1,4,29380612,139309034,1840709,694254,140003288,112218357
29380612_694281,CM021103.1,4,29380612,139309034,1840709,694281,140003315,112218384
29380612_694307,CM021103.1,4,29380612,139309034,1840709,694307,140003341,112218410
29380612_694319,CM021103.1,4,29380612,139309034,1840709,694319,140003353,112218422
29380612_694325,CM021103.1,4,29380612,139309034,1840709,694325,140003359,112218428
29380612_694327,CM021103.1,4,29380612,139309034,1840709,694327,140003361,112218430
29380612_694361,CM021103.1,4,29380612,139309034,1840709,694361,140003395,112218464
29380612_694391,CM021103.1,4,29380612,139309034,1840709,694391,140003425,112218494
29380612_694458,CM021103.1,4,29380612,139309034,1840709,694458,140003492,112218561
29380612_985626,CM021103.1,4,29380612,139309034,1840709,985626,140294660,112509729
29380612_985661,CM021103.1,4,29380612,139309034,1840709,985661,140294695,112509764
29380612_985672,CM021103.1,4,29380612,139309034,1840709,985672,140294706,112509775
29380612_986536,CM021103.1,4,29380612,139309034,1840709,986536,140295570,112510639
29380612_986603,CM021103.1,4,29380612,139309034,1840709,986603,140295637,112510706
29378621_3554432,CM021103.1,4,29378621,136870517,6322254,3554432,140424949,112640018
29378621_3598820,CM021103.1,4,29378621,136870517,6322254,3598820,140469337,112684406
29380051_1504831,CM021103.1,4,29380051,139309038,4143438,1504831,140813869,113028938
29378519_4354935,CM021103.1,4,29378519,136870518,4928760,4354935,141225453,113440522
29378519_4357282,CM021103.1,4,29378519,136870518,4928760,4357282,141227800,113442869
29378519_4357348,CM021103.1,4,29378519,136870518,4928760,4357348,141227866,113442935
29381135_2080359,CM021103.1,4,29381135,139309041,2304749,2080359,141389400,113604469
29381135_2080452,CM021103.1,4,29381135,139309041,2304749,2080452,141389493,113604562
29381135_2080457,CM021103.1,4,29381135,139309041,2304749,2080457,141389498,113604567
29381135_2080492,CM021103.1,4,29381135,139309041,2304749,2080492,141389533,113604602
29381135_2080499,CM021103.1,4,29381135,139309041,2304749,2080499,141389540,113604609
29378519_4903534,CM021103.1,4,29378519,136870518,4928760,4903534,141774052,113989121
29378519_4903565,CM021103.1,4,29378519,136870518,4928760,4903565,141774083,113989152
29378519_4903581,CM021103.1,4,29378519,136870518,4928760,4903581,141774099,113989168
29378519_4903751,CM021103.1,4,29378519,136870518,4928760,4903751,141774269,113989338
29381762_2473191,CM021103.1,4,29381762,139309039,5544081,2473191,141782230,113997299
29381762_2474723,CM021103.1,4,29381762,139309039,5544081,2474723,141783762,113998831
29381762_2474728,CM021103.1,4,29381762,139309039,5544081,2474728,141783767,113998836
29381762_2474743,CM021103.1,4,29381762,139309039,5544081,2474743,141783782,113998851
29381762_2474836,CM021103.1,4,29381762,139309039,5544081,2474836,141783875,113998944
29381762_2476714,CM021103.1,4,29381762,139309039,5544081,2476714,141785753,114000822
29381762_2476816,CM021103.1,4,29381762,139309039,5544081,2476816,141785855,114000924
29380051_2535002,CM021103.1,4,29380051,139309038,4143438,2535002,141844040,114059109
29381762_2587661,CM021103.1,4,29381762,139309039,5544081,2587661,141896700,114111769
29381762_2587677,CM021103.1,4,29381762,139309039,5544081,2587677,141896716,114111785
29381762_2587813,CM021103.1,4,29381762,139309039,5544081,2587813,141896852,114111921
29381762_2587826,CM021103.1,4,29381762,139309039,5544081,2587826,141896865,114111934
29381762_2587874,CM021103.1,4,29381762,139309039,5544081,2587874,141896913,114111982
29381762_2587879,CM021103.1,4,29381762,139309039,5544081,2587879,141896918,114111987
29381762_2587897,CM021103.1,4,29381762,139309039,5544081,2587897,141896936,114112005
29381762_2587908,CM021103.1,4,29381762,139309039,5544081,2587908,141896947,114112016
29381762_2590665,CM021103.1,4,29381762,139309039,5544081,2590665,141899704,114114773
29381762_2591783,CM021103.1,4,29381762,139309039,5544081,2591783,141900822,114115891
29381762_3266513,CM021103.1,4,29381762,139309039,5544081,3266513,142575552,114790621
29378621_6282213,CM021103.1,4,29378621,136870517,6322254,6282213,143152730,115367799
29378621_6282324,CM021103.1,4,29378621,136870517,6322254,6282324,143152841,115367910
29378621_6302556,CM021103.1,4,29378621,136870517,6322254,6302556,143173073,115388142
29378621_6302749,CM021103.1,4,29378621,136870517,6322254,6302749,143173266,115388335
29381762_3902382,CM021103.1,4,29381762,139309039,5544081,3902382,143211421,115426490
29381762_3940566,CM021103.1,4,29381762,139309039,5544081,3940566,143249605,115464674
29381762_3947120,CM021103.1,4,29381762,139309039,5544081,3947120,143256159,115471228
29381762_3974215,CM021103.1,4,29381762,139309039,5544081,3974215,143283254,115498323
29381762_4790642,CM021103.1,4,29381762,139309039,5544081,4790642,144099681,116314750
29381762_4793797,CM021103.1,4,29381762,139309039,5544081,4793797,144102836,116317905
29381762_5126831,CM021103.1,4,29381762,139309039,5544081,5126831,144435870,116650939
29381762_5126832,CM021103.1,4,29381762,139309039,5544081,5126832,144435871,116650940
29381762_5126842,CM021103.1,4,29381762,139309039,5544081,5126842,144435881,116650950
29381762_5126861,CM021103.1,4,29381762,139309039,5544081,5126861,144435900,116650969
29381762_5127600,CM021103.1,4,29381762,139309039,5544081,5127600,144436639,116651708
29381762_5127601,CM021103.1,4,29381762,139309039,5544081,5127601,144436640,116651709
29381762_5130624,CM021103.1,4,29381762,139309039,5544081,5130624,144439663,116654732
29381762_5130632,CM021103.1,4,29381762,139309039,5544081,5130632,144439671,116654740
29367903_275693,CM021103.1,4,29367903,152796041,358318,275693,153071734,125286803
29367903_275753,CM021103.1,4,29367903,152796041,358318,275753,153071794,125286863
29354810_23493,CM021103.1,4,29354810,164885467,37883,23493,164908960,137124029
29354810_23534,CM021103.1,4,29354810,164885467,37883,23534,164909001,137124070
29354810_23551,CM021103.1,4,29354810,164885467,37883,23551,164909018,137124087
29354810_23597,CM021103.1,4,29354810,164885467,37883,23597,164909064,137124133
29354810_23600,CM021103.1,4,29354810,164885467,37883,23600,164909067,137124136
29354810_23606,CM021103.1,4,29354810,164885467,37883,23606,164909073,137124142
29380987_31124,CM021103.1,4,29380987,164882034,511906,31124,164913158,137128227
29380987_31254,CM021103.1,4,29380987,164882034,511906,31254,164913288,137128357
29381086_42584,CM021103.1,4,29381086,164882040,6438302,42584,164924624,137139693
29371212_81357,CM021103.1,4,29371212,164882040,98749,81357,164963397,137178466
29371212_81372,CM021103.1,4,29371212,164882040,98749,81372,164963412,137178481
29371212_81388,CM021103.1,4,29371212,164882040,98749,81388,164963428,137178497
29371212_81392,CM021103.1,4,29371212,164882040,98749,81392,164963432,137178501
29371212_81397,CM021103.1,4,29371212,164882040,98749,81397,164963437,137178506
29371212_81411,CM021103.1,4,29371212,164882040,98749,81411,164963451,137178520
29371212_81412,CM021103.1,4,29371212,164882040,98749,81412,164963452,137178521
29371212_81418,CM021103.1,4,29371212,164882040,98749,81418,164963458,137178527
29371212_81430,CM021103.1,4,29371212,164882040,98749,81430,164963470,137178539
29371212_81433,CM021103.1,4,29371212,164882040,98749,81433,164963473,137178542
29371212_81446,CM021103.1,4,29371212,164882040,98749,81446,164963486,137178555
29371212_81447,CM021103.1,4,29371212,164882040,98749,81447,164963487,137178556
29371212_81449,CM021103.1,4,29371212,164882040,98749,81449,164963489,137178558
29371212_81451,CM021103.1,4,29371212,164882040,98749,81451,164963491,137178560
29378287_180322,CM021103.1,4,29378287,164882040,2891393,180322,165062362,137277431
29377766_238841,CM021103.1,4,29377766,164882770,243879,238841,165121611,137336680
29377766_239036,CM021103.1,4,29377766,164882770,243879,239036,165121806,137336875
29378263_251931,CM021103.1,4,29378263,164883082,534961,251931,165135013,137350082
29378263_251989,CM021103.1,4,29378263,164883082,534961,251989,165135071,137350140
29381086_306728,CM021103.1,4,29381086,164882040,6438302,306728,165188768,137403837
29381690_308086,CM021103.1,4,29381690,164882040,414395,308086,165190126,137405195
29381690_308125,CM021103.1,4,29381690,164882040,414395,308125,165190165,137405234
29381690_308173,CM021103.1,4,29381690,164882040,414395,308173,165190213,137405282
29380987_330814,CM021103.1,4,29380987,164882034,511906,330814,165212848,137427917
29380987_330820,CM021103.1,4,29380987,164882034,511906,330820,165212854,137427923
29380987_330828,CM021103.1,4,29380987,164882034,511906,330828,165212862,137427931
29380987_330849,CM021103.1,4,29380987,164882034,511906,330849,165212883,137427952
29380987_330901,CM021103.1,4,29380987,164882034,511906,330901,165212935,137428004
29380987_330915,CM021103.1,4,29380987,164882034,511906,330915,165212949,137428018
29380987_330947,CM021103.1,4,29380987,164882034,511906,330947,165212981,137428050
29380987_330984,CM021103.1,4,29380987,164882034,511906,330984,165213018,137428087
29381749_454394,CM021103.1,4,29381749,164882547,3658147,454394,165336941,137552010
29381749_454445,CM021103.1,4,29381749,164882547,3658147,454445,165336992,137552061
29381749_454447,CM021103.1,4,29381749,164882547,3658147,454447,165336994,137552063
29381749_454504,CM021103.1,4,29381749,164882547,3658147,454504,165337051,137552120
29381749_611351,CM021103.1,4,29381749,164882547,3658147,611351,165493898,137708967
29381749_611365,CM021103.1,4,29381749,164882547,3658147,611365,165493912,137708981
29381864_611913,CM021103.1,4,29381864,164882099,1302822,611913,165494012,137709081
29381864_611927,CM021103.1,4,29381864,164882099,1302822,611927,165494026,137709095
29381749_640857,CM021103.1,4,29381749,164882547,3658147,640857,165523404,137738473
29381749_641040,CM021103.1,4,29381749,164882547,3658147,641040,165523587,137738656
29381749_641070,CM021103.1,4,29381749,164882547,3658147,641070,165523617,137738686
29381749_641076,CM021103.1,4,29381749,164882547,3658147,641076,165523623,137738692
29381749_641085,CM021103.1,4,29381749,164882547,3658147,641085,165523632,137738701
29380877_797842,CM021103.1,4,29380877,164882040,2279834,797842,165679882,137894951
29379870_840505,CM021103.1,4,29379870,164882152,1849070,840505,165722657,137937726
29379870_840533,CM021103.1,4,29379870,164882152,1849070,840533,165722685,137937754
29379870_840621,CM021103.1,4,29379870,164882152,1849070,840621,165722773,137937842
29379870_840630,CM021103.1,4,29379870,164882152,1849070,840630,165722782,137937851
29377561_871414,CM021103.1,4,29377561,164882038,2555134,871414,165753452,137968521
29377561_871426,CM021103.1,4,29377561,164882038,2555134,871426,165753464,137968533
29377561_871430,CM021103.1,4,29377561,164882038,2555134,871430,165753468,137968537
29377561_871477,CM021103.1,4,29377561,164882038,2555134,871477,165753515,137968584
29377561_871478,CM021103.1,4,29377561,164882038,2555134,871478,165753516,137968585
29377561_871492,CM021103.1,4,29377561,164882038,2555134,871492,165753530,137968599
29377561_871494,CM021103.1,4,29377561,164882038,2555134,871494,165753532,137968601
29377561_871496,CM021103.1,4,29377561,164882038,2555134,871496,165753534,137968603
29381749_1169271,CM021103.1,4,29381749,164882547,3658147,1169271,166051818,138266887
29381749_1220254,CM021103.1,4,29381749,164882547,3658147,1220254,166102801,138317870
29381086_1315967,CM021103.1,4,29381086,164882040,6438302,1315967,166198007,138413076
29381086_1316138,CM021103.1,4,29381086,164882040,6438302,1316138,166198178,138413247
29381086_1316175,CM021103.1,4,29381086,164882040,6438302,1316175,166198215,138413284
29381086_1316235,CM021103.1,4,29381086,164882040,6438302,1316235,166198275,138413344
29379084_1464162,CM021103.1,4,29379084,164882037,2067125,1464162,166346199,138561268
29381749_1480244,CM021103.1,4,29381749,164882547,3658147,1480244,166362791,138577860
29381749_1480364,CM021103.1,4,29381749,164882547,3658147,1480364,166362911,138577980
29381749_1480370,CM021103.1,4,29381749,164882547,3658147,1480370,166362917,138577986
29381749_1480443,CM021103.1,4,29381749,164882547,3658147,1480443,166362990,138578059
29377561_1496567,CM021103.1,4,29377561,164882038,2555134,1496567,166378605,138593674
29381749_1896009,CM021103.1,4,29381749,164882547,3658147,1896009,166778556,138993625
29381749_1896283,CM021103.1,4,29381749,164882547,3658147,1896283,166778830,138993899
29381749_1954191,CM021103.1,4,29381749,164882547,3658147,1954191,166836738,139051807
29380786_2140144,CM021103.1,4,29380786,164882038,2276692,2140144,167022182,139237251
29381749_2158249,CM021103.1,4,29381749,164882547,3658147,2158249,167040796,139255865
29378575_2162333,CM021103.1,4,29378575,164882040,2343250,2162333,167044373,139259442
29381086_2464939,CM021103.1,4,29381086,164882040,6438302,2464939,167346979,139562048
29381086_2465023,CM021103.1,4,29381086,164882040,6438302,2465023,167347063,139562132
29378287_2493435,CM021103.1,4,29378287,164882040,2891393,2493435,167375475,139590544
29378287_2494708,CM021103.1,4,29378287,164882040,2891393,2494708,167376748,139591817
29378287_2528294,CM021103.1,4,29378287,164882040,2891393,2528294,167410334,139625403
29378287_2528512,CM021103.1,4,29378287,164882040,2891393,2528512,167410552,139625621
29378287_2528568,CM021103.1,4,29378287,164882040,2891393,2528568,167410608,139625677
29378287_2528600,CM021103.1,4,29378287,164882040,2891393,2528600,167410640,139625709
29381749_3390856,CM021103.1,4,29381749,164882547,3658147,3390856,168273403,140488472
29381749_3391242,CM021103.1,4,29381749,164882547,3658147,3391242,168273789,140488858
29381749_3528914,CM021103.1,4,29381749,164882547,3658147,3528914,168411461,140626530
29381749_3552292,CM021103.1,4,29381749,164882547,3658147,3552292,168434839,140649908
29381749_3552385,CM021103.1,4,29381749,164882547,3658147,3552385,168434932,140650001
29381749_3552563,CM021103.1,4,29381749,164882547,3658147,3552563,168435110,140650179
29381749_3552736,CM021103.1,4,29381749,164882547,3658147,3552736,168435283,140650352
29381749_3552749,CM021103.1,4,29381749,164882547,3658147,3552749,168435296,140650365
29381086_3893675,CM021103.1,4,29381086,164882040,6438302,3893675,168775715,140990784
29381086_3893777,CM021103.1,4,29381086,164882040,6438302,3893777,168775817,140990886
29381086_3893962,CM021103.1,4,29381086,164882040,6438302,3893962,168776002,140991071
29381086_3893997,CM021103.1,4,29381086,164882040,6438302,3893997,168776037,140991106
29381086_3894004,CM021103.1,4,29381086,164882040,6438302,3894004,168776044,140991113
29381086_3966618,CM021103.1,4,29381086,164882040,6438302,3966618,168848658,141063727
29381086_3966724,CM021103.1,4,29381086,164882040,6438302,3966724,168848764,141063833
29381086_4057425,CM021103.1,4,29381086,164882040,6438302,4057425,168939465,141154534
29381086_5110372,CM021103.1,4,29381086,164882040,6438302,5110372,169992412,142207481
29381086_5110419,CM021103.1,4,29381086,164882040,6438302,5110419,169992459,142207528
29381086_5147128,CM021103.1,4,29381086,164882040,6438302,5147128,170029168,142244237
29381086_5150573,CM021103.1,4,29381086,164882040,6438302,5150573,170032613,142247682
29381086_5150597,CM021103.1,4,29381086,164882040,6438302,5150597,170032637,142247706
29381086_5150756,CM021103.1,4,29381086,164882040,6438302,5150756,170032796,142247865
29381086_5150778,CM021103.1,4,29381086,164882040,6438302,5150778,170032818,142247887
29381086_5150850,CM021103.1,4,29381086,164882040,6438302,5150850,170032890,142247959
29381086_5453241,CM021103.1,4,29381086,164882040,6438302,5453241,170335281,142550350
29381086_5453249,CM021103.1,4,29381086,164882040,6438302,5453249,170335289,142550358
29381086_5453280,CM021103.1,4,29381086,164882040,6438302,5453280,170335320,142550389
29381086_5517043,CM021103.1,4,29381086,164882040,6438302,5517043,170399083,142614152
29381086_5517045,CM021103.1,4,29381086,164882040,6438302,5517045,170399085,142614154
29381086_5517076,CM021103.1,4,29381086,164882040,6438302,5517076,170399116,142614185
29381086_5517083,CM021103.1,4,29381086,164882040,6438302,5517083,170399123,142614192
29381086_5517101,CM021103.1,4,29381086,164882040,6438302,5517101,170399141,142614210
29381086_5604049,CM021103.1,4,29381086,164882040,6438302,5604049,170486089,142701158
29381086_5604111,CM021103.1,4,29381086,164882040,6438302,5604111,170486151,142701220
29381086_5604206,CM021103.1,4,29381086,164882040,6438302,5604206,170486246,142701315
29381086_5878006,CM021103.1,4,29381086,164882040,6438302,5878006,170760046,142975115
29381086_5878300,CM021103.1,4,29381086,164882040,6438302,5878300,170760340,142975409
29381086_5878354,CM021103.1,4,29381086,164882040,6438302,5878354,170760394,142975463
29381086_5878412,CM021103.1,4,29381086,164882040,6438302,5878412,170760452,142975521
29373002_7205,CM021103.1,4,29373002,171647733,387895,7205,171654938,143870007
29373002_7247,CM021103.1,4,29373002,171647733,387895,7247,171654980,143870049
29380353_15172,CM021103.1,4,29380353,171648718,651579,15172,171663890,143878959
29380353_15219,CM021103.1,4,29380353,171648718,651579,15219,171663937,143879006
29380353_18003,CM021103.1,4,29380353,171648718,651579,18003,171666721,143881790
29380353_18010,CM021103.1,4,29380353,171648718,651579,18010,171666728,143881797
29380353_18061,CM021103.1,4,29380353,171648718,651579,18061,171666779,143881848
29380353_18062,CM021103.1,4,29380353,171648718,651579,18062,171666780,143881849
29380353_18064,CM021103.1,4,29380353,171648718,651579,18064,171666782,143881851
29380353_18118,CM021103.1,4,29380353,171648718,651579,18118,171666836,143881905
29380353_18157,CM021103.1,4,29380353,171648718,651579,18157,171666875,143881944
29380353_18204,CM021103.1,4,29380353,171648718,651579,18204,171666922,143881991
29380353_18243,CM021103.1,4,29380353,171648718,651579,18243,171666961,143882030
29380353_18354,CM021103.1,4,29380353,171648718,651579,18354,171667072,143882141
29373002_24767,CM021103.1,4,29373002,171647733,387895,24767,171672500,143887569
29373002_65440,CM021103.1,4,29373002,171647733,387895,65440,171713173,143928242
29373002_65461,CM021103.1,4,29373002,171647733,387895,65461,171713194,143928263
29374343_92170,CM021103.1,4,29374343,171648440,409092,92170,171740610,143955679
29374343_92233,CM021103.1,4,29374343,171648440,409092,92233,171740673,143955742
29374343_92266,CM021103.1,4,29374343,171648440,409092,92266,171740706,143955775
29374343_92283,CM021103.1,4,29374343,171648440,409092,92283,171740723,143955792
29374343_92379,CM021103.1,4,29374343,171648440,409092,92379,171740819,143955888
29377556_171773,CM021103.1,4,29377556,171647739,1587039,171773,171819512,144034581
29373002_183902,CM021103.1,4,29373002,171647733,387895,183902,171831635,144046704
29373002_209108,CM021103.1,4,29373002,171647733,387895,209108,171856841,144071910
29377556_216120,CM021103.1,4,29377556,171647739,1587039,216120,171863859,144078928
29377556_216968,CM021103.1,4,29377556,171647739,1587039,216968,171864707,144079776
29377556_273474,CM021103.1,4,29377556,171647739,1587039,273474,171921213,144136282
29381936_309143,CM021103.1,4,29381936,171647734,1784729,309143,171956877,144171946
29381936_309509,CM021103.1,4,29381936,171647734,1784729,309509,171957243,144172312
29378566_332070,CM021103.1,4,29378566,171647739,866576,332070,171979809,144194878
29378566_332123,CM021103.1,4,29378566,171647739,866576,332123,171979862,144194931
29378566_332126,CM021103.1,4,29378566,171647739,866576,332126,171979865,144194934
29378566_332155,CM021103.1,4,29378566,171647739,866576,332155,171979894,144194963
29378566_332160,CM021103.1,4,29378566,171647739,866576,332160,171979899,144194968
29378566_332204,CM021103.1,4,29378566,171647739,866576,332204,171979943,144195012
29379807_340618,CM021103.1,4,29379807,171647732,398012,340618,171988350,144203419
29379807_340619,CM021103.1,4,29379807,171647732,398012,340619,171988351,144203420
29379807_340666,CM021103.1,4,29379807,171647732,398012,340666,171988398,144203467
29379807_340670,CM021103.1,4,29379807,171647732,398012,340670,171988402,144203471
29379807_340674,CM021103.1,4,29379807,171647732,398012,340674,171988406,144203475
29379807_340691,CM021103.1,4,29379807,171647732,398012,340691,171988423,144203492
29379807_340748,CM021103.1,4,29379807,171647732,398012,340748,171988480,144203549
29379807_340753,CM021103.1,4,29379807,171647732,398012,340753,171988485,144203554
29380353_345009,CM021103.1,4,29380353,171648718,651579,345009,171993727,144208796
29380353_345060,CM021103.1,4,29380353,171648718,651579,345060,171993778,144208847
29380353_345062,CM021103.1,4,29380353,171648718,651579,345062,171993780,144208849
29380353_345543,CM021103.1,4,29380353,171648718,651579,345543,171994261,144209330
29380353_346107,CM021103.1,4,29380353,171648718,651579,346107,171994825,144209894
29380353_350407,CM021103.1,4,29380353,171648718,651579,350407,171999125,144214194
29380353_445735,CM021103.1,4,29380353,171648718,651579,445735,172094453,144309522
29380353_445778,CM021103.1,4,29380353,171648718,651579,445778,172094496,144309565
29378965_1160532,CM021103.1,4,29378965,171648039,1978110,1160532,172808571,145023640
29378965_1160668,CM021103.1,4,29378965,171648039,1978110,1160668,172808707,145023776
29378965_1213139,CM021103.1,4,29378965,171648039,1978110,1213139,172861178,145076247
29378965_1306785,CM021103.1,4,29378965,171648039,1978110,1306785,172954824,145169893
29377556_1582905,CM021103.1,4,29377556,171647739,1587039,1582905,173230644,145445713
29377556_1582952,CM021103.1,4,29377556,171647739,1587039,1582952,173230691,145445760
29381936_1657253,CM021103.1,4,29381936,171647734,1784729,1657253,173304987,145520056
29381936_1657264,CM021103.1,4,29381936,171647734,1784729,1657264,173304998,145520067
29381936_1657287,CM021103.1,4,29381936,171647734,1784729,1657287,173305021,145520090
29381936_1663626,CM021103.1,4,29381936,171647734,1784729,1663626,173311360,145526429
29381936_1704431,CM021103.1,4,29381936,171647734,1784729,1704431,173352165,145567234
29381936_1704463,CM021103.1,4,29381936,171647734,1784729,1704463,173352197,145567266
29378965_1767353,CM021103.1,4,29378965,171648039,1978110,1767353,173415392,145630461
29378965_1769572,CM021103.1,4,29378965,171648039,1978110,1769572,173417611,145632680
29378965_1769583,CM021103.1,4,29378965,171648039,1978110,1769583,173417622,145632691
29378965_1769603,CM021103.1,4,29378965,171648039,1978110,1769603,173417642,145632711
29378965_1769626,CM021103.1,4,29378965,171648039,1978110,1769626,173417665,145632734
29381202_1918252,CM021103.1,4,29381202,171647737,2863694,1918252,173565989,145781058
29381202_1918261,CM021103.1,4,29381202,171647737,2863694,1918261,173565998,145781067
29381202_1918302,CM021103.1,4,29381202,171647737,2863694,1918302,173566039,145781108
29381202_1918304,CM021103.1,4,29381202,171647737,2863694,1918304,173566041,145781110
29381202_1918353,CM021103.1,4,29381202,171647737,2863694,1918353,173566090,145781159
29379583_44828,CM021103.1,4,29379583,186289522,339208,44828,186334350,158549419
29379583_44842,CM021103.1,4,29379583,186289522,339208,44842,186334364,158549433
29379583_44927,CM021103.1,4,29379583,186289522,339208,44927,186334449,158549518
29379583_44951,CM021103.1,4,29379583,186289522,339208,44951,186334473,158549542
29377865_53145,CM021103.1,4,29377865,186293225,457820,53145,186346370,158561439
29377865_53193,CM021103.1,4,29377865,186293225,457820,53193,186346418,158561487
29381010_70836,CM021103.1,4,29381010,186289526,112797,70836,186360362,158575431
29381010_70856,CM021103.1,4,29381010,186289526,112797,70856,186360382,158575451
29381010_70946,CM021103.1,4,29381010,186289526,112797,70946,186360472,158575541
29378473_78910,CM021103.1,4,29378473,186289525,3568172,78910,186368435,158583504
29378473_78925,CM021103.1,4,29378473,186289525,3568172,78925,186368450,158583519
29378473_78971,CM021103.1,4,29378473,186289525,3568172,78971,186368496,158583565
29378473_79370,CM021103.1,4,29378473,186289525,3568172,79370,186368895,158583964
29377809_102718,CM021103.1,4,29377809,186289527,613662,102718,186392245,158607314
29380424_150355,CM021103.1,4,29380424,186289531,299490,150355,186439886,158654955
29379567_173306,CM021103.1,4,29379567,186289527,2348005,173306,186462833,158677902
29379567_173379,CM021103.1,4,29379567,186289527,2348005,173379,186462906,158677975
29379273_226363,CM021103.1,4,29379273,186289531,2514540,226363,186515894,158730963
29380287_258669,CM021103.1,4,29380287,186289768,607654,258669,186548437,158763506
29380287_258796,CM021103.1,4,29380287,186289768,607654,258796,186548564,158763633
29380287_258797,CM021103.1,4,29380287,186289768,607654,258797,186548565,158763634
29380287_264025,CM021103.1,4,29380287,186289768,607654,264025,186553793,158768862
29380287_264094,CM021103.1,4,29380287,186289768,607654,264094,186553862,158768931
29380287_264146,CM021103.1,4,29380287,186289768,607654,264146,186553914,158768983
29380287_264161,CM021103.1,4,29380287,186289768,607654,264161,186553929,158768998
29380287_264228,CM021103.1,4,29380287,186289768,607654,264228,186553996,158769065
29380287_264456,CM021103.1,4,29380287,186289768,607654,264456,186554224,158769293
29380287_264510,CM021103.1,4,29380287,186289768,607654,264510,186554278,158769347
29377894_323790,CM021103.1,4,29377894,186289531,553471,323790,186613321,158828390
29377894_323947,CM021103.1,4,29377894,186289531,553471,323947,186613478,158828547
29377894_323993,CM021103.1,4,29377894,186289531,553471,323993,186613524,158828593
29377894_327121,CM021103.1,4,29377894,186289531,553471,327121,186616652,158831721
29377894_327125,CM021103.1,4,29377894,186289531,553471,327125,186616656,158831725
29377894_327127,CM021103.1,4,29377894,186289531,553471,327127,186616658,158831727
29380806_390746,CM021103.1,4,29380806,186289531,2465626,390746,186680277,158895346
29380806_390958,CM021103.1,4,29380806,186289531,2465626,390958,186680489,158895558
29380806_397593,CM021103.1,4,29380806,186289531,2465626,397593,186687124,158902193
29380806_397600,CM021103.1,4,29380806,186289531,2465626,397600,186687131,158902200
29380806_397652,CM021103.1,4,29380806,186289531,2465626,397652,186687183,158902252
29380806_397667,CM021103.1,4,29380806,186289531,2465626,397667,186687198,158902267
29380708_454224,CM021103.1,4,29380708,186289528,3218023,454224,186743752,158958821
29379320_472556,CM021103.1,4,29379320,186289527,666797,472556,186762083,158977152
29379320_472588,CM021103.1,4,29379320,186289527,666797,472588,186762115,158977184
29380806_535425,CM021103.1,4,29380806,186289531,2465626,535425,186824956,159040025
29380806_535460,CM021103.1,4,29380806,186289531,2465626,535460,186824991,159040060
29378473_565327,CM021103.1,4,29378473,186289525,3568172,565327,186854852,159069921
29380287_580701,CM021103.1,4,29380287,186289768,607654,580701,186870469,159085538
29377809_601131,CM021103.1,4,29377809,186289527,613662,601131,186890658,159105727
29377809_601137,CM021103.1,4,29377809,186289527,613662,601137,186890664,159105733
29361473_616019,CM021103.1,4,29361473,186289531,1063254,616019,186905550,159120619
29380806_657609,CM021103.1,4,29380806,186289531,2465626,657609,186947140,159162209
29380806_657656,CM021103.1,4,29380806,186289531,2465626,657656,186947187,159162256
29380806_657793,CM021103.1,4,29380806,186289531,2465626,657793,186947324,159162393
29380806_667924,CM021103.1,4,29380806,186289531,2465626,667924,186957455,159172524
29380806_668432,CM021103.1,4,29380806,186289531,2465626,668432,186957963,159173032
29380806_668543,CM021103.1,4,29380806,186289531,2465626,668543,186958074,159173143
29378473_706775,CM021103.1,4,29378473,186289525,3568172,706775,186996300,159211369
29379095_846341,CM021103.1,4,29379095,186291249,2487997,846341,187137590,159352659
29379095_850712,CM021103.1,4,29379095,186291249,2487997,850712,187141961,159357030
29377559_984448,CM021103.1,4,29377559,186289531,5335367,984448,187273979,159489048
29377559_984562,CM021103.1,4,29377559,186289531,5335367,984562,187274093,159489162
29377559_985031,CM021103.1,4,29377559,186289531,5335367,985031,187274562,159489631
29377559_985062,CM021103.1,4,29377559,186289531,5335367,985062,187274593,159489662
29377559_985087,CM021103.1,4,29377559,186289531,5335367,985087,187274618,159489687
29377559_985092,CM021103.1,4,29377559,186289531,5335367,985092,187274623,159489692
29377559_985105,CM021103.1,4,29377559,186289531,5335367,985105,187274636,159489705
29377559_985117,CM021103.1,4,29377559,186289531,5335367,985117,187274648,159489717
29377559_985119,CM021103.1,4,29377559,186289531,5335367,985119,187274650,159489719
29378473_1002075,CM021103.1,4,29378473,186289525,3568172,1002075,187291600,159506669
29380806_1013895,CM021103.1,4,29380806,186289531,2465626,1013895,187303426,159518495
29380806_1227025,CM021103.1,4,29380806,186289531,2465626,1227025,187516556,159731625
29380806_1227127,CM021103.1,4,29380806,186289531,2465626,1227127,187516658,159731727
29380806_1227140,CM021103.1,4,29380806,186289531,2465626,1227140,187516671,159731740
29380806_1227258,CM021103.1,4,29380806,186289531,2465626,1227258,187516789,159731858
29380806_1227380,CM021103.1,4,29380806,186289531,2465626,1227380,187516911,159731980
29380708_1287656,CM021103.1,4,29380708,186289528,3218023,1287656,187577184,159792253
29380708_1287678,CM021103.1,4,29380708,186289528,3218023,1287678,187577206,159792275
29380708_1287766,CM021103.1,4,29380708,186289528,3218023,1287766,187577294,159792363
29380708_1288797,CM021103.1,4,29380708,186289528,3218023,1288797,187578325,159793394
29380708_1288828,CM021103.1,4,29380708,186289528,3218023,1288828,187578356,159793425
29380708_1288880,CM021103.1,4,29380708,186289528,3218023,1288880,187578408,159793477
29380708_1288988,CM021103.1,4,29380708,186289528,3218023,1288988,187578516,159793585
29378664_1365606,CM021103.1,4,29378664,186289531,5130627,1365606,187655137,159870206
29378664_1365619,CM021103.1,4,29378664,186289531,5130627,1365619,187655150,159870219
29378664_1365623,CM021103.1,4,29378664,186289531,5130627,1365623,187655154,159870223
29378664_1365665,CM021103.1,4,29378664,186289531,5130627,1365665,187655196,159870265
29380806_1414591,CM021103.1,4,29380806,186289531,2465626,1414591,187704122,159919191
29380708_1591552,CM021103.1,4,29380708,186289528,3218023,1591552,187881080,160096149
29380708_1592329,CM021103.1,4,29380708,186289528,3218023,1592329,187881857,160096926
29380708_1592373,CM021103.1,4,29380708,186289528,3218023,1592373,187881901,160096970
29380708_1592390,CM021103.1,4,29380708,186289528,3218023,1592390,187881918,160096987
29380708_1592457,CM021103.1,4,29380708,186289528,3218023,1592457,187881985,160097054
29380708_1592520,CM021103.1,4,29380708,186289528,3218023,1592520,187882048,160097117
29380708_1592539,CM021103.1,4,29380708,186289528,3218023,1592539,187882067,160097136
29380708_1592549,CM021103.1,4,29380708,186289528,3218023,1592549,187882077,160097146
29380708_1592596,CM021103.1,4,29380708,186289528,3218023,1592596,187882124,160097193
29380708_1592786,CM021103.1,4,29380708,186289528,3218023,1592786,187882314,160097383
29380708_1592795,CM021103.1,4,29380708,186289528,3218023,1592795,187882323,160097392
29380708_1597446,CM021103.1,4,29380708,186289528,3218023,1597446,187886974,160102043
29378473_1638255,CM021103.1,4,29378473,186289525,3568172,1638255,187927780,160142849
29377333_1725997,CM021103.1,4,29377333,186289531,2838098,1725997,188015528,160230597
29377333_1726010,CM021103.1,4,29377333,186289531,2838098,1726010,188015541,160230610
29377333_1726050,CM021103.1,4,29377333,186289531,2838098,1726050,188015581,160230650
29378664_1750837,CM021103.1,4,29378664,186289531,5130627,1750837,188040368,160255437
29379567_1776085,CM021103.1,4,29379567,186289527,2348005,1776085,188065612,160280681
29380806_1786912,CM021103.1,4,29380806,186289531,2465626,1786912,188076443,160291512
29380806_1787639,CM021103.1,4,29380806,186289531,2465626,1787639,188077170,160292239
29380806_1787700,CM021103.1,4,29380806,186289531,2465626,1787700,188077231,160292300
29379567_1792146,CM021103.1,4,29379567,186289527,2348005,1792146,188081673,160296742
29379567_1792147,CM021103.1,4,29379567,186289527,2348005,1792147,188081674,160296743
29379567_1792179,CM021103.1,4,29379567,186289527,2348005,1792179,188081706,160296775
29380708_1811822,CM021103.1,4,29380708,186289528,3218023,1811822,188101350,160316419
29380708_1976290,CM021103.1,4,29380708,186289528,3218023,1976290,188265818,160480887
29380708_1976305,CM021103.1,4,29380708,186289528,3218023,1976305,188265833,160480902
29380708_1976309,CM021103.1,4,29380708,186289528,3218023,1976309,188265837,160480906
29380708_1976326,CM021103.1,4,29380708,186289528,3218023,1976326,188265854,160480923
29380708_1976366,CM021103.1,4,29380708,186289528,3218023,1976366,188265894,160480963
29380708_1976383,CM021103.1,4,29380708,186289528,3218023,1976383,188265911,160480980
29380708_1976394,CM021103.1,4,29380708,186289528,3218023,1976394,188265922,160480991
29380708_1976501,CM021103.1,4,29380708,186289528,3218023,1976501,188266029,160481098
29380708_1976532,CM021103.1,4,29380708,186289528,3218023,1976532,188266060,160481129
29380708_1976541,CM021103.1,4,29380708,186289528,3218023,1976541,188266069,160481138
29380708_1976555,CM021103.1,4,29380708,186289528,3218023,1976555,188266083,160481152
29380708_1976562,CM021103.1,4,29380708,186289528,3218023,1976562,188266090,160481159
29380806_2014236,CM021103.1,4,29380806,186289531,2465626,2014236,188303767,160518836
29380806_2014238,CM021103.1,4,29380806,186289531,2465626,2014238,188303769,160518838
29380806_2014250,CM021103.1,4,29380806,186289531,2465626,2014250,188303781,160518850
29380806_2014258,CM021103.1,4,29380806,186289531,2465626,2014258,188303789,160518858
29378664_2064722,CM021103.1,4,29378664,186289531,5130627,2064722,188354253,160569322
29378664_2074444,CM021103.1,4,29378664,186289531,5130627,2074444,188363975,160579044
29378664_2098340,CM021103.1,4,29378664,186289531,5130627,2098340,188387871,160602940
29378664_2098361,CM021103.1,4,29378664,186289531,5130627,2098361,188387892,160602961
29378664_2098370,CM021103.1,4,29378664,186289531,5130627,2098370,188387901,160602970
29378664_2098390,CM021103.1,4,29378664,186289531,5130627,2098390,188387921,160602990
29378664_2098450,CM021103.1,4,29378664,186289531,5130627,2098450,188387981,160603050
29378664_2098451,CM021103.1,4,29378664,186289531,5130627,2098451,188387982,160603051
29378664_2098493,CM021103.1,4,29378664,186289531,5130627,2098493,188388024,160603093
29378664_2098517,CM021103.1,4,29378664,186289531,5130627,2098517,188388048,160603117
29380806_2184258,CM021103.1,4,29380806,186289531,2465626,2184258,188473789,160688858
29380806_2188782,CM021103.1,4,29380806,186289531,2465626,2188782,188478313,160693382
29378473_2223530,CM021103.1,4,29378473,186289525,3568172,2223530,188513055,160728124
29378473_2223681,CM021103.1,4,29378473,186289525,3568172,2223681,188513206,160728275
29378473_2228537,CM021103.1,4,29378473,186289525,3568172,2228537,188518062,160733131
29378473_2228703,CM021103.1,4,29378473,186289525,3568172,2228703,188518228,160733297
29378473_2228831,CM021103.1,4,29378473,186289525,3568172,2228831,188518356,160733425
29378473_2228840,CM021103.1,4,29378473,186289525,3568172,2228840,188518365,160733434
29378473_2228856,CM021103.1,4,29378473,186289525,3568172,2228856,188518381,160733450
29378473_2228863,CM021103.1,4,29378473,186289525,3568172,2228863,188518388,160733457
29378473_2228870,CM021103.1,4,29378473,186289525,3568172,2228870,188518395,160733464
29380708_2278640,CM021103.1,4,29380708,186289528,3218023,2278640,188568168,160783237
29380708_2491400,CM021103.1,4,29380708,186289528,3218023,2491400,188780928,160995997
29380708_2491460,CM021103.1,4,29380708,186289528,3218023,2491460,188780988,160996057
29380708_2491517,CM021103.1,4,29380708,186289528,3218023,2491517,188781045,160996114
29380708_2517102,CM021103.1,4,29380708,186289528,3218023,2517102,188806630,161021699
29380708_2517108,CM021103.1,4,29380708,186289528,3218023,2517108,188806636,161021705
29380708_2517182,CM021103.1,4,29380708,186289528,3218023,2517182,188806710,161021779
29377559_2735315,CM021103.1,4,29377559,186289531,5335367,2735315,189024846,161239915
29377559_2735435,CM021103.1,4,29377559,186289531,5335367,2735435,189024966,161240035
29377559_2742523,CM021103.1,4,29377559,186289531,5335367,2742523,189032054,161247123
29380708_2813186,CM021103.1,4,29380708,186289528,3218023,2813186,189102714,161317783
29380708_2813217,CM021103.1,4,29380708,186289528,3218023,2813217,189102745,161317814
29380708_2846253,CM021103.1,4,29380708,186289528,3218023,2846253,189135781,161350850
29378664_2926094,CM021103.1,4,29378664,186289531,5130627,2926094,189215625,161430694
29378664_2933052,CM021103.1,4,29378664,186289531,5130627,2933052,189222583,161437652
29377559_3151395,CM021103.1,4,29377559,186289531,5335367,3151395,189440926,161655995
29377559_3151474,CM021103.1,4,29377559,186289531,5335367,3151474,189441005,161656074
29378664_3516144,CM021103.1,4,29378664,186289531,5130627,3516144,189805675,162020744
29378664_3516164,CM021103.1,4,29378664,186289531,5130627,3516164,189805695,162020764
29378664_3516188,CM021103.1,4,29378664,186289531,5130627,3516188,189805719,162020788
29378664_3545998,CM021103.1,4,29378664,186289531,5130627,3545998,189835529,162050598
29378664_3546007,CM021103.1,4,29378664,186289531,5130627,3546007,189835538,162050607
29378664_3546079,CM021103.1,4,29378664,186289531,5130627,3546079,189835610,162050679
29378664_3546191,CM021103.1,4,29378664,186289531,5130627,3546191,189835722,162050791
29377559_3630312,CM021103.1,4,29377559,186289531,5335367,3630312,189919843,162134912
29377559_3924351,CM021103.1,4,29377559,186289531,5335367,3924351,190213882,162428951
29377559_3924400,CM021103.1,4,29377559,186289531,5335367,3924400,190213931,162429000
29377559_3924464,CM021103.1,4,29377559,186289531,5335367,3924464,190213995,162429064
29377559_3925353,CM021103.1,4,29377559,186289531,5335367,3925353,190214884,162429953
29381479_8191,CM021103.1,4,29381479,203548982,1988688,8191,203557173,175772242
29381479_8223,CM021103.1,4,29381479,203548982,1988688,8223,203557205,175772274
29381479_8242,CM021103.1,4,29381479,203548982,1988688,8242,203557224,175772293
29381479_8249,CM021103.1,4,29381479,203548982,1988688,8249,203557231,175772300
29381479_8272,CM021103.1,4,29381479,203548982,1988688,8272,203557254,175772323
29381479_8310,CM021103.1,4,29381479,203548982,1988688,8310,203557292,175772361
29376983_11516,CM021103.1,4,29376983,203548981,2708013,11516,203560497,175775566
29376983_11530,CM021103.1,4,29376983,203548981,2708013,11530,203560511,175775580
29376983_11667,CM021103.1,4,29376983,203548981,2708013,11667,203560648,175775717
29376983_11678,CM021103.1,4,29376983,203548981,2708013,11678,203560659,175775728
29376983_11732,CM021103.1,4,29376983,203548981,2708013,11732,203560713,175775782
29381479_36459,CM021103.1,4,29381479,203548982,1988688,36459,203585441,175800510
29381479_37853,CM021103.1,4,29381479,203548982,1988688,37853,203586835,175801904
29381479_37897,CM021103.1,4,29381479,203548982,1988688,37897,203586879,175801948
29377000_39543,CM021103.1,4,29377000,203548985,1314729,39543,203588528,175803597
29377000_39956,CM021103.1,4,29377000,203548985,1314729,39956,203588941,175804010
29377000_39969,CM021103.1,4,29377000,203548985,1314729,39969,203588954,175804023
29377000_40016,CM021103.1,4,29377000,203548985,1314729,40016,203589001,175804070
29381479_57929,CM021103.1,4,29381479,203548982,1988688,57929,203606911,175821980
29381479_57997,CM021103.1,4,29381479,203548982,1988688,57997,203606979,175822048
29381479_58024,CM021103.1,4,29381479,203548982,1988688,58024,203607006,175822075
29360225_75472,CM021103.1,4,29360225,203550989,365678,75472,203626461,175841530
29360225_75515,CM021103.1,4,29360225,203550989,365678,75515,203626504,175841573
29360225_75524,CM021103.1,4,29360225,203550989,365678,75524,203626513,175841582
29360225_75525,CM021103.1,4,29360225,203550989,365678,75525,203626514,175841583
29360225_75526,CM021103.1,4,29360225,203550989,365678,75526,203626515,175841584
29360225_75537,CM021103.1,4,29360225,203550989,365678,75537,203626526,175841595
29360225_75541,CM021103.1,4,29360225,203550989,365678,75541,203626530,175841599
29360225_75565,CM021103.1,4,29360225,203550989,365678,75565,203626554,175841623
29360225_75616,CM021103.1,4,29360225,203550989,365678,75616,203626605,175841674
29360225_75619,CM021103.1,4,29360225,203550989,365678,75619,203626608,175841677
29360225_75630,CM021103.1,4,29360225,203550989,365678,75630,203626619,175841688
29360225_75641,CM021103.1,4,29360225,203550989,365678,75641,203626630,175841699
29377000_96517,CM021103.1,4,29377000,203548985,1314729,96517,203645502,175860571
29377000_96561,CM021103.1,4,29377000,203548985,1314729,96561,203645546,175860615
29377000_96647,CM021103.1,4,29377000,203548985,1314729,96647,203645632,175860701
29378127_111666,CM021103.1,4,29378127,203548977,719121,111666,203660643,175875712
29377079_189646,CM021103.1,4,29377079,203548983,4377754,189646,203738629,175953698
29378568_190048,CM021103.1,4,29378568,203548985,3084595,190048,203739033,175954102
29377439_191341,CM021103.1,4,29377439,203548982,2188283,191341,203740323,175955392
29377439_191342,CM021103.1,4,29377439,203548982,2188283,191342,203740324,175955393
29377439_191357,CM021103.1,4,29377439,203548982,2188283,191357,203740339,175955408
29377000_297322,CM021103.1,4,29377000,203548985,1314729,297322,203846307,176061376
29376983_348379,CM021103.1,4,29376983,203548981,2708013,348379,203897360,176112429
29360225_355000,CM021103.1,4,29360225,203550989,365678,355000,203905989,176121058
29360225_355086,CM021103.1,4,29360225,203550989,365678,355086,203906075,176121144
29378568_398652,CM021103.1,4,29378568,203548985,3084595,398652,203947637,176162706
29379521_484166,CM021103.1,4,29379521,203549428,2293670,484166,204033594,176248663
29377439_496540,CM021103.1,4,29377439,203548982,2188283,496540,204045522,176260591
29377439_496804,CM021103.1,4,29377439,203548982,2188283,496804,204045786,176260855
29378178_501701,CM021103.1,4,29378178,203549693,2547887,501701,204051394,176266463
29377006_639550,CM021103.1,4,29377006,203548982,3866001,639550,204188532,176403601
29377006_639555,CM021103.1,4,29377006,203548982,3866001,639555,204188537,176403606
29377006_639580,CM021103.1,4,29377006,203548982,3866001,639580,204188562,176403631
29377006_639591,CM021103.1,4,29377006,203548982,3866001,639591,204188573,176403642
29377006_639648,CM021103.1,4,29377006,203548982,3866001,639648,204188630,176403699
29377006_639655,CM021103.1,4,29377006,203548982,3866001,639655,204188637,176403706
29377006_639661,CM021103.1,4,29377006,203548982,3866001,639661,204188643,176403712
29377006_639706,CM021103.1,4,29377006,203548982,3866001,639706,204188688,176403757
29377006_639724,CM021103.1,4,29377006,203548982,3866001,639724,204188706,176403775
29379836_669710,CM021103.1,4,29379836,203548982,1927163,669710,204218692,176433761
29379836_669866,CM021103.1,4,29379836,203548982,1927163,669866,204218848,176433917
29379836_669908,CM021103.1,4,29379836,203548982,1927163,669908,204218890,176433959
29379980_688042,CM021103.1,4,29379980,203548985,3940575,688042,204237027,176452096
29379980_688103,CM021103.1,4,29379980,203548985,3940575,688103,204237088,176452157
29377000_751259,CM021103.1,4,29377000,203548985,1314729,751259,204300244,176515313
29377439_801492,CM021103.1,4,29377439,203548982,2188283,801492,204350474,176565543
29377439_801513,CM021103.1,4,29377439,203548982,2188283,801513,204350495,176565564
29377439_801540,CM021103.1,4,29377439,203548982,2188283,801540,204350522,176565591
29377439_801560,CM021103.1,4,29377439,203548982,2188283,801560,204350542,176565611
29377439_801564,CM021103.1,4,29377439,203548982,2188283,801564,204350546,176565615
29377439_801587,CM021103.1,4,29377439,203548982,2188283,801587,204350569,176565638
29377439_801596,CM021103.1,4,29377439,203548982,2188283,801596,204350578,176565647
29377439_811762,CM021103.1,4,29377439,203548982,2188283,811762,204360744,176575813
29377439_825863,CM021103.1,4,29377439,203548982,2188283,825863,204374845,176589914
29377439_825936,CM021103.1,4,29377439,203548982,2188283,825936,204374918,176589987
29377439_825978,CM021103.1,4,29377439,203548982,2188283,825978,204374960,176590029
29377439_826008,CM021103.1,4,29377439,203548982,2188283,826008,204374990,176590059
29377439_826029,CM021103.1,4,29377439,203548982,2188283,826029,204375011,176590080
29377439_826076,CM021103.1,4,29377439,203548982,2188283,826076,204375058,176590127
29378568_840712,CM021103.1,4,29378568,203548985,3084595,840712,204389697,176604766
29378568_840713,CM021103.1,4,29378568,203548985,3084595,840713,204389698,176604767
29377439_968964,CM021103.1,4,29377439,203548982,2188283,968964,204517946,176733015
29377439_969027,CM021103.1,4,29377439,203548982,2188283,969027,204518009,176733078
29376983_1053143,CM021103.1,4,29376983,203548981,2708013,1053143,204602124,176817193
29376983_1053256,CM021103.1,4,29376983,203548981,2708013,1053256,204602237,176817306
29376983_1053390,CM021103.1,4,29376983,203548981,2708013,1053390,204602371,176817440
29377079_1076283,CM021103.1,4,29377079,203548983,4377754,1076283,204625266,176840335
29377439_1137161,CM021103.1,4,29377439,203548982,2188283,1137161,204686143,176901212
29377439_1137197,CM021103.1,4,29377439,203548982,2188283,1137197,204686179,176901248
29377439_1137224,CM021103.1,4,29377439,203548982,2188283,1137224,204686206,176901275
29377439_1137244,CM021103.1,4,29377439,203548982,2188283,1137244,204686226,176901295
29377439_1137308,CM021103.1,4,29377439,203548982,2188283,1137308,204686290,176901359
29377439_1137351,CM021103.1,4,29377439,203548982,2188283,1137351,204686333,176901402
29377439_1137488,CM021103.1,4,29377439,203548982,2188283,1137488,204686470,176901539
29377439_1137509,CM021103.1,4,29377439,203548982,2188283,1137509,204686491,176901560
29377439_1137608,CM021103.1,4,29377439,203548982,2188283,1137608,204686590,176901659
29378568_1829067,CM021103.1,4,29378568,203548985,3084595,1829067,205378052,177593121
29380247_1891898,CM021103.1,4,29380247,203549220,6653938,1891898,205441118,177656187
29380247_1891961,CM021103.1,4,29380247,203549220,6653938,1891961,205441181,177656250
29380247_1892026,CM021103.1,4,29380247,203549220,6653938,1892026,205441246,177656315
29380247_1894154,CM021103.1,4,29380247,203549220,6653938,1894154,205443374,177658443
29380247_1894197,CM021103.1,4,29380247,203549220,6653938,1894197,205443417,177658486
29380247_1894277,CM021103.1,4,29380247,203549220,6653938,1894277,205443497,177658566
29380247_1894331,CM021103.1,4,29380247,203549220,6653938,1894331,205443551,177658620
29380247_1894358,CM021103.1,4,29380247,203549220,6653938,1894358,205443578,177658647
29380247_1894364,CM021103.1,4,29380247,203549220,6653938,1894364,205443584,177658653
29380247_1896435,CM021103.1,4,29380247,203549220,6653938,1896435,205445655,177660724
29380247_1896444,CM021103.1,4,29380247,203549220,6653938,1896444,205445664,177660733
29380247_1896523,CM021103.1,4,29380247,203549220,6653938,1896523,205445743,177660812
29380247_1896564,CM021103.1,4,29380247,203549220,6653938,1896564,205445784,177660853
29380247_1896602,CM021103.1,4,29380247,203549220,6653938,1896602,205445822,177660891
29380247_1896607,CM021103.1,4,29380247,203549220,6653938,1896607,205445827,177660896
29380247_1896608,CM021103.1,4,29380247,203549220,6653938,1896608,205445828,177660897
29380247_1896666,CM021103.1,4,29380247,203549220,6653938,1896666,205445886,177660955
29380247_2285894,CM021103.1,4,29380247,203549220,6653938,2285894,205835114,178050183
29380247_2285925,CM021103.1,4,29380247,203549220,6653938,2285925,205835145,178050214
29380247_2285934,CM021103.1,4,29380247,203549220,6653938,2285934,205835154,178050223
29380247_2285949,CM021103.1,4,29380247,203549220,6653938,2285949,205835169,178050238
29380247_2285950,CM021103.1,4,29380247,203549220,6653938,2285950,205835170,178050239
29380247_2286435,CM021103.1,4,29380247,203549220,6653938,2286435,205835655,178050724
29380247_2288666,CM021103.1,4,29380247,203549220,6653938,2288666,205837886,178052955
29380247_2288709,CM021103.1,4,29380247,203549220,6653938,2288709,205837929,178052998
29380247_2288732,CM021103.1,4,29380247,203549220,6653938,2288732,205837952,178053021
29380247_2306598,CM021103.1,4,29380247,203549220,6653938,2306598,205855818,178070887
29380247_2306637,CM021103.1,4,29380247,203549220,6653938,2306637,205855857,178070926
29380247_2306680,CM021103.1,4,29380247,203549220,6653938,2306680,205855900,178070969
29380247_2306701,CM021103.1,4,29380247,203549220,6653938,2306701,205855921,178070990
29380247_2306705,CM021103.1,4,29380247,203549220,6653938,2306705,205855925,178070994
29380247_2306720,CM021103.1,4,29380247,203549220,6653938,2306720,205855940,178071009
29380247_2306774,CM021103.1,4,29380247,203549220,6653938,2306774,205855994,178071063
29380247_2306786,CM021103.1,4,29380247,203549220,6653938,2306786,205856006,178071075
29380247_2691718,CM021103.1,4,29380247,203549220,6653938,2691718,206240938,178456007
29379980_3552789,CM021103.1,4,29379980,203548985,3940575,3552789,207101774,179316843
29379980_3552815,CM021103.1,4,29379980,203548985,3940575,3552815,207101800,179316869
29379980_3552876,CM021103.1,4,29379980,203548985,3940575,3552876,207101861,179316930
29379980_3552884,CM021103.1,4,29379980,203548985,3940575,3552884,207101869,179316938
29379980_3552919,CM021103.1,4,29379980,203548985,3940575,3552919,207101904,179316973
29377079_4019899,CM021103.1,4,29377079,203548983,4377754,4019899,207568882,179783951
29377079_4019913,CM021103.1,4,29377079,203548983,4377754,4019913,207568896,179783965
29380247_4801547,CM021103.1,4,29380247,203549220,6653938,4801547,208350767,180565836
29380247_5417864,CM021103.1,4,29380247,203549220,6653938,5417864,208967084,181182153
29380247_5947388,CM021103.1,4,29380247,203549220,6653938,5947388,209496608,181711677
29380247_6212542,CM021103.1,4,29380247,203549220,6653938,6212542,209761762,181976831
29380247_6212547,CM021103.1,4,29380247,203549220,6653938,6212547,209761767,181976836
29380247_6237201,CM021103.1,4,29380247,203549220,6653938,6237201,209786421,182001490
29380247_6251683,CM021103.1,4,29380247,203549220,6653938,6251683,209800903,182015972
29380247_6251684,CM021103.1,4,29380247,203549220,6653938,6251684,209800904,182015973
29380247_6554617,CM021103.1,4,29380247,203549220,6653938,6554617,210103837,182318906
29380247_6554622,CM021103.1,4,29380247,203549220,6653938,6554622,210103842,182318911
29380247_6554738,CM021103.1,4,29380247,203549220,6653938,6554738,210103958,182319027
29380247_6554745,CM021103.1,4,29380247,203549220,6653938,6554745,210103965,182319034
29362679_44998,CM021103.1,4,29362679,219636088,97551,44998,219681086,191896155
29343692_2468,CM021103.1,4,29343692,226222390,29874,2468,226224858,198439927
29377881_5806,CM021103.1,4,29377881,226221056,1098614,5806,226226862,198441931
29377881_5836,CM021103.1,4,29377881,226221056,1098614,5836,226226892,198441961
29377881_5885,CM021103.1,4,29377881,226221056,1098614,5885,226226941,198442010
29377881_5953,CM021103.1,4,29377881,226221056,1098614,5953,226227009,198442078
29343692_12502,CM021103.1,4,29343692,226222390,29874,12502,226234892,198449961
29377881_38840,CM021103.1,4,29377881,226221056,1098614,38840,226259896,198474965
29381701_80054,CM021103.1,4,29381701,226219909,4072849,80054,226299963,198515032
29379551_120287,CM021103.1,4,29379551,226219331,6303894,120287,226339618,198554687
29379551_120739,CM021103.1,4,29379551,226219331,6303894,120739,226340070,198555139
29377555_142123,CM021103.1,4,29377555,226220358,3530639,142123,226362481,198577550
29377555_142133,CM021103.1,4,29377555,226220358,3530639,142133,226362491,198577560
29380755_178933,CM021103.1,4,29380755,226221807,948889,178933,226400740,198615809
29380755_194348,CM021103.1,4,29380755,226221807,948889,194348,226416155,198631224
29380755_194379,CM021103.1,4,29380755,226221807,948889,194379,226416186,198631255
29380755_194384,CM021103.1,4,29380755,226221807,948889,194384,226416191,198631260
29380755_194427,CM021103.1,4,29380755,226221807,948889,194427,226416234,198631303
29379551_244845,CM021103.1,4,29379551,226219331,6303894,244845,226464176,198679245
29379551_244937,CM021103.1,4,29379551,226219331,6303894,244937,226464268,198679337
29380826_356039,CM021103.1,4,29380826,226220664,3204529,356039,226576703,198791772
29380826_356095,CM021103.1,4,29380826,226220664,3204529,356095,226576759,198791828
29380826_356500,CM021103.1,4,29380826,226220664,3204529,356500,226577164,198792233
29380826_356563,CM021103.1,4,29380826,226220664,3204529,356563,226577227,198792296
29380826_356907,CM021103.1,4,29380826,226220664,3204529,356907,226577571,198792640
29380826_358130,CM021103.1,4,29380826,226220664,3204529,358130,226578794,198793863
29377881_359980,CM021103.1,4,29377881,226221056,1098614,359980,226581036,198796105
29377881_359995,CM021103.1,4,29377881,226221056,1098614,359995,226581051,198796120
29377881_360053,CM021103.1,4,29377881,226221056,1098614,360053,226581109,198796178
29381750_397883,CM021103.1,4,29381750,226220190,5266534,397883,226618073,198833142
29381750_397886,CM021103.1,4,29381750,226220190,5266534,397886,226618076,198833145
29381750_397928,CM021103.1,4,29381750,226220190,5266534,397928,226618118,198833187
29378727_478158,CM021103.1,4,29378727,226220096,2414552,478158,226698254,198913323
29378727_507147,CM021103.1,4,29378727,226220096,2414552,507147,226727243,198942312
29381632_523611,CM021103.1,4,29381632,226220456,2482633,523611,226744067,198959136
29378727_540766,CM021103.1,4,29378727,226220096,2414552,540766,226760862,198975931
29378727_540787,CM021103.1,4,29378727,226220096,2414552,540787,226760883,198975952
29378727_540870,CM021103.1,4,29378727,226220096,2414552,540870,226760966,198976035
29378727_556519,CM021103.1,4,29378727,226220096,2414552,556519,226776615,198991684
29381293_575861,CM021103.1,4,29381293,226220869,579493,575861,226796730,199011799
29381293_577610,CM021103.1,4,29381293,226220869,579493,577610,226798479,199013548
29381293_577631,CM021103.1,4,29381293,226220869,579493,577631,226798500,199013569
29377881_640437,CM021103.1,4,29377881,226221056,1098614,640437,226861493,199076562
29377881_694497,CM021103.1,4,29377881,226221056,1098614,694497,226915553,199130622
29377881_694752,CM021103.1,4,29377881,226221056,1098614,694752,226915808,199130877
29380060_722685,CM021103.1,4,29380060,226219626,1795051,722685,226942311,199157380
29380060_722727,CM021103.1,4,29380060,226219626,1795051,722727,226942353,199157422
29380060_723669,CM021103.1,4,29380060,226219626,1795051,723669,226943295,199158364
29380060_723725,CM021103.1,4,29380060,226219626,1795051,723725,226943351,199158420
29380755_781450,CM021103.1,4,29380755,226221807,948889,781450,227003257,199218326
29380755_781463,CM021103.1,4,29380755,226221807,948889,781463,227003270,199218339
29382354_870217,CM021103.1,4,29382354,226220175,3644617,870217,227090392,199305461
29382354_870249,CM021103.1,4,29382354,226220175,3644617,870249,227090424,199305493
29377881_886203,CM021103.1,4,29377881,226221056,1098614,886203,227107259,199322328
29382354_994211,CM021103.1,4,29382354,226220175,3644617,994211,227214386,199429455
29379551_1074956,CM021103.1,4,29379551,226219331,6303894,1074956,227294287,199509356
29379551_1084083,CM021103.1,4,29379551,226219331,6303894,1084083,227303414,199518483
29379551_1086855,CM021103.1,4,29379551,226219331,6303894,1086855,227306186,199521255
29381632_1195632,CM021103.1,4,29381632,226220456,2482633,1195632,227416088,199631157
29381632_1203461,CM021103.1,4,29381632,226220456,2482633,1203461,227423917,199638986
29381632_1220350,CM021103.1,4,29381632,226220456,2482633,1220350,227440806,199655875
29381632_1220409,CM021103.1,4,29381632,226220456,2482633,1220409,227440865,199655934
29381632_1365337,CM021103.1,4,29381632,226220456,2482633,1365337,227585793,199800862
29381632_1365345,CM021103.1,4,29381632,226220456,2482633,1365345,227585801,199800870
29381701_1432285,CM021103.1,4,29381701,226219909,4072849,1432285,227652194,199867263
29381701_1432340,CM021103.1,4,29381701,226219909,4072849,1432340,227652249,199867318
29381701_1432383,CM021103.1,4,29381701,226219909,4072849,1432383,227652292,199867361
29381701_1432385,CM021103.1,4,29381701,226219909,4072849,1432385,227652294,199867363
29381701_1449335,CM021103.1,4,29381701,226219909,4072849,1449335,227669244,199884313
29381701_1516373,CM021103.1,4,29381701,226219909,4072849,1516373,227736282,199951351
29381701_1516393,CM021103.1,4,29381701,226219909,4072849,1516393,227736302,199951371
29381701_1516448,CM021103.1,4,29381701,226219909,4072849,1516448,227736357,199951426
29381701_1516508,CM021103.1,4,29381701,226219909,4072849,1516508,227736417,199951486
29381701_1517120,CM021103.1,4,29381701,226219909,4072849,1517120,227737029,199952098
29381632_1524228,CM021103.1,4,29381632,226220456,2482633,1524228,227744684,199959753
29380060_1526143,CM021103.1,4,29380060,226219626,1795051,1526143,227745769,199960838
29380060_1526144,CM021103.1,4,29380060,226219626,1795051,1526144,227745770,199960839
29380060_1526154,CM021103.1,4,29380060,226219626,1795051,1526154,227745780,199960849
29380060_1526202,CM021103.1,4,29380060,226219626,1795051,1526202,227745828,199960897
29380060_1526226,CM021103.1,4,29380060,226219626,1795051,1526226,227745852,199960921
29380060_1526274,CM021103.1,4,29380060,226219626,1795051,1526274,227745900,199960969
29381701_1551894,CM021103.1,4,29381701,226219909,4072849,1551894,227771803,199986872
29381701_1551940,CM021103.1,4,29381701,226219909,4072849,1551940,227771849,199986918
29379551_1564044,CM021103.1,4,29379551,226219331,6303894,1564044,227783375,199998444
29379551_1564077,CM021103.1,4,29379551,226219331,6303894,1564077,227783408,199998477
29382354_1752893,CM021103.1,4,29382354,226220175,3644617,1752893,227973068,200188137
29382354_1839191,CM021103.1,4,29382354,226220175,3644617,1839191,228059366,200274435
29382354_1839372,CM021103.1,4,29382354,226220175,3644617,1839372,228059547,200274616
29381701_1932290,CM021103.1,4,29381701,226219909,4072849,1932290,228152199,200367268
29381750_1943358,CM021103.1,4,29381750,226220190,5266534,1943358,228163548,200378617
29381750_1943416,CM021103.1,4,29381750,226220190,5266534,1943416,228163606,200378675
29381750_1943418,CM021103.1,4,29381750,226220190,5266534,1943418,228163608,200378677
29381750_1943428,CM021103.1,4,29381750,226220190,5266534,1943428,228163618,200378687
29381750_1943446,CM021103.1,4,29381750,226220190,5266534,1943446,228163636,200378705
29381750_1943456,CM021103.1,4,29381750,226220190,5266534,1943456,228163646,200378715
29381750_1943457,CM021103.1,4,29381750,226220190,5266534,1943457,228163647,200378716
29381519_1956817,CM021103.1,4,29381519,226220249,2521102,1956817,228177066,200392135
29381519_1956842,CM021103.1,4,29381519,226220249,2521102,1956842,228177091,200392160
29381519_1956875,CM021103.1,4,29381519,226220249,2521102,1956875,228177124,200392193
29379551_2066966,CM021103.1,4,29379551,226219331,6303894,2066966,228286297,200501366
29379551_2067056,CM021103.1,4,29379551,226219331,6303894,2067056,228286387,200501456
29381632_2070549,CM021103.1,4,29381632,226220456,2482633,2070549,228291005,200506074
29381632_2070710,CM021103.1,4,29381632,226220456,2482633,2070710,228291166,200506235
29381632_2070735,CM021103.1,4,29381632,226220456,2482633,2070735,228291191,200506260
29381701_2163075,CM021103.1,4,29381701,226219909,4072849,2163075,228382984,200598053
29381750_2168045,CM021103.1,4,29381750,226220190,5266534,2168045,228388235,200603304
29381750_2168109,CM021103.1,4,29381750,226220190,5266534,2168109,228388299,200603368
29381750_2168143,CM021103.1,4,29381750,226220190,5266534,2168143,228388333,200603402
29381701_2192894,CM021103.1,4,29381701,226219909,4072849,2192894,228412803,200627872
29381701_2192972,CM021103.1,4,29381701,226219909,4072849,2192972,228412881,200627950
29381750_2221996,CM021103.1,4,29381750,226220190,5266534,2221996,228442186,200657255
29381750_2222075,CM021103.1,4,29381750,226220190,5266534,2222075,228442265,200657334
29381750_2222126,CM021103.1,4,29381750,226220190,5266534,2222126,228442316,200657385
29381750_2222127,CM021103.1,4,29381750,226220190,5266534,2222127,228442317,200657386
29382313_2249492,CM021103.1,4,29382313,226220177,5938285,2249492,228469669,200684738
29381519_2359850,CM021103.1,4,29381519,226220249,2521102,2359850,228580099,200795168
29381701_2370568,CM021103.1,4,29381701,226219909,4072849,2370568,228590477,200805546
29381701_2372496,CM021103.1,4,29381701,226219909,4072849,2372496,228592405,200807474
29381519_2381211,CM021103.1,4,29381519,226220249,2521102,2381211,228601460,200816529
29381750_2434654,CM021103.1,4,29381750,226220190,5266534,2434654,228654844,200869913
29381750_2434759,CM021103.1,4,29381750,226220190,5266534,2434759,228654949,200870018
29382354_2478902,CM021103.1,4,29382354,226220175,3644617,2478902,228699077,200914146
29382354_2478918,CM021103.1,4,29382354,226220175,3644617,2478918,228699093,200914162
29382354_2478919,CM021103.1,4,29382354,226220175,3644617,2478919,228699094,200914163
29379551_2727620,CM021103.1,4,29379551,226219331,6303894,2727620,228946951,201162020
29379551_2727681,CM021103.1,4,29379551,226219331,6303894,2727681,228947012,201162081
29381701_3043797,CM021103.1,4,29381701,226219909,4072849,3043797,229263706,201478775
29381701_3043801,CM021103.1,4,29381701,226219909,4072849,3043801,229263710,201478779
29381701_3043802,CM021103.1,4,29381701,226219909,4072849,3043802,229263711,201478780
29381701_3043816,CM021103.1,4,29381701,226219909,4072849,3043816,229263725,201478794
29381701_3043890,CM021103.1,4,29381701,226219909,4072849,3043890,229263799,201478868
29381701_3043895,CM021103.1,4,29381701,226219909,4072849,3043895,229263804,201478873
29381701_3043988,CM021103.1,4,29381701,226219909,4072849,3043988,229263897,201478966
29381701_3044005,CM021103.1,4,29381701,226219909,4072849,3044005,229263914,201478983
29381701_3045140,CM021103.1,4,29381701,226219909,4072849,3045140,229265049,201480118
29381701_3045179,CM021103.1,4,29381701,226219909,4072849,3045179,229265088,201480157
29381701_3071230,CM021103.1,4,29381701,226219909,4072849,3071230,229291139,201506208
29381701_3071299,CM021103.1,4,29381701,226219909,4072849,3071299,229291208,201506277
29382354_3087615,CM021103.1,4,29382354,226220175,3644617,3087615,229307790,201522859
29382354_3087624,CM021103.1,4,29382354,226220175,3644617,3087624,229307799,201522868
29382354_3089942,CM021103.1,4,29382354,226220175,3644617,3089942,229310117,201525186
29382354_3090076,CM021103.1,4,29382354,226220175,3644617,3090076,229310251,201525320
29382354_3090082,CM021103.1,4,29382354,226220175,3644617,3090082,229310257,201525326
29382354_3090090,CM021103.1,4,29382354,226220175,3644617,3090090,229310265,201525334
29382354_3090142,CM021103.1,4,29382354,226220175,3644617,3090142,229310317,201525386
29382354_3090187,CM021103.1,4,29382354,226220175,3644617,3090187,229310362,201525431
29382354_3110522,CM021103.1,4,29382354,226220175,3644617,3110522,229330697,201545766
29382354_3110538,CM021103.1,4,29382354,226220175,3644617,3110538,229330713,201545782
29382354_3110784,CM021103.1,4,29382354,226220175,3644617,3110784,229330959,201546028
29382354_3203783,CM021103.1,4,29382354,226220175,3644617,3203783,229423958,201639027
29382354_3203835,CM021103.1,4,29382354,226220175,3644617,3203835,229424010,201639079
29382354_3203965,CM021103.1,4,29382354,226220175,3644617,3203965,229424140,201639209
29382354_3204020,CM021103.1,4,29382354,226220175,3644617,3204020,229424195,201639264
29382354_3204048,CM021103.1,4,29382354,226220175,3644617,3204048,229424223,201639292
29382354_3204098,CM021103.1,4,29382354,226220175,3644617,3204098,229424273,201639342
29381701_3485657,CM021103.1,4,29381701,226219909,4072849,3485657,229705566,201920635
29381701_3485725,CM021103.1,4,29381701,226219909,4072849,3485725,229705634,201920703
29381701_3485768,CM021103.1,4,29381701,226219909,4072849,3485768,229705677,201920746
29381701_3485782,CM021103.1,4,29381701,226219909,4072849,3485782,229705691,201920760
29381701_3485799,CM021103.1,4,29381701,226219909,4072849,3485799,229705708,201920777
29381701_3485802,CM021103.1,4,29381701,226219909,4072849,3485802,229705711,201920780
29382354_3576880,CM021103.1,4,29382354,226220175,3644617,3576880,229797055,202012124
29382354_3609652,CM021103.1,4,29382354,226220175,3644617,3609652,229829827,202044896
29382354_3643144,CM021103.1,4,29382354,226220175,3644617,3643144,229863319,202078388
29382354_3643191,CM021103.1,4,29382354,226220175,3644617,3643191,229863366,202078435
29382354_3643255,CM021103.1,4,29382354,226220175,3644617,3643255,229863430,202078499
29380181_3689767,CM021103.1,4,29380181,226219905,5139166,3689767,229909672,202124741
29380181_3689769,CM021103.1,4,29380181,226219905,5139166,3689769,229909674,202124743
29380181_3689772,CM021103.1,4,29380181,226219905,5139166,3689772,229909677,202124746
29380181_3689784,CM021103.1,4,29380181,226219905,5139166,3689784,229909689,202124758
29380181_3689826,CM021103.1,4,29380181,226219905,5139166,3689826,229909731,202124800
29380181_3689912,CM021103.1,4,29380181,226219905,5139166,3689912,229909817,202124886
29380181_3689913,CM021103.1,4,29380181,226219905,5139166,3689913,229909818,202124887
29380181_3689931,CM021103.1,4,29380181,226219905,5139166,3689931,229909836,202124905
29381750_3880361,CM021103.1,4,29381750,226220190,5266534,3880361,230100551,202315620
29381750_3880377,CM021103.1,4,29381750,226220190,5266534,3880377,230100567,202315636
29381750_3880378,CM021103.1,4,29381750,226220190,5266534,3880378,230100568,202315637
29381750_3880407,CM021103.1,4,29381750,226220190,5266534,3880407,230100597,202315666
29381750_3880421,CM021103.1,4,29381750,226220190,5266534,3880421,230100611,202315680
29381750_3880424,CM021103.1,4,29381750,226220190,5266534,3880424,230100614,202315683
29381750_3880430,CM021103.1,4,29381750,226220190,5266534,3880430,230100620,202315689
29381750_3880468,CM021103.1,4,29381750,226220190,5266534,3880468,230100658,202315727
29381750_3880471,CM021103.1,4,29381750,226220190,5266534,3880471,230100661,202315730
29381701_3996230,CM021103.1,4,29381701,226219909,4072849,3996230,230216139,202431208
29381701_3996296,CM021103.1,4,29381701,226219909,4072849,3996296,230216205,202431274
29381701_3996354,CM021103.1,4,29381701,226219909,4072849,3996354,230216263,202431332
29381701_3996364,CM021103.1,4,29381701,226219909,4072849,3996364,230216273,202431342
29381701_3996394,CM021103.1,4,29381701,226219909,4072849,3996394,230216303,202431372
29381701_3996415,CM021103.1,4,29381701,226219909,4072849,3996415,230216324,202431393
29381701_3996430,CM021103.1,4,29381701,226219909,4072849,3996430,230216339,202431408
29381701_3996432,CM021103.1,4,29381701,226219909,4072849,3996432,230216341,202431410
29381701_4045381,CM021103.1,4,29381701,226219909,4072849,4045381,230265290,202480359
29381701_4045386,CM021103.1,4,29381701,226219909,4072849,4045386,230265295,202480364
29379551_4242466,CM021103.1,4,29379551,226219331,6303894,4242466,230461797,202676866
29381750_4272761,CM021103.1,4,29381750,226220190,5266534,4272761,230492951,202708020
29381750_4272833,CM021103.1,4,29381750,226220190,5266534,4272833,230493023,202708092
29381750_4273057,CM021103.1,4,29381750,226220190,5266534,4273057,230493247,202708316
29381750_4273154,CM021103.1,4,29381750,226220190,5266534,4273154,230493344,202708413
29381750_4273647,CM021103.1,4,29381750,226220190,5266534,4273647,230493837,202708906
29381750_4340238,CM021103.1,4,29381750,226220190,5266534,4340238,230560428,202775497
29381750_4340241,CM021103.1,4,29381750,226220190,5266534,4340241,230560431,202775500
29381750_4340269,CM021103.1,4,29381750,226220190,5266534,4340269,230560459,202775528
29381750_4340313,CM021103.1,4,29381750,226220190,5266534,4340313,230560503,202775572
29381750_4340348,CM021103.1,4,29381750,226220190,5266534,4340348,230560538,202775607
29379551_4586285,CM021103.1,4,29379551,226219331,6303894,4586285,230805616,203020685
29379551_4590032,CM021103.1,4,29379551,226219331,6303894,4590032,230809363,203024432
29380181_4917157,CM021103.1,4,29380181,226219905,5139166,4917157,231137062,203352131
29380181_4917160,CM021103.1,4,29380181,226219905,5139166,4917160,231137065,203352134
29379551_5432940,CM021103.1,4,29379551,226219331,6303894,5432940,231652271,203867340
29379551_5432965,CM021103.1,4,29379551,226219331,6303894,5432965,231652296,203867365
29379551_5472920,CM021103.1,4,29379551,226219331,6303894,5472920,231692251,203907320
29379551_5473315,CM021103.1,4,29379551,226219331,6303894,5473315,231692646,203907715
29379551_5474051,CM021103.1,4,29379551,226219331,6303894,5474051,231693382,203908451
29379551_5606507,CM021103.1,4,29379551,226219331,6303894,5606507,231825838,204040907
29379551_5606710,CM021103.1,4,29379551,226219331,6303894,5606710,231826041,204041110
29379551_5611908,CM021103.1,4,29379551,226219331,6303894,5611908,231831239,204046308
29379551_5612987,CM021103.1,4,29379551,226219331,6303894,5612987,231832318,204047387
29379551_5612990,CM021103.1,4,29379551,226219331,6303894,5612990,231832321,204047390
29379551_5613174,CM021103.1,4,29379551,226219331,6303894,5613174,231832505,204047574
29379551_5874412,CM021103.1,4,29379551,226219331,6303894,5874412,232093743,204308812
29379551_5929526,CM021103.1,4,29379551,226219331,6303894,5929526,232148857,204363926
29379551_5949329,CM021103.1,4,29379551,226219331,6303894,5949329,232168660,204383729
29379551_5949517,CM021103.1,4,29379551,226219331,6303894,5949517,232168848,204383917
29379551_5949601,CM021103.1,4,29379551,226219331,6303894,5949601,232168932,204384001
29379551_6140251,CM021103.1,4,29379551,226219331,6303894,6140251,232359582,204574651
29379551_6140272,CM021103.1,4,29379551,226219331,6303894,6140272,232359603,204574672
29379551_6140307,CM021103.1,4,29379551,226219331,6303894,6140307,232359638,204574707
29379551_6140324,CM021103.1,4,29379551,226219331,6303894,6140324,232359655,204574724
29379551_6155004,CM021103.1,4,29379551,226219331,6303894,6155004,232374335,204589404
29379551_6155005,CM021103.1,4,29379551,226219331,6303894,6155005,232374336,204589405
29379551_6155156,CM021103.1,4,29379551,226219331,6303894,6155156,232374487,204589556
29377239_60228,CM021103.1,4,29377239,235036092,2543891,60228,235096320,207311389
29377239_60318,CM021103.1,4,29377239,235036092,2543891,60318,235096410,207311479
29377239_60329,CM021103.1,4,29377239,235036092,2543891,60329,235096421,207311490
29377239_60703,CM021103.1,4,29377239,235036092,2543891,60703,235096795,207311864
29377239_60743,CM021103.1,4,29377239,235036092,2543891,60743,235096835,207311904
29377239_60756,CM021103.1,4,29377239,235036092,2543891,60756,235096848,207311917
29377239_159621,CM021103.1,4,29377239,235036092,2543891,159621,235195713,207410782
29377239_159678,CM021103.1,4,29377239,235036092,2543891,159678,235195770,207410839
29377239_160465,CM021103.1,4,29377239,235036092,2543891,160465,235196557,207411626
29377239_160546,CM021103.1,4,29377239,235036092,2543891,160546,235196638,207411707
29377239_648996,CM021103.1,4,29377239,235036092,2543891,648996,235685088,207900157
29377239_649004,CM021103.1,4,29377239,235036092,2543891,649004,235685096,207900165
29377239_649065,CM021103.1,4,29377239,235036092,2543891,649065,235685157,207900226
29377239_649085,CM021103.1,4,29377239,235036092,2543891,649085,235685177,207900246
29377239_649130,CM021103.1,4,29377239,235036092,2543891,649130,235685222,207900291
29377239_649558,CM021103.1,4,29377239,235036092,2543891,649558,235685650,207900719
29377239_649644,CM021103.1,4,29377239,235036092,2543891,649644,235685736,207900805
29378212_2100537,CM021103.1,4,29378212,235035551,8495815,2100537,237136088,209351157
29378212_2100568,CM021103.1,4,29378212,235035551,8495815,2100568,237136119,209351188
29378212_2107045,CM021103.1,4,29378212,235035551,8495815,2107045,237142596,209357665
29378212_2150175,CM021103.1,4,29378212,235035551,8495815,2150175,237185726,209400795
29378212_2954649,CM021103.1,4,29378212,235035551,8495815,2954649,237990200,210205269
29378212_2954663,CM021103.1,4,29378212,235035551,8495815,2954663,237990214,210205283
29378212_2954713,CM021103.1,4,29378212,235035551,8495815,2954713,237990264,210205333
29378212_2954759,CM021103.1,4,29378212,235035551,8495815,2954759,237990310,210205379
29378212_2954769,CM021103.1,4,29378212,235035551,8495815,2954769,237990320,210205389
29378212_2954788,CM021103.1,4,29378212,235035551,8495815,2954788,237990339,210205408
29378212_3244314,CM021103.1,4,29378212,235035551,8495815,3244314,238279865,210494934
29378212_3244339,CM021103.1,4,29378212,235035551,8495815,3244339,238279890,210494959
29378212_3244408,CM021103.1,4,29378212,235035551,8495815,3244408,238279959,210495028
29378212_3244465,CM021103.1,4,29378212,235035551,8495815,3244465,238280016,210495085
29378212_3256287,CM021103.1,4,29378212,235035551,8495815,3256287,238291838,210506907
29378212_3524941,CM021103.1,4,29378212,235035551,8495815,3524941,238560492,210775561
29378212_3525005,CM021103.1,4,29378212,235035551,8495815,3525005,238560556,210775625
29378212_3525036,CM021103.1,4,29378212,235035551,8495815,3525036,238560587,210775656
29378212_3525092,CM021103.1,4,29378212,235035551,8495815,3525092,238560643,210775712
29378212_3526148,CM021103.1,4,29378212,235035551,8495815,3526148,238561699,210776768
29378212_3526165,CM021103.1,4,29378212,235035551,8495815,3526165,238561716,210776785
29378212_3526169,CM021103.1,4,29378212,235035551,8495815,3526169,238561720,210776789
29378212_3526216,CM021103.1,4,29378212,235035551,8495815,3526216,238561767,210776836
29378212_3526217,CM021103.1,4,29378212,235035551,8495815,3526217,238561768,210776837
29378212_3526454,CM021103.1,4,29378212,235035551,8495815,3526454,238562005,210777074
29378212_3526474,CM021103.1,4,29378212,235035551,8495815,3526474,238562025,210777094
29378212_3526489,CM021103.1,4,29378212,235035551,8495815,3526489,238562040,210777109
29378212_3526493,CM021103.1,4,29378212,235035551,8495815,3526493,238562044,210777113
29378212_3526520,CM021103.1,4,29378212,235035551,8495815,3526520,238562071,210777140
29378212_3697311,CM021103.1,4,29378212,235035551,8495815,3697311,238732862,210947931
29378212_3697377,CM021103.1,4,29378212,235035551,8495815,3697377,238732928,210947997
29378212_3697378,CM021103.1,4,29378212,235035551,8495815,3697378,238732929,210947998
29378212_3721579,CM021103.1,4,29378212,235035551,8495815,3721579,238757130,210972199
29378212_3722864,CM021103.1,4,29378212,235035551,8495815,3722864,238758415,210973484
29378212_3723402,CM021103.1,4,29378212,235035551,8495815,3723402,238758953,210974022
29378212_3742929,CM021103.1,4,29378212,235035551,8495815,3742929,238778480,210993549
29378212_3742994,CM021103.1,4,29378212,235035551,8495815,3742994,238778545,210993614
29378212_3747742,CM021103.1,4,29378212,235035551,8495815,3747742,238783293,210998362
29378212_3747751,CM021103.1,4,29378212,235035551,8495815,3747751,238783302,210998371
29378212_4575019,CM021103.1,4,29378212,235035551,8495815,4575019,239610570,211825639
29378212_4866334,CM021103.1,4,29378212,235035551,8495815,4866334,239901885,212116954
29378212_4866351,CM021103.1,4,29378212,235035551,8495815,4866351,239901902,212116971
29378212_4866776,CM021103.1,4,29378212,235035551,8495815,4866776,239902327,212117396
29378212_4905025,CM021103.1,4,29378212,235035551,8495815,4905025,239940576,212155645
29378212_5460050,CM021103.1,4,29378212,235035551,8495815,5460050,240495601,212710670
29378212_5460068,CM021103.1,4,29378212,235035551,8495815,5460068,240495619,212710688
29378212_5460108,CM021103.1,4,29378212,235035551,8495815,5460108,240495659,212710728
29378212_5460117,CM021103.1,4,29378212,235035551,8495815,5460117,240495668,212710737
29378212_5460123,CM021103.1,4,29378212,235035551,8495815,5460123,240495674,212710743
29378212_5460129,CM021103.1,4,29378212,235035551,8495815,5460129,240495680,212710749
29378212_5600805,CM021103.1,4,29378212,235035551,8495815,5600805,240636356,212851425
29378212_5613091,CM021103.1,4,29378212,235035551,8495815,5613091,240648642,212863711
29378212_5613142,CM021103.1,4,29378212,235035551,8495815,5613142,240648693,212863762
29378212_5613157,CM021103.1,4,29378212,235035551,8495815,5613157,240648708,212863777
29378212_5953235,CM021103.1,4,29378212,235035551,8495815,5953235,240988786,213203855
29378212_5953240,CM021103.1,4,29378212,235035551,8495815,5953240,240988791,213203860
29378212_6220125,CM021103.1,4,29378212,235035551,8495815,6220125,241255676,213470745
29378212_6611861,CM021103.1,4,29378212,235035551,8495815,6611861,241647412,213862481
29378212_6638075,CM021103.1,4,29378212,235035551,8495815,6638075,241673626,213888695
29378212_6680164,CM021103.1,4,29378212,235035551,8495815,6680164,241715715,213930784
29378212_6751404,CM021103.1,4,29378212,235035551,8495815,6751404,241786955,214002024
29378212_6771647,CM021103.1,4,29378212,235035551,8495815,6771647,241807198,214022267
29378212_7156705,CM021103.1,4,29378212,235035551,8495815,7156705,242192256,214407325
29378212_7156792,CM021103.1,4,29378212,235035551,8495815,7156792,242192343,214407412
29378212_8254783,CM021103.1,4,29378212,235035551,8495815,8254783,243290334,215505403
29378212_8280316,CM021103.1,4,29378212,235035551,8495815,8280316,243315867,215530936
29378212_8284293,CM021103.1,4,29378212,235035551,8495815,8284293,243319844,215534913
29378212_8285794,CM021103.1,4,29378212,235035551,8495815,8285794,243321345,215536414
29342442_3425,CM021103.1,4,29342442,250279977,198563,3425,250283402,222498471
29342442_3434,CM021103.1,4,29342442,250279977,198563,3434,250283411,222498480
29342442_3441,CM021103.1,4,29342442,250279977,198563,3441,250283418,222498487
29342442_3464,CM021103.1,4,29342442,250279977,198563,3464,250283441,222498510
29342442_3478,CM021103.1,4,29342442,250279977,198563,3478,250283455,222498524
29342442_3487,CM021103.1,4,29342442,250279977,198563,3487,250283464,222498533
29342442_3489,CM021103.1,4,29342442,250279977,198563,3489,250283466,222498535
29342442_3533,CM021103.1,4,29342442,250279977,198563,3533,250283510,222498579
29342442_3534,CM021103.1,4,29342442,250279977,198563,3534,250283511,222498580
29342442_3559,CM021103.1,4,29342442,250279977,198563,3559,250283536,222498605
29342442_3568,CM021103.1,4,29342442,250279977,198563,3568,250283545,222498614
29342442_162517,CM021103.1,4,29342442,250279977,198563,162517,250442494,222657563
29342442_162559,CM021103.1,4,29342442,250279977,198563,162559,250442536,222657605
29342442_162589,CM021103.1,4,29342442,250279977,198563,162589,250442566,222657635
29342442_162594,CM021103.1,4,29342442,250279977,198563,162594,250442571,222657640
29342442_162597,CM021103.1,4,29342442,250279977,198563,162597,250442574,222657643
29342442_162612,CM021103.1,4,29342442,250279977,198563,162612,250442589,222657658
29342442_162633,CM021103.1,4,29342442,250279977,198563,162633,250442610,222657679
29342442_162634,CM021103.1,4,29342442,250279977,198563,162634,250442611,222657680
29347466_10067,CM021103.1,4,29347466,259945301,29779,10067,259955368,232170437
29347466_10101,CM021103.1,4,29347466,259945301,29779,10101,259955402,232170471
29347466_10104,CM021103.1,4,29347466,259945301,29779,10104,259955405,232170474
29347466_10106,CM021103.1,4,29347466,259945301,29779,10106,259955407,232170476
29347466_10117,CM021103.1,4,29347466,259945301,29779,10117,259955418,232170487
29347466_10120,CM021103.1,4,29347466,259945301,29779,10120,259955421,232170490
29347466_10121,CM021103.1,4,29347466,259945301,29779,10121,259955422,232170491
29347466_10190,CM021103.1,4,29347466,259945301,29779,10190,259955491,232170560
29377173_24949,CM021103.1,4,29377173,259937108,148468,24949,259962057,232177126
29377173_24972,CM021103.1,4,29377173,259937108,148468,24972,259962080,232177149
29377173_24974,CM021103.1,4,29377173,259937108,148468,24974,259962082,232177151
29377173_24983,CM021103.1,4,29377173,259937108,148468,24983,259962091,232177160
29377173_24992,CM021103.1,4,29377173,259937108,148468,24992,259962100,232177169
29377173_24995,CM021103.1,4,29377173,259937108,148468,24995,259962103,232177172
29377173_25014,CM021103.1,4,29377173,259937108,148468,25014,259962122,232177191
29377173_25019,CM021103.1,4,29377173,259937108,148468,25019,259962127,232177196
29378591_574873,CM021103.1,4,29378591,259938046,948695,574873,260512919,232727988
29378591_574928,CM021103.1,4,29378591,259938046,948695,574928,260512974,232728043
29378591_574954,CM021103.1,4,29378591,259938046,948695,574954,260513000,232728069
29378591_575005,CM021103.1,4,29378591,259938046,948695,575005,260513051,232728120
29378591_575006,CM021103.1,4,29378591,259938046,948695,575006,260513052,232728121
29378591_575014,CM021103.1,4,29378591,259938046,948695,575014,260513060,232728129
29378591_575024,CM021103.1,4,29378591,259938046,948695,575024,260513070,232728139
29378591_913209,CM021103.1,4,29378591,259938046,948695,913209,260851255,233066324
29378591_913323,CM021103.1,4,29378591,259938046,948695,913323,260851369,233066438
29378591_938161,CM021103.1,4,29378591,259938046,948695,938161,260876207,233091276
29378591_938165,CM021103.1,4,29378591,259938046,948695,938165,260876211,233091280
29378591_938210,CM021103.1,4,29378591,259938046,948695,938210,260876256,233091325
29378591_938238,CM021103.1,4,29378591,259938046,948695,938238,260876284,233091353
29378591_938260,CM021103.1,4,29378591,259938046,948695,938260,260876306,233091375
29378591_938315,CM021103.1,4,29378591,259938046,948695,938315,260876361,233091430
29377641_442,CM021103.1,4,29377641,286343343,111936,442,286343785,258558854
29377641_486,CM021103.1,4,29377641,286343343,111936,486,286343829,258558898
29377641_518,CM021103.1,4,29377641,286343343,111936,518,286343861,258558930
29379342_4325,CM021103.1,4,29379342,290252399,1052430,4325,290256724,262471793
29377877_7508,CM021103.1,4,29377877,290252396,189786,7508,290259904,262474973
29377877_7529,CM021103.1,4,29377877,290252396,189786,7529,290259925,262474994
29379159_13776,CM021103.1,4,29379159,290252399,950821,13776,290266175,262481244
29355715_31907,CM021103.1,4,29355715,290253260,599079,31907,290285167,262500236
29355715_65683,CM021103.1,4,29355715,290253260,599079,65683,290318943,262534012
29355715_65685,CM021103.1,4,29355715,290253260,599079,65685,290318945,262534014
29355715_65690,CM021103.1,4,29355715,290253260,599079,65690,290318950,262534019
29355715_65725,CM021103.1,4,29355715,290253260,599079,65725,290318985,262534054
29355715_65729,CM021103.1,4,29355715,290253260,599079,65729,290318989,262534058
29355715_65778,CM021103.1,4,29355715,290253260,599079,65778,290319038,262534107
29355715_65779,CM021103.1,4,29355715,290253260,599079,65779,290319039,262534108
29355715_65790,CM021103.1,4,29355715,290253260,599079,65790,290319050,262534119
29379967_85314,CM021103.1,4,29379967,290253027,1317830,85314,290338341,262553410
29381964_90965,CM021103.1,4,29381964,290253194,2307271,90965,290344159,262559228
29381964_91017,CM021103.1,4,29381964,290253194,2307271,91017,290344211,262559280
29379967_111846,CM021103.1,4,29379967,290253027,1317830,111846,290364873,262579942
29355715_112602,CM021103.1,4,29355715,290253260,599079,112602,290365862,262580931
29382466_127449,CM021103.1,4,29382466,290252395,4426512,127449,290379844,262594913
29382466_127481,CM021103.1,4,29382466,290252395,4426512,127481,290379876,262594945
29382466_128763,CM021103.1,4,29382466,290252395,4426512,128763,290381158,262596227
29382466_212854,CM021103.1,4,29382466,290252395,4426512,212854,290465249,262680318
29382466_212865,CM021103.1,4,29382466,290252395,4426512,212865,290465260,262680329
29382466_213046,CM021103.1,4,29382466,290252395,4426512,213046,290465441,262680510
29377713_242555,CM021103.1,4,29377713,290252399,2157577,242555,290494954,262710023
29377713_250694,CM021103.1,4,29377713,290252399,2157577,250694,290503093,262718162
29377713_250885,CM021103.1,4,29377713,290252399,2157577,250885,290503284,262718353
29379967_257170,CM021103.1,4,29379967,290253027,1317830,257170,290510197,262725266
29379967_257185,CM021103.1,4,29379967,290253027,1317830,257185,290510212,262725281
29379967_257208,CM021103.1,4,29379967,290253027,1317830,257208,290510235,262725304
29379967_257224,CM021103.1,4,29379967,290253027,1317830,257224,290510251,262725320
29379967_257364,CM021103.1,4,29379967,290253027,1317830,257364,290510391,262725460
29382466_306604,CM021103.1,4,29382466,290252395,4426512,306604,290558999,262774068
29382466_306627,CM021103.1,4,29382466,290252395,4426512,306627,290559022,262774091
29382466_306641,CM021103.1,4,29382466,290252395,4426512,306641,290559036,262774105
29382466_306683,CM021103.1,4,29382466,290252395,4426512,306683,290559078,262774147
29382466_306695,CM021103.1,4,29382466,290252395,4426512,306695,290559090,262774159
29382466_306697,CM021103.1,4,29382466,290252395,4426512,306697,290559092,262774161
29382466_306705,CM021103.1,4,29382466,290252395,4426512,306705,290559100,262774169
29382466_307656,CM021103.1,4,29382466,290252395,4426512,307656,290560051,262775120
29379159_322359,CM021103.1,4,29379159,290252399,950821,322359,290574758,262789827
29378475_398640,CM021103.1,4,29378475,290252449,573592,398640,290651089,262866158
29378564_409779,CM021103.1,4,29378564,290253285,2475849,409779,290663064,262878133
29352072_454468,CM021103.1,4,29352072,290252470,904748,454468,290706938,262922007
29377713_528220,CM021103.1,4,29377713,290252399,2157577,528220,290780619,262995688
29377713_528259,CM021103.1,4,29377713,290252399,2157577,528259,290780658,262995727
29377713_528276,CM021103.1,4,29377713,290252399,2157577,528276,290780675,262995744
29381964_542648,CM021103.1,4,29381964,290253194,2307271,542648,290795842,263010911
29377713_553900,CM021103.1,4,29377713,290252399,2157577,553900,290806299,263021368
29377713_553957,CM021103.1,4,29377713,290252399,2157577,553957,290806356,263021425
29381170_590032,CM021103.1,4,29381170,290252394,4879441,590032,290842426,263057495
29381170_590343,CM021103.1,4,29381170,290252394,4879441,590343,290842737,263057806
29381170_612257,CM021103.1,4,29381170,290252394,4879441,612257,290864651,263079720
29381170_612278,CM021103.1,4,29381170,290252394,4879441,612278,290864672,263079741
29377260_680243,CM021103.1,4,29377260,290252399,3010759,680243,290932642,263147711
29377260_683863,CM021103.1,4,29377260,290252399,3010759,683863,290936262,263151331
29377260_684583,CM021103.1,4,29377260,290252399,3010759,684583,290936982,263152051
29377260_684639,CM021103.1,4,29377260,290252399,3010759,684639,290937038,263152107
29379637_686945,CM021103.1,4,29379637,290252399,6431587,686945,290939344,263154413
29379637_686961,CM021103.1,4,29379637,290252399,6431587,686961,290939360,263154429
29377260_688764,CM021103.1,4,29377260,290252399,3010759,688764,290941163,263156232
29377260_688765,CM021103.1,4,29377260,290252399,3010759,688765,290941164,263156233
29377260_688835,CM021103.1,4,29377260,290252399,3010759,688835,290941234,263156303
29381964_727884,CM021103.1,4,29381964,290253194,2307271,727884,290981078,263196147
29378564_741003,CM021103.1,4,29378564,290253285,2475849,741003,290994288,263209357
29381662_790520,CM021103.1,4,29381662,290252396,1054926,790520,291042916,263257985
29381662_790550,CM021103.1,4,29381662,290252396,1054926,790550,291042946,263258015
29381662_790557,CM021103.1,4,29381662,290252396,1054926,790557,291042953,263258022
29381662_790675,CM021103.1,4,29381662,290252396,1054926,790675,291043071,263258140
29381662_790695,CM021103.1,4,29381662,290252396,1054926,790695,291043091,263258160
29381662_790698,CM021103.1,4,29381662,290252396,1054926,790698,291043094,263258163
29381662_790816,CM021103.1,4,29381662,290252396,1054926,790816,291043212,263258281
29381662_790954,CM021103.1,4,29381662,290252396,1054926,790954,291043350,263258419
29381662_823815,CM021103.1,4,29381662,290252396,1054926,823815,291076211,263291280
29381662_823823,CM021103.1,4,29381662,290252396,1054926,823823,291076219,263291288
29379342_834256,CM021103.1,4,29379342,290252399,1052430,834256,291086655,263301724
29379342_834357,CM021103.1,4,29379342,290252399,1052430,834357,291086756,263301825
29381662_896078,CM021103.1,4,29381662,290252396,1054926,896078,291148474,263363543
29381662_896085,CM021103.1,4,29381662,290252396,1054926,896085,291148481,263363550
29381662_896094,CM021103.1,4,29381662,290252396,1054926,896094,291148490,263363559
29381662_896095,CM021103.1,4,29381662,290252396,1054926,896095,291148491,263363560
29381662_896100,CM021103.1,4,29381662,290252396,1054926,896100,291148496,263363565
29381662_896102,CM021103.1,4,29381662,290252396,1054926,896102,291148498,263363567
29377260_945335,CM021103.1,4,29377260,290252399,3010759,945335,291197734,263412803
29377260_946761,CM021103.1,4,29377260,290252399,3010759,946761,291199160,263414229
29377260_947121,CM021103.1,4,29377260,290252399,3010759,947121,291199520,263414589
29381662_956430,CM021103.1,4,29381662,290252396,1054926,956430,291208826,263423895
29381662_956482,CM021103.1,4,29381662,290252396,1054926,956482,291208878,263423947
29381662_969486,CM021103.1,4,29381662,290252396,1054926,969486,291221882,263436951
29381662_969508,CM021103.1,4,29381662,290252396,1054926,969508,291221904,263436973
29378592_1009953,CM021103.1,4,29378592,290252401,2290079,1009953,291262354,263477423
29353851_1096866,CM021103.1,4,29353851,290252399,1209712,1096866,291349265,263564334
29353851_1135535,CM021103.1,4,29353851,290252399,1209712,1135535,291387934,263603003
29353851_1135568,CM021103.1,4,29353851,290252399,1209712,1135568,291387967,263603036
29353851_1135605,CM021103.1,4,29353851,290252399,1209712,1135605,291388004,263603073
29353851_1139753,CM021103.1,4,29353851,290252399,1209712,1139753,291392152,263607221
29379637_1148286,CM021103.1,4,29379637,290252399,6431587,1148286,291400685,263615754
29379637_1148314,CM021103.1,4,29379637,290252399,6431587,1148314,291400713,263615782
29379637_1148316,CM021103.1,4,29379637,290252399,6431587,1148316,291400715,263615784
29379637_1148323,CM021103.1,4,29379637,290252399,6431587,1148323,291400722,263615791
29379637_1148402,CM021103.1,4,29379637,290252399,6431587,1148402,291400801,263615870
29378592_1231507,CM021103.1,4,29378592,290252401,2290079,1231507,291483908,263698977
29378592_1254278,CM021103.1,4,29378592,290252401,2290079,1254278,291506679,263721748
29377781_1336953,CM021103.1,4,29377781,290252396,2339599,1336953,291589349,263804418
29379301_1346842,CM021103.1,4,29379301,290252399,1366238,1346842,291599241,263814310
29381964_1360496,CM021103.1,4,29381964,290253194,2307271,1360496,291613690,263828759
29381964_1360508,CM021103.1,4,29381964,290253194,2307271,1360508,291613702,263828771
29381964_1360581,CM021103.1,4,29381964,290253194,2307271,1360581,291613775,263828844
29381964_1360613,CM021103.1,4,29381964,290253194,2307271,1360613,291613807,263828876
29381964_1360618,CM021103.1,4,29381964,290253194,2307271,1360618,291613812,263828881
29381964_1360620,CM021103.1,4,29381964,290253194,2307271,1360620,291613814,263828883
29381964_1360630,CM021103.1,4,29381964,290253194,2307271,1360630,291613824,263828893
29381964_1360676,CM021103.1,4,29381964,290253194,2307271,1360676,291613870,263828939
29381964_1360678,CM021103.1,4,29381964,290253194,2307271,1360678,291613872,263828941
29377781_1399246,CM021103.1,4,29377781,290252396,2339599,1399246,291651642,263866711
29377260_1429596,CM021103.1,4,29377260,290252399,3010759,1429596,291681995,263897064
29377260_1429609,CM021103.1,4,29377260,290252399,3010759,1429609,291682008,263897077
29377260_1429620,CM021103.1,4,29377260,290252399,3010759,1429620,291682019,263897088
29377260_1429625,CM021103.1,4,29377260,290252399,3010759,1429625,291682024,263897093
29377260_1429644,CM021103.1,4,29377260,290252399,3010759,1429644,291682043,263897112
29377260_1429657,CM021103.1,4,29377260,290252399,3010759,1429657,291682056,263897125
29377260_1429661,CM021103.1,4,29377260,290252399,3010759,1429661,291682060,263897129
29377260_1429689,CM021103.1,4,29377260,290252399,3010759,1429689,291682088,263897157
29377260_1429706,CM021103.1,4,29377260,290252399,3010759,1429706,291682105,263897174
29377260_1429709,CM021103.1,4,29377260,290252399,3010759,1429709,291682108,263897177
29377781_1747600,CM021103.1,4,29377781,290252396,2339599,1747600,291999996,264215065
29377781_1747675,CM021103.1,4,29377781,290252396,2339599,1747675,292000071,264215140
29377260_1763826,CM021103.1,4,29377260,290252399,3010759,1763826,292016225,264231294
29377781_1770490,CM021103.1,4,29377781,290252396,2339599,1770490,292022886,264237955
29381170_2186259,CM021103.1,4,29381170,290252394,4879441,2186259,292438653,264653722
29381170_2186278,CM021103.1,4,29381170,290252394,4879441,2186278,292438672,264653741
29381170_2186289,CM021103.1,4,29381170,290252394,4879441,2186289,292438683,264653752
29381170_2186340,CM021103.1,4,29381170,290252394,4879441,2186340,292438734,264653803
29382466_2536118,CM021103.1,4,29382466,290252395,4426512,2536118,292788513,265003582
29382466_2536204,CM021103.1,4,29382466,290252395,4426512,2536204,292788599,265003668
29381170_2927732,CM021103.1,4,29381170,290252394,4879441,2927732,293180126,265395195
29381170_2927756,CM021103.1,4,29381170,290252394,4879441,2927756,293180150,265395219
29381170_2927763,CM021103.1,4,29381170,290252394,4879441,2927763,293180157,265395226
29381170_2927764,CM021103.1,4,29381170,290252394,4879441,2927764,293180158,265395227
29381170_2927768,CM021103.1,4,29381170,290252394,4879441,2927768,293180162,265395231
29381170_2927913,CM021103.1,4,29381170,290252394,4879441,2927913,293180307,265395376
29381170_2927943,CM021103.1,4,29381170,290252394,4879441,2927943,293180337,265395406
29379637_3012338,CM021103.1,4,29379637,290252399,6431587,3012338,293264737,265479806
29379637_3012459,CM021103.1,4,29379637,290252399,6431587,3012459,293264858,265479927
29382466_3816694,CM021103.1,4,29382466,290252395,4426512,3816694,294069089,266284158
29382466_3816744,CM021103.1,4,29382466,290252395,4426512,3816744,294069139,266284208
29382466_3816832,CM021103.1,4,29382466,290252395,4426512,3816832,294069227,266284296
29382466_3816860,CM021103.1,4,29382466,290252395,4426512,3816860,294069255,266284324
29382466_3816863,CM021103.1,4,29382466,290252395,4426512,3816863,294069258,266284327
29382466_3934641,CM021103.1,4,29382466,290252395,4426512,3934641,294187036,266402105
29382466_3934648,CM021103.1,4,29382466,290252395,4426512,3934648,294187043,266402112
29382466_3934662,CM021103.1,4,29382466,290252395,4426512,3934662,294187057,266402126
29382466_3934693,CM021103.1,4,29382466,290252395,4426512,3934693,294187088,266402157
29382466_3934703,CM021103.1,4,29382466,290252395,4426512,3934703,294187098,266402167
29382466_3934723,CM021103.1,4,29382466,290252395,4426512,3934723,294187118,266402187
29381170_4460868,CM021103.1,4,29381170,290252394,4879441,4460868,294713262,266928331
29379637_5551264,CM021103.1,4,29379637,290252399,6431587,5551264,295803663,268018732
29379637_5551266,CM021103.1,4,29379637,290252399,6431587,5551266,295803665,268018734
29379637_5551275,CM021103.1,4,29379637,290252399,6431587,5551275,295803674,268018743
29379637_5551278,CM021103.1,4,29379637,290252399,6431587,5551278,295803677,268018746
29379637_5551294,CM021103.1,4,29379637,290252399,6431587,5551294,295803693,268018762
29379637_5551298,CM021103.1,4,29379637,290252399,6431587,5551298,295803697,268018766
29379637_5551300,CM021103.1,4,29379637,290252399,6431587,5551300,295803699,268018768
29379637_5551323,CM021103.1,4,29379637,290252399,6431587,5551323,295803722,268018791
29379637_5551335,CM021103.1,4,29379637,290252399,6431587,5551335,295803734,268018803
29379637_5551459,CM021103.1,4,29379637,290252399,6431587,5551459,295803858,268018927
29379637_5551463,CM021103.1,4,29379637,290252399,6431587,5551463,295803862,268018931
29379637_5551485,CM021103.1,4,29379637,290252399,6431587,5551485,295803884,268018953
29379637_5551487,CM021103.1,4,29379637,290252399,6431587,5551487,295803886,268018955
29379637_5551500,CM021103.1,4,29379637,290252399,6431587,5551500,295803899,268018968
29379637_5821987,CM021103.1,4,29379637,290252399,6431587,5821987,296074386,268289455
29344996_1344,CM021103.1,4,29344996,300120004,19864,1344,300121348,272336417
29379037_144901,CM021103.1,4,29379037,306667357,687822,144901,306812258,279027327
29379037_144905,CM021103.1,4,29379037,306667357,687822,144905,306812262,279027331
29379037_144906,CM021103.1,4,29379037,306667357,687822,144906,306812263,279027332
29379037_145026,CM021103.1,4,29379037,306667357,687822,145026,306812383,279027452
29379037_166737,CM021103.1,4,29379037,306667357,687822,166737,306834094,279049163
29380513_218934,CM021103.1,4,29380513,306667345,2118905,218934,306886279,279101348
29380513_218993,CM021103.1,4,29380513,306667345,2118905,218993,306886338,279101407
29381606_729059,CM021103.1,4,29381606,306667356,1030616,729059,307396415,279611484
29381606_729060,CM021103.1,4,29381606,306667356,1030616,729060,307396416,279611485
29344749_30994,CM021103.1,4,29344749,316891347,38901,30994,316922341,289137410
29343224_1288,CM021103.1,4,29343224,322515130,78414,1288,322516418,294731487
29343224_1297,CM021103.1,4,29343224,322515130,78414,1297,322516427,294731496
29343224_1355,CM021103.1,4,29343224,322515130,78414,1355,322516485,294731554
29343224_29053,CM021103.1,4,29343224,322515130,78414,29053,322544183,294759252
29343224_29056,CM021103.1,4,29343224,322515130,78414,29056,322544186,294759255
29343224_44217,CM021103.1,4,29343224,322515130,78414,44217,322559347,294774416
29349553_4077,CM021103.1,4,29349553,332659055,487532,4077,332663132,304878201
29378259_6545,CM021103.1,4,29378259,332663290,198607,6545,332669835,304884904
29377073_82934,CM021103.1,4,29377073,332659055,564310,82934,332741989,304957058
29377073_100361,CM021103.1,4,29377073,332659055,564310,100361,332759416,304974485
29377073_137547,CM021103.1,4,29377073,332659055,564310,137547,332796602,305011671
29377073_137947,CM021103.1,4,29377073,332659055,564310,137947,332797002,305012071
29380411_275165,CM021103.1,4,29380411,332659654,4855072,275165,332934819,305149888
29380411_275628,CM021103.1,4,29380411,332659654,4855072,275628,332935282,305150351
29380411_275866,CM021103.1,4,29380411,332659654,4855072,275866,332935520,305150589
29377073_358488,CM021103.1,4,29377073,332659055,564310,358488,333017543,305232612
29377073_358521,CM021103.1,4,29377073,332659055,564310,358521,333017576,305232645
29378614_370735,CM021103.1,4,29378614,332659052,436223,370735,333029787,305244856
29380411_405148,CM021103.1,4,29380411,332659654,4855072,405148,333064802,305279871
29378311_417660,CM021103.1,4,29378311,332661140,2995749,417660,333078800,305293869
29379683_442800,CM021103.1,4,29379683,332660059,1154644,442800,333102859,305317928
29378121_456976,CM021103.1,4,29378121,332659048,852937,456976,333116024,305331093
29378121_457066,CM021103.1,4,29378121,332659048,852937,457066,333116114,305331183
29382386_665872,CM021103.1,4,29382386,332659055,2015643,665872,333324927,305539996
29382386_665954,CM021103.1,4,29382386,332659055,2015643,665954,333325009,305540078
29382386_666027,CM021103.1,4,29382386,332659055,2015643,666027,333325082,305540151
29382386_782646,CM021103.1,4,29382386,332659055,2015643,782646,333441701,305656770
29379254_902554,CM021103.1,4,29379254,332659053,2900312,902554,333561607,305776676
29379254_949098,CM021103.1,4,29379254,332659053,2900312,949098,333608151,305823220
29379254_949630,CM021103.1,4,29379254,332659053,2900312,949630,333608683,305823752
29379254_949712,CM021103.1,4,29379254,332659053,2900312,949712,333608765,305823834
29379254_949770,CM021103.1,4,29379254,332659053,2900312,949770,333608823,305823892
29379683_971247,CM021103.1,4,29379683,332660059,1154644,971247,333631306,305846375
29379254_1003468,CM021103.1,4,29379254,332659053,2900312,1003468,333662521,305877590
29379254_1003646,CM021103.1,4,29379254,332659053,2900312,1003646,333662699,305877768
29382386_1063616,CM021103.1,4,29382386,332659055,2015643,1063616,333722671,305937740
29382386_1063646,CM021103.1,4,29382386,332659055,2015643,1063646,333722701,305937770
29382064_1069822,CM021103.1,4,29382064,332659054,1259622,1069822,333728876,305943945
29382064_1069931,CM021103.1,4,29382064,332659054,1259622,1069931,333728985,305944054
29379771_1077646,CM021103.1,4,29379771,332659054,4992802,1077646,333736700,305951769
29379771_1077668,CM021103.1,4,29379771,332659054,4992802,1077668,333736722,305951791
29379771_1077697,CM021103.1,4,29379771,332659054,4992802,1077697,333736751,305951820
29379771_1077726,CM021103.1,4,29379771,332659054,4992802,1077726,333736780,305951849
29379771_1077744,CM021103.1,4,29379771,332659054,4992802,1077744,333736798,305951867
29379771_1077760,CM021103.1,4,29379771,332659054,4992802,1077760,333736814,305951883
29379771_1077761,CM021103.1,4,29379771,332659054,4992802,1077761,333736815,305951884
29379771_1077776,CM021103.1,4,29379771,332659054,4992802,1077776,333736830,305951899
29379771_1078086,CM021103.1,4,29379771,332659054,4992802,1078086,333737140,305952209
29380411_1135336,CM021103.1,4,29380411,332659654,4855072,1135336,333794990,306010059
29379771_1222494,CM021103.1,4,29379771,332659054,4992802,1222494,333881548,306096617
29379771_1456351,CM021103.1,4,29379771,332659054,4992802,1456351,334115405,306330474
29379771_1456858,CM021103.1,4,29379771,332659054,4992802,1456858,334115912,306330981
29379771_1456877,CM021103.1,4,29379771,332659054,4992802,1456877,334115931,306331000
29379771_1649702,CM021103.1,4,29379771,332659054,4992802,1649702,334308756,306523825
29379771_1649727,CM021103.1,4,29379771,332659054,4992802,1649727,334308781,306523850
29379771_1649787,CM021103.1,4,29379771,332659054,4992802,1649787,334308841,306523910
29380411_1676994,CM021103.1,4,29380411,332659654,4855072,1676994,334336648,306551717
29380411_1689707,CM021103.1,4,29380411,332659654,4855072,1689707,334349361,306564430
29380411_1703702,CM021103.1,4,29380411,332659654,4855072,1703702,334363356,306578425
29379146_1920490,CM021103.1,4,29379146,332659055,2639638,1920490,334579545,306794614
29379146_1920781,CM021103.1,4,29379146,332659055,2639638,1920781,334579836,306794905
29379146_1920945,CM021103.1,4,29379146,332659055,2639638,1920945,334580000,306795069
29379146_2028887,CM021103.1,4,29379146,332659055,2639638,2028887,334687942,306903011
29379146_2029033,CM021103.1,4,29379146,332659055,2639638,2029033,334688088,306903157
29380411_2069937,CM021103.1,4,29380411,332659654,4855072,2069937,334729591,306944660
29380411_2069939,CM021103.1,4,29380411,332659654,4855072,2069939,334729593,306944662
29380411_2070146,CM021103.1,4,29380411,332659654,4855072,2070146,334729800,306944869
29380411_2121990,CM021103.1,4,29380411,332659654,4855072,2121990,334781644,306996713
29381872_2198422,CM021103.1,4,29381872,332659054,4702406,2198422,334857476,307072545
29381872_2198491,CM021103.1,4,29381872,332659054,4702406,2198491,334857545,307072614
29381872_2198509,CM021103.1,4,29381872,332659054,4702406,2198509,334857563,307072632
29381872_2198535,CM021103.1,4,29381872,332659054,4702406,2198535,334857589,307072658
29379771_2228329,CM021103.1,4,29379771,332659054,4992802,2228329,334887383,307102452
29379771_2228332,CM021103.1,4,29379771,332659054,4992802,2228332,334887386,307102455
29379771_2322663,CM021103.1,4,29379771,332659054,4992802,2322663,334981717,307196786
29379771_2322676,CM021103.1,4,29379771,332659054,4992802,2322676,334981730,307196799
29379771_2322776,CM021103.1,4,29379771,332659054,4992802,2322776,334981830,307196899
29379771_2327788,CM021103.1,4,29379771,332659054,4992802,2327788,334986842,307201911
29379771_2328079,CM021103.1,4,29379771,332659054,4992802,2328079,334987133,307202202
29379771_2328099,CM021103.1,4,29379771,332659054,4992802,2328099,334987153,307202222
29381872_2328901,CM021103.1,4,29381872,332659054,4702406,2328901,334987955,307203024
29379058_2423295,CM021103.1,4,29379058,332659054,2700008,2423295,335082349,307297418
29379058_2423297,CM021103.1,4,29379058,332659054,2700008,2423297,335082351,307297420
29379058_2423308,CM021103.1,4,29379058,332659054,2700008,2423308,335082362,307297431
29379058_2423313,CM021103.1,4,29379058,332659054,2700008,2423313,335082367,307297436
29379058_2423316,CM021103.1,4,29379058,332659054,2700008,2423316,335082370,307297439
29379058_2423323,CM021103.1,4,29379058,332659054,2700008,2423323,335082377,307297446
29379058_2423327,CM021103.1,4,29379058,332659054,2700008,2423327,335082381,307297450
29379058_2423331,CM021103.1,4,29379058,332659054,2700008,2423331,335082385,307297454
29379058_2423355,CM021103.1,4,29379058,332659054,2700008,2423355,335082409,307297478
29379058_2423365,CM021103.1,4,29379058,332659054,2700008,2423365,335082419,307297488
29379058_2423366,CM021103.1,4,29379058,332659054,2700008,2423366,335082420,307297489
29379058_2423403,CM021103.1,4,29379058,332659054,2700008,2423403,335082457,307297526
29379058_2423431,CM021103.1,4,29379058,332659054,2700008,2423431,335082485,307297554
29379058_2423435,CM021103.1,4,29379058,332659054,2700008,2423435,335082489,307297558
29379058_2423449,CM021103.1,4,29379058,332659054,2700008,2423449,335082503,307297572
29379058_2423464,CM021103.1,4,29379058,332659054,2700008,2423464,335082518,307297587
29379058_2423490,CM021103.1,4,29379058,332659054,2700008,2423490,335082544,307297613
29379058_2423517,CM021103.1,4,29379058,332659054,2700008,2423517,335082571,307297640
29379058_2423519,CM021103.1,4,29379058,332659054,2700008,2423519,335082573,307297642
29379058_2435675,CM021103.1,4,29379058,332659054,2700008,2435675,335094729,307309798
29379058_2435707,CM021103.1,4,29379058,332659054,2700008,2435707,335094761,307309830
29379058_2435718,CM021103.1,4,29379058,332659054,2700008,2435718,335094772,307309841
29381586_2554332,CM021103.1,4,29381586,332659055,2666423,2554332,335213387,307428456
29378311_2554215,CM021103.1,4,29378311,332661140,2995749,2554215,335215355,307430424
29378311_2554224,CM021103.1,4,29378311,332661140,2995749,2554224,335215364,307430433
29378311_2554225,CM021103.1,4,29378311,332661140,2995749,2554225,335215365,307430434
29378311_2554240,CM021103.1,4,29378311,332661140,2995749,2554240,335215380,307430449
29378311_2554263,CM021103.1,4,29378311,332661140,2995749,2554263,335215403,307430472
29378311_2554283,CM021103.1,4,29378311,332661140,2995749,2554283,335215423,307430492
29378311_2554293,CM021103.1,4,29378311,332661140,2995749,2554293,335215433,307430502
29378311_2554296,CM021103.1,4,29378311,332661140,2995749,2554296,335215436,307430505
29378311_2554302,CM021103.1,4,29378311,332661140,2995749,2554302,335215442,307430511
29378311_2554307,CM021103.1,4,29378311,332661140,2995749,2554307,335215447,307430516
29378311_2554319,CM021103.1,4,29378311,332661140,2995749,2554319,335215459,307430528
29378311_2554346,CM021103.1,4,29378311,332661140,2995749,2554346,335215486,307430555
29378311_2554357,CM021103.1,4,29378311,332661140,2995749,2554357,335215497,307430566
29378311_2554359,CM021103.1,4,29378311,332661140,2995749,2554359,335215499,307430568
29378311_2554394,CM021103.1,4,29378311,332661140,2995749,2554394,335215534,307430603
29378311_2554413,CM021103.1,4,29378311,332661140,2995749,2554413,335215553,307430622
29378311_2554417,CM021103.1,4,29378311,332661140,2995749,2554417,335215557,307430626
29380411_2594703,CM021103.1,4,29380411,332659654,4855072,2594703,335254357,307469426
29379058_2659419,CM021103.1,4,29379058,332659054,2700008,2659419,335318473,307533542
29379058_2659435,CM021103.1,4,29379058,332659054,2700008,2659435,335318489,307533558
29379058_2661578,CM021103.1,4,29379058,332659054,2700008,2661578,335320632,307535701
29379058_2661594,CM021103.1,4,29379058,332659054,2700008,2661594,335320648,307535717
29379058_2661610,CM021103.1,4,29379058,332659054,2700008,2661610,335320664,307535733
29379058_2661618,CM021103.1,4,29379058,332659054,2700008,2661618,335320672,307535741
29379058_2661620,CM021103.1,4,29379058,332659054,2700008,2661620,335320674,307535743
29379058_2661631,CM021103.1,4,29379058,332659054,2700008,2661631,335320685,307535754
29379058_2661651,CM021103.1,4,29379058,332659054,2700008,2661651,335320705,307535774
29379058_2661658,CM021103.1,4,29379058,332659054,2700008,2661658,335320712,307535781
29379058_2661662,CM021103.1,4,29379058,332659054,2700008,2661662,335320716,307535785
29379058_2661677,CM021103.1,4,29379058,332659054,2700008,2661677,335320731,307535800
29379771_2703099,CM021103.1,4,29379771,332659054,4992802,2703099,335362153,307577222
29379771_2703136,CM021103.1,4,29379771,332659054,4992802,2703136,335362190,307577259
29379771_2809931,CM021103.1,4,29379771,332659054,4992802,2809931,335468985,307684054
29381872_2867345,CM021103.1,4,29381872,332659054,4702406,2867345,335526399,307741468
29381872_2867372,CM021103.1,4,29381872,332659054,4702406,2867372,335526426,307741495
29381872_2867451,CM021103.1,4,29381872,332659054,4702406,2867451,335526505,307741574
29381872_2867485,CM021103.1,4,29381872,332659054,4702406,2867485,335526539,307741608
29380411_2900911,CM021103.1,4,29380411,332659654,4855072,2900911,335560565,307775634
29380411_2900958,CM021103.1,4,29380411,332659654,4855072,2900958,335560612,307775681
29380411_2913464,CM021103.1,4,29380411,332659654,4855072,2913464,335573118,307788187
29380411_2913541,CM021103.1,4,29380411,332659654,4855072,2913541,335573195,307788264
29380411_2913543,CM021103.1,4,29380411,332659654,4855072,2913543,335573197,307788266
29380411_2913609,CM021103.1,4,29380411,332659654,4855072,2913609,335573263,307788332
29380411_2913649,CM021103.1,4,29380411,332659654,4855072,2913649,335573303,307788372
29380783_3034521,CM021103.1,4,29380783,332659055,4499433,3034521,335693576,307908645
29380411_3271933,CM021103.1,4,29380411,332659654,4855072,3271933,335931587,308146656
29380411_3312047,CM021103.1,4,29380411,332659654,4855072,3312047,335971701,308186770
29380411_3312073,CM021103.1,4,29380411,332659654,4855072,3312073,335971727,308186796
29379451_1043763,CM021103.1,4,29379451,335083537,1142814,1043763,336127300,308342369
29379451_1043764,CM021103.1,4,29379451,335083537,1142814,1043764,336127301,308342370
29379451_1043768,CM021103.1,4,29379451,335083537,1142814,1043768,336127305,308342374
29379451_1043781,CM021103.1,4,29379451,335083537,1142814,1043781,336127318,308342387
29379451_1043785,CM021103.1,4,29379451,335083537,1142814,1043785,336127322,308342391
29379451_1043788,CM021103.1,4,29379451,335083537,1142814,1043788,336127325,308342394
29379451_1043808,CM021103.1,4,29379451,335083537,1142814,1043808,336127345,308342414
29379451_1043829,CM021103.1,4,29379451,335083537,1142814,1043829,336127366,308342435
29379451_1043855,CM021103.1,4,29379451,335083537,1142814,1043855,336127392,308342461
29380783_3724610,CM021103.1,4,29380783,332659055,4499433,3724610,336383665,308598734
29380783_3724877,CM021103.1,4,29380783,332659055,4499433,3724877,336383932,308599001
29379771_4335986,CM021103.1,4,29379771,332659054,4992802,4335986,336995040,309210109
29379771_4336432,CM021103.1,4,29379771,332659054,4992802,4336432,336995486,309210555
29379771_4339493,CM021103.1,4,29379771,332659054,4992802,4339493,336998547,309213616
29340426_25469,CM021103.1,4,29340426,340478421,26716,25469,340503890,312718959
29340426_25672,CM021103.1,4,29340426,340478421,26716,25672,340504093,312719162
29344240_4489,CM021103.1,4,29344240,341791030,22320,4489,341795519,314010588
29377727_951,CM021103.1,4,29377727,344540248,1037656,951,344541199,316756268
29381829_16263,CM021103.1,4,29381829,344538949,4016336,16263,344555212,316770281
29381829_16286,CM021103.1,4,29381829,344538949,4016336,16286,344555235,316770304
29334714_12152,CM021103.1,4,29334714,344543095,37684,12152,344555247,316770316
29334714_12160,CM021103.1,4,29334714,344543095,37684,12160,344555255,316770324
29381829_16341,CM021103.1,4,29381829,344538949,4016336,16341,344555290,316770359
29334714_12212,CM021103.1,4,29334714,344543095,37684,12212,344555307,316770376
29334714_12230,CM021103.1,4,29334714,344543095,37684,12230,344555325,316770394
29334714_12279,CM021103.1,4,29334714,344543095,37684,12279,344555374,316770443
29334714_12301,CM021103.1,4,29334714,344543095,37684,12301,344555396,316770465
29381829_16454,CM021103.1,4,29381829,344538949,4016336,16454,344555403,316770472
29334714_12321,CM021103.1,4,29334714,344543095,37684,12321,344555416,316770485
29334714_12338,CM021103.1,4,29334714,344543095,37684,12338,344555433,316770502
29334714_12397,CM021103.1,4,29334714,344543095,37684,12397,344555492,316770561
29334714_12438,CM021103.1,4,29334714,344543095,37684,12438,344555533,316770602
29334714_12460,CM021103.1,4,29334714,344543095,37684,12460,344555555,316770624
29334714_12461,CM021103.1,4,29334714,344543095,37684,12461,344555556,316770625
29334714_12470,CM021103.1,4,29334714,344543095,37684,12470,344555565,316770634
29334714_12478,CM021103.1,4,29334714,344543095,37684,12478,344555573,316770642
29334714_12495,CM021103.1,4,29334714,344543095,37684,12495,344555590,316770659
29334714_12510,CM021103.1,4,29334714,344543095,37684,12510,344555605,316770674
29382300_25570,CM021103.1,4,29382300,344537412,2101541,25570,344562982,316778051
29382300_25589,CM021103.1,4,29382300,344537412,2101541,25589,344563001,316778070
29382300_25603,CM021103.1,4,29382300,344537412,2101541,25603,344563015,316778084
29382300_25854,CM021103.1,4,29382300,344537412,2101541,25854,344563266,316778335
29382300_26465,CM021103.1,4,29382300,344537412,2101541,26465,344563877,316778946
29381707_63256,CM021103.1,4,29381707,344537412,405190,63256,344600668,316815737
29377018_66169,CM021103.1,4,29377018,344537409,5016891,66169,344603578,316818647
29376992_81867,CM021103.1,4,29376992,344541789,2184323,81867,344623656,316838725
29380546_108256,CM021103.1,4,29380546,344543110,1116280,108256,344651366,316866435
29380546_108268,CM021103.1,4,29380546,344543110,1116280,108268,344651378,316866447
29380546_108277,CM021103.1,4,29380546,344543110,1116280,108277,344651387,316866456
29380546_108278,CM021103.1,4,29380546,344543110,1116280,108278,344651388,316866457
29380546_108279,CM021103.1,4,29380546,344543110,1116280,108279,344651389,316866458
29380546_109653,CM021103.1,4,29380546,344543110,1116280,109653,344652763,316867832
29379119_121218,CM021103.1,4,29379119,344543925,130899,121218,344665143,316880212
29379119_121226,CM021103.1,4,29379119,344543925,130899,121226,344665151,316880220
29379119_121263,CM021103.1,4,29379119,344543925,130899,121263,344665188,316880257
29379119_121279,CM021103.1,4,29379119,344543925,130899,121279,344665204,316880273
29379119_121292,CM021103.1,4,29379119,344543925,130899,121292,344665217,316880286
29379119_121301,CM021103.1,4,29379119,344543925,130899,121301,344665226,316880295
29379119_121321,CM021103.1,4,29379119,344543925,130899,121321,344665246,316880315
29379119_121327,CM021103.1,4,29379119,344543925,130899,121327,344665252,316880321
29379119_121388,CM021103.1,4,29379119,344543925,130899,121388,344665313,316880382
29379119_121422,CM021103.1,4,29379119,344543925,130899,121422,344665347,316880416
29379119_121445,CM021103.1,4,29379119,344543925,130899,121445,344665370,316880439
29377341_163008,CM021103.1,4,29377341,344537412,2084877,163008,344700420,316915489
29377919_164866,CM021103.1,4,29377919,344537410,975621,164866,344702276,316917345
29382456_163688,CM021103.1,4,29382456,344538824,4720123,163688,344702512,316917581
29382456_163699,CM021103.1,4,29382456,344538824,4720123,163699,344702523,316917592
29382456_163781,CM021103.1,4,29382456,344538824,4720123,163781,344702605,316917674
29382456_163857,CM021103.1,4,29382456,344538824,4720123,163857,344702681,316917750
29377867_184188,CM021103.1,4,29377867,344537412,958600,184188,344721600,316936669
29377867_184231,CM021103.1,4,29377867,344537412,958600,184231,344721643,316936712
29377177_208918,CM021103.1,4,29377177,344537413,699042,208918,344746331,316961400
29379564_224714,CM021103.1,4,29379564,344538943,1331376,224714,344763657,316978726
29379564_224737,CM021103.1,4,29379564,344538943,1331376,224737,344763680,316978749
29379564_224746,CM021103.1,4,29379564,344538943,1331376,224746,344763689,316978758
29379564_224850,CM021103.1,4,29379564,344538943,1331376,224850,344763793,316978862
29381504_232228,CM021103.1,4,29381504,344539687,4078884,232228,344771915,316986984
29381504_232284,CM021103.1,4,29381504,344539687,4078884,232284,344771971,316987040
29380684_238570,CM021103.1,4,29380684,344537415,2723420,238570,344775985,316991054
29380684_259876,CM021103.1,4,29380684,344537415,2723420,259876,344797291,317012360
29377973_294967,CM021103.1,4,29377973,344537412,1527314,294967,344832379,317047448
29377973_295050,CM021103.1,4,29377973,344537412,1527314,295050,344832462,317047531
29377177_311443,CM021103.1,4,29377177,344537413,699042,311443,344848856,317063925
29377605_327404,CM021103.1,4,29377605,344537412,699105,327404,344864816,317079885
29377605_327441,CM021103.1,4,29377605,344537412,699105,327441,344864853,317079922
29377605_327483,CM021103.1,4,29377605,344537412,699105,327483,344864895,317079964
29377605_327942,CM021103.1,4,29377605,344537412,699105,327942,344865354,317080423
29377605_328064,CM021103.1,4,29377605,344537412,699105,328064,344865476,317080545
29377605_331135,CM021103.1,4,29377605,344537412,699105,331135,344868547,317083616
29377605_331148,CM021103.1,4,29377605,344537412,699105,331148,344868560,317083629
29377605_331187,CM021103.1,4,29377605,344537412,699105,331187,344868599,317083668
29377605_331211,CM021103.1,4,29377605,344537412,699105,331211,344868623,317083692
29377605_331216,CM021103.1,4,29377605,344537412,699105,331216,344868628,317083697
29377605_331228,CM021103.1,4,29377605,344537412,699105,331228,344868640,317083709
29382481_406133,CM021103.1,4,29382481,344537413,1785280,406133,344943546,317158615
29377973_430199,CM021103.1,4,29377973,344537412,1527314,430199,344967611,317182680
29377973_430251,CM021103.1,4,29377973,344537412,1527314,430251,344967663,317182732
29379120_443461,CM021103.1,4,29379120,344537411,3095592,443461,344980872,317195941
29379120_443471,CM021103.1,4,29379120,344537411,3095592,443471,344980882,317195951
29379120_443512,CM021103.1,4,29379120,344537411,3095592,443512,344980923,317195992
29380684_444570,CM021103.1,4,29380684,344537415,2723420,444570,344981985,317197054
29380684_444636,CM021103.1,4,29380684,344537415,2723420,444636,344982051,317197120
29380684_448387,CM021103.1,4,29380684,344537415,2723420,448387,344985802,317200871
29380684_448555,CM021103.1,4,29380684,344537415,2723420,448555,344985970,317201039
29377605_456976,CM021103.1,4,29377605,344537412,699105,456976,344994388,317209457
29380684_457416,CM021103.1,4,29380684,344537415,2723420,457416,344994831,317209900
29380684_457430,CM021103.1,4,29380684,344537415,2723420,457430,344994845,317209914
29382456_460584,CM021103.1,4,29382456,344538824,4720123,460584,344999408,317214477
29380499_502148,CM021103.1,4,29380499,344537412,1287688,502148,345039560,317254629
29380499_502203,CM021103.1,4,29380499,344537412,1287688,502203,345039615,317254684
29381716_505577,CM021103.1,4,29381716,344537485,3097805,505577,345043062,317258131
29381716_506041,CM021103.1,4,29381716,344537485,3097805,506041,345043526,317258595
29381716_506080,CM021103.1,4,29381716,344537485,3097805,506080,345043565,317258634
29380684_519561,CM021103.1,4,29380684,344537415,2723420,519561,345056976,317272045
29380684_519650,CM021103.1,4,29380684,344537415,2723420,519650,345057065,317272134
29377919_520283,CM021103.1,4,29377919,344537410,975621,520283,345057693,317272762
29380684_520364,CM021103.1,4,29380684,344537415,2723420,520364,345057779,317272848
29380684_520370,CM021103.1,4,29380684,344537415,2723420,520370,345057785,317272854
29380684_520412,CM021103.1,4,29380684,344537415,2723420,520412,345057827,317272896
29377727_518452,CM021103.1,4,29377727,344540248,1037656,518452,345058700,317273769
29377727_518453,CM021103.1,4,29377727,344540248,1037656,518453,345058701,317273770
29377867_532294,CM021103.1,4,29377867,344537412,958600,532294,345069706,317284775
29377867_532323,CM021103.1,4,29377867,344537412,958600,532323,345069735,317284804
29381504_542902,CM021103.1,4,29381504,344539687,4078884,542902,345082589,317297658
29381504_542924,CM021103.1,4,29381504,344539687,4078884,542924,345082611,317297680
29381504_542938,CM021103.1,4,29381504,344539687,4078884,542938,345082625,317297694
29381504_542996,CM021103.1,4,29381504,344539687,4078884,542996,345082683,317297752
29381504_543045,CM021103.1,4,29381504,344539687,4078884,543045,345082732,317297801
29379120_551997,CM021103.1,4,29379120,344537411,3095592,551997,345089408,317304477
29379120_552001,CM021103.1,4,29379120,344537411,3095592,552001,345089412,317304481
29380368_555401,CM021103.1,4,29380368,344541375,782155,555401,345096776,317311845
29380368_555402,CM021103.1,4,29380368,344541375,782155,555402,345096777,317311846
29380368_555470,CM021103.1,4,29380368,344541375,782155,555470,345096845,317311914
29378261_586573,CM021103.1,4,29378261,344537411,2783711,586573,345123984,317339053
29378261_586723,CM021103.1,4,29378261,344537411,2783711,586723,345124134,317339203
29378261_586739,CM021103.1,4,29378261,344537411,2783711,586739,345124150,317339219
29378261_586740,CM021103.1,4,29378261,344537411,2783711,586740,345124151,317339220
29379240_634959,CM021103.1,4,29379240,344540268,2090319,634959,345175227,317390296
29381297_665070,CM021103.1,4,29381297,344537411,2110467,665070,345202481,317417550
29381297_714989,CM021103.1,4,29381297,344537411,2110467,714989,345252400,317467469
29377867_720588,CM021103.1,4,29377867,344537412,958600,720588,345258000,317473069
29377867_720597,CM021103.1,4,29377867,344537412,958600,720597,345258009,317473078
29378135_722487,CM021103.1,4,29378135,344540976,3380549,722487,345263463,317478532
29380546_728579,CM021103.1,4,29380546,344543110,1116280,728579,345271689,317486758
29377867_737108,CM021103.1,4,29377867,344537412,958600,737108,345274520,317489589
29379564_736200,CM021103.1,4,29379564,344538943,1331376,736200,345275143,317490212
29379564_736263,CM021103.1,4,29379564,344538943,1331376,736263,345275206,317490275
29379564_736290,CM021103.1,4,29379564,344538943,1331376,736290,345275233,317490302
29379638_740345,CM021103.1,4,29379638,344540090,2467309,740345,345280435,317495504
29377867_750414,CM021103.1,4,29377867,344537412,958600,750414,345287826,317502895
29378261_771211,CM021103.1,4,29378261,344537411,2783711,771211,345308622,317523691
29376992_812223,CM021103.1,4,29376992,344541789,2184323,812223,345354012,317569081
29376992_812249,CM021103.1,4,29376992,344541789,2184323,812249,345354038,317569107
29376992_812371,CM021103.1,4,29376992,344541789,2184323,812371,345354160,317569229
29379120_832883,CM021103.1,4,29379120,344537411,3095592,832883,345370294,317585363
29379120_832918,CM021103.1,4,29379120,344537411,3095592,832918,345370329,317585398
29379120_832947,CM021103.1,4,29379120,344537411,3095592,832947,345370358,317585427
29379120_832993,CM021103.1,4,29379120,344537411,3095592,832993,345370404,317585473
29379120_833005,CM021103.1,4,29379120,344537411,3095592,833005,345370416,317585485
29379120_833009,CM021103.1,4,29379120,344537411,3095592,833009,345370420,317585489
29379120_833010,CM021103.1,4,29379120,344537411,3095592,833010,345370421,317585490
29382441_838761,CM021103.1,4,29382441,344537412,1448355,838761,345376173,317591242
29382441_838843,CM021103.1,4,29382441,344537412,1448355,838843,345376255,317591324
29377734_856382,CM021103.1,4,29377734,344540349,954371,856382,345396731,317611800
29377060_859948,CM021103.1,4,29377060,344537413,1923286,859948,345397361,317612430
29377872_860651,CM021103.1,4,29377872,344537411,1769731,860651,345398062,317613131
29377872_860696,CM021103.1,4,29377872,344537411,1769731,860696,345398107,317613176
29376992_874826,CM021103.1,4,29376992,344541789,2184323,874826,345416615,317631684
29376992_874828,CM021103.1,4,29376992,344541789,2184323,874828,345416617,317631686
29382481_879963,CM021103.1,4,29382481,344537413,1785280,879963,345417376,317632445
29379120_893338,CM021103.1,4,29379120,344537411,3095592,893338,345430749,317645818
29379120_893405,CM021103.1,4,29379120,344537411,3095592,893405,345430816,317645885
29379120_893458,CM021103.1,4,29379120,344537411,3095592,893458,345430869,317645938
29379120_893954,CM021103.1,4,29379120,344537411,3095592,893954,345431365,317646434
29379120_894000,CM021103.1,4,29379120,344537411,3095592,894000,345431411,317646480
29379120_894011,CM021103.1,4,29379120,344537411,3095592,894011,345431422,317646491
29377341_919703,CM021103.1,4,29377341,344537412,2084877,919703,345457115,317672184
29377341_919765,CM021103.1,4,29377341,344537412,2084877,919765,345457177,317672246
29381716_975331,CM021103.1,4,29381716,344537485,3097805,975331,345512816,317727885
29381716_976288,CM021103.1,4,29381716,344537485,3097805,976288,345513773,317728842
29377018_1015554,CM021103.1,4,29377018,344537409,5016891,1015554,345552963,317768032
29379120_1033565,CM021103.1,4,29379120,344537411,3095592,1033565,345570976,317786045
29379120_1033675,CM021103.1,4,29379120,344537411,3095592,1033675,345571086,317786155
29378135_1098645,CM021103.1,4,29378135,344540976,3380549,1098645,345639621,317854690
29378135_1098673,CM021103.1,4,29378135,344540976,3380549,1098673,345639649,317854718
29378135_1098686,CM021103.1,4,29378135,344540976,3380549,1098686,345639662,317854731
29378135_1098742,CM021103.1,4,29378135,344540976,3380549,1098742,345639718,317854787
29377084_1122512,CM021103.1,4,29377084,344537413,2799148,1122512,345659925,317874994
29377084_1122600,CM021103.1,4,29377084,344537413,2799148,1122600,345660013,317875082
29377084_1122686,CM021103.1,4,29377084,344537413,2799148,1122686,345660099,317875168
29377148_1143522,CM021103.1,4,29377148,344539370,1224201,1143522,345682892,317897961
29377148_1143558,CM021103.1,4,29377148,344539370,1224201,1143558,345682928,317897997
29377148_1143665,CM021103.1,4,29377148,344539370,1224201,1143665,345683035,317898104
29377148_1143678,CM021103.1,4,29377148,344539370,1224201,1143678,345683048,317898117
29377148_1143696,CM021103.1,4,29377148,344539370,1224201,1143696,345683066,317898135
29380684_1156364,CM021103.1,4,29380684,344537415,2723420,1156364,345693779,317908848
29379240_1153630,CM021103.1,4,29379240,344540268,2090319,1153630,345693898,317908967
29380684_1174635,CM021103.1,4,29380684,344537415,2723420,1174635,345712050,317927119
29380684_1174963,CM021103.1,4,29380684,344537415,2723420,1174963,345712378,317927447
29379240_1195970,CM021103.1,4,29379240,344540268,2090319,1195970,345736238,317951307
29382481_1212611,CM021103.1,4,29382481,344537413,1785280,1212611,345750024,317965093
29382481_1212687,CM021103.1,4,29382481,344537413,1785280,1212687,345750100,317965169
29379240_1229952,CM021103.1,4,29379240,344540268,2090319,1229952,345770220,317985289
29379240_1229967,CM021103.1,4,29379240,344540268,2090319,1229967,345770235,317985304
29379240_1230052,CM021103.1,4,29379240,344540268,2090319,1230052,345770320,317985389
29380696_1236546,CM021103.1,4,29380696,344537412,1448352,1236546,345773958,317989027
29379120_1241601,CM021103.1,4,29379120,344537411,3095592,1241601,345779012,317994081
29379120_1241608,CM021103.1,4,29379120,344537411,3095592,1241608,345779019,317994088
29379120_1241671,CM021103.1,4,29379120,344537411,3095592,1241671,345779082,317994151
29379120_1241959,CM021103.1,4,29379120,344537411,3095592,1241959,345779370,317994439
29379120_1243475,CM021103.1,4,29379120,344537411,3095592,1243475,345780886,317995955
29380696_1270081,CM021103.1,4,29380696,344537412,1448352,1270081,345807493,318022562
29378135_1271610,CM021103.1,4,29378135,344540976,3380549,1271610,345812586,318027655
29378135_1271696,CM021103.1,4,29378135,344540976,3380549,1271696,345812672,318027741
29378135_1271793,CM021103.1,4,29378135,344540976,3380549,1271793,345812769,318027838
29378135_1271904,CM021103.1,4,29378135,344540976,3380549,1271904,345812880,318027949
29378135_1276109,CM021103.1,4,29378135,344540976,3380549,1276109,345817085,318032154
29382300_1345845,CM021103.1,4,29382300,344537412,2101541,1345845,345883257,318098326
29382300_1345915,CM021103.1,4,29382300,344537412,2101541,1345915,345883327,318098396
29382300_1345961,CM021103.1,4,29382300,344537412,2101541,1345961,345883373,318098442
29382300_1345966,CM021103.1,4,29382300,344537412,2101541,1345966,345883378,318098447
29382300_1345977,CM021103.1,4,29382300,344537412,2101541,1345977,345883389,318098458
29376992_1350437,CM021103.1,4,29376992,344541789,2184323,1350437,345892226,318107295
29382441_1447554,CM021103.1,4,29382441,344537412,1448355,1447554,345984966,318200035
29377973_1489705,CM021103.1,4,29377973,344537412,1527314,1489705,346027117,318242186
29379120_1503994,CM021103.1,4,29379120,344537411,3095592,1503994,346041405,318256474
29377018_1553174,CM021103.1,4,29377018,344537409,5016891,1553174,346090583,318305652
29377018_1553236,CM021103.1,4,29377018,344537409,5016891,1553236,346090645,318305714
29377018_1553261,CM021103.1,4,29377018,344537409,5016891,1553261,346090670,318305739
29378135_1563357,CM021103.1,4,29378135,344540976,3380549,1563357,346104333,318319402
29378135_1563376,CM021103.1,4,29378135,344540976,3380549,1563376,346104352,318319421
29379240_1605039,CM021103.1,4,29379240,344540268,2090319,1605039,346145307,318360376
29377341_1667308,CM021103.1,4,29377341,344537412,2084877,1667308,346204720,318419789
29382456_1696114,CM021103.1,4,29382456,344538824,4720123,1696114,346234938,318450007
29382456_1696151,CM021103.1,4,29382456,344538824,4720123,1696151,346234975,318450044
29382456_1696209,CM021103.1,4,29382456,344538824,4720123,1696209,346235033,318450102
29382456_1709644,CM021103.1,4,29382456,344538824,4720123,1709644,346248468,318463537
29381592_1713993,CM021103.1,4,29381592,344537411,2269189,1713993,346251404,318466473
29377408_1717163,CM021103.1,4,29377408,344537412,4446727,1717163,346254575,318469644
29377408_1717178,CM021103.1,4,29377408,344537412,4446727,1717178,346254590,318469659
29379638_1730785,CM021103.1,4,29379638,344540090,2467309,1730785,346270875,318485944
29376992_1754707,CM021103.1,4,29376992,344541789,2184323,1754707,346296496,318511565
29376992_1754728,CM021103.1,4,29376992,344541789,2184323,1754728,346296517,318511586
29380684_1760780,CM021103.1,4,29380684,344537415,2723420,1760780,346298195,318513264
29380684_1772042,CM021103.1,4,29380684,344537415,2723420,1772042,346309457,318524526
29380684_1815077,CM021103.1,4,29380684,344537415,2723420,1815077,346352492,318567561
29380684_1815122,CM021103.1,4,29380684,344537415,2723420,1815122,346352537,318567606
29382300_1830155,CM021103.1,4,29382300,344537412,2101541,1830155,346367567,318582636
29382300_1830182,CM021103.1,4,29382300,344537412,2101541,1830182,346367594,318582663
29382300_1830257,CM021103.1,4,29382300,344537412,2101541,1830257,346367669,318582738
29382300_1832301,CM021103.1,4,29382300,344537412,2101541,1832301,346369713,318584782
29381297_1858255,CM021103.1,4,29381297,344537411,2110467,1858255,346395666,318610735
29381297_1858341,CM021103.1,4,29381297,344537411,2110467,1858341,346395752,318610821
29379240_1920983,CM021103.1,4,29379240,344540268,2090319,1920983,346461251,318676320
29381297_1994586,CM021103.1,4,29381297,344537411,2110467,1994586,346531997,318747066
29381297_1994663,CM021103.1,4,29381297,344537411,2110467,1994663,346532074,318747143
29381297_1994693,CM021103.1,4,29381297,344537411,2110467,1994693,346532104,318747173
29381297_2005807,CM021103.1,4,29381297,344537411,2110467,2005807,346543218,318758287
29378135_2004575,CM021103.1,4,29378135,344540976,3380549,2004575,346545551,318760620
29378135_2004581,CM021103.1,4,29378135,344540976,3380549,2004581,346545557,318760626
29378135_2006036,CM021103.1,4,29378135,344540976,3380549,2006036,346547012,318762081
29378135_2006053,CM021103.1,4,29378135,344540976,3380549,2006053,346547029,318762098
29378135_2006090,CM021103.1,4,29378135,344540976,3380549,2006090,346547066,318762135
29378135_2006110,CM021103.1,4,29378135,344540976,3380549,2006110,346547086,318762155
29377084_2014591,CM021103.1,4,29377084,344537413,2799148,2014591,346552004,318767073
29377084_2014594,CM021103.1,4,29377084,344537413,2799148,2014594,346552007,318767076
29377084_2014601,CM021103.1,4,29377084,344537413,2799148,2014601,346552014,318767083
29377084_2014618,CM021103.1,4,29377084,344537413,2799148,2014618,346552031,318767100
29377084_2014641,CM021103.1,4,29377084,344537413,2799148,2014641,346552054,318767123
29377084_2014668,CM021103.1,4,29377084,344537413,2799148,2014668,346552081,318767150
29377084_2014706,CM021103.1,4,29377084,344537413,2799148,2014706,346552119,318767188
29377084_2014760,CM021103.1,4,29377084,344537413,2799148,2014760,346552173,318767242
29377084_2014804,CM021103.1,4,29377084,344537413,2799148,2014804,346552217,318767286
29378261_2034155,CM021103.1,4,29378261,344537411,2783711,2034155,346571566,318786635
29378261_2036910,CM021103.1,4,29378261,344537411,2783711,2036910,346574321,318789390
29378135_2137111,CM021103.1,4,29378135,344540976,3380549,2137111,346678087,318893156
29381716_2162298,CM021103.1,4,29381716,344537485,3097805,2162298,346699783,318914852
29380684_2225646,CM021103.1,4,29380684,344537415,2723420,2225646,346763061,318978130
29377018_2227899,CM021103.1,4,29377018,344537409,5016891,2227899,346765308,318980377
29378261_2332165,CM021103.1,4,29378261,344537411,2783711,2332165,346869576,319084645
29378261_2332188,CM021103.1,4,29378261,344537411,2783711,2332188,346869599,319084668
29378261_2332204,CM021103.1,4,29378261,344537411,2783711,2332204,346869615,319084684
29378261_2332216,CM021103.1,4,29378261,344537411,2783711,2332216,346869627,319084696
29378261_2332266,CM021103.1,4,29378261,344537411,2783711,2332266,346869677,319084746
29378261_2332303,CM021103.1,4,29378261,344537411,2783711,2332303,346869714,319084783
29382456_2368033,CM021103.1,4,29382456,344538824,4720123,2368033,346906857,319121926
29382456_2368057,CM021103.1,4,29382456,344538824,4720123,2368057,346906881,319121950
29377018_2476835,CM021103.1,4,29377018,344537409,5016891,2476835,347014244,319229313
29380684_2585217,CM021103.1,4,29380684,344537415,2723420,2585217,347122632,319337701
29380684_2654683,CM021103.1,4,29380684,344537415,2723420,2654683,347192098,319407167
29380684_2656029,CM021103.1,4,29380684,344537415,2723420,2656029,347193444,319408513
29380684_2658753,CM021103.1,4,29380684,344537415,2723420,2658753,347196168,319411237
29380684_2658810,CM021103.1,4,29380684,344537415,2723420,2658810,347196225,319411294
29380684_2659009,CM021103.1,4,29380684,344537415,2723420,2659009,347196424,319411493
29380684_2659016,CM021103.1,4,29380684,344537415,2723420,2659016,347196431,319411500
29380684_2659373,CM021103.1,4,29380684,344537415,2723420,2659373,347196788,319411857
29380684_2661739,CM021103.1,4,29380684,344537415,2723420,2661739,347199154,319414223
29380684_2662204,CM021103.1,4,29380684,344537415,2723420,2662204,347199619,319414688
29377687_2672209,CM021103.1,4,29377687,344539854,5836285,2672209,347212063,319427132
29379120_2697844,CM021103.1,4,29379120,344537411,3095592,2697844,347235255,319450324
29379120_2697864,CM021103.1,4,29379120,344537411,3095592,2697864,347235275,319450344
29379120_2697872,CM021103.1,4,29379120,344537411,3095592,2697872,347235283,319450352
29379120_2697891,CM021103.1,4,29379120,344537411,3095592,2697891,347235302,319450371
29379120_2697929,CM021103.1,4,29379120,344537411,3095592,2697929,347235340,319450409
29379120_2697937,CM021103.1,4,29379120,344537411,3095592,2697937,347235348,319450417
29379120_2697943,CM021103.1,4,29379120,344537411,3095592,2697943,347235354,319450423
29379120_2697982,CM021103.1,4,29379120,344537411,3095592,2697982,347235393,319450462
29379120_2819744,CM021103.1,4,29379120,344537411,3095592,2819744,347357155,319572224
29379120_2819757,CM021103.1,4,29379120,344537411,3095592,2819757,347357168,319572237
29379120_2819765,CM021103.1,4,29379120,344537411,3095592,2819765,347357176,319572245
29379120_2819777,CM021103.1,4,29379120,344537411,3095592,2819777,347357188,319572257
29379120_2819778,CM021103.1,4,29379120,344537411,3095592,2819778,347357189,319572258
29379120_2819779,CM021103.1,4,29379120,344537411,3095592,2819779,347357190,319572259
29379120_2819783,CM021103.1,4,29379120,344537411,3095592,2819783,347357194,319572263
29379120_2819799,CM021103.1,4,29379120,344537411,3095592,2819799,347357210,319572279
29379120_2819814,CM021103.1,4,29379120,344537411,3095592,2819814,347357225,319572294
29379120_2819842,CM021103.1,4,29379120,344537411,3095592,2819842,347357253,319572322
29379120_2819845,CM021103.1,4,29379120,344537411,3095592,2819845,347357256,319572325
29379120_2819856,CM021103.1,4,29379120,344537411,3095592,2819856,347357267,319572336
29379120_2819864,CM021103.1,4,29379120,344537411,3095592,2819864,347357275,319572344
29379120_2819871,CM021103.1,4,29379120,344537411,3095592,2819871,347357282,319572351
29379120_2819877,CM021103.1,4,29379120,344537411,3095592,2819877,347357288,319572357
29379120_2819928,CM021103.1,4,29379120,344537411,3095592,2819928,347357339,319572408
29379120_2819957,CM021103.1,4,29379120,344537411,3095592,2819957,347357368,319572437
29379120_2819961,CM021103.1,4,29379120,344537411,3095592,2819961,347357372,319572441
29379120_2819973,CM021103.1,4,29379120,344537411,3095592,2819973,347357384,319572453
29379120_2819974,CM021103.1,4,29379120,344537411,3095592,2819974,347357385,319572454
29379120_2819980,CM021103.1,4,29379120,344537411,3095592,2819980,347357391,319572460
29379120_2819983,CM021103.1,4,29379120,344537411,3095592,2819983,347357394,319572463
29379120_2819994,CM021103.1,4,29379120,344537411,3095592,2819994,347357405,319572474
29379120_2819998,CM021103.1,4,29379120,344537411,3095592,2819998,347357409,319572478
29379120_3008485,CM021103.1,4,29379120,344537411,3095592,3008485,347545896,319760965
29379120_3008487,CM021103.1,4,29379120,344537411,3095592,3008487,347545898,319760967
29379120_3008488,CM021103.1,4,29379120,344537411,3095592,3008488,347545899,319760968
29379120_3008638,CM021103.1,4,29379120,344537411,3095592,3008638,347546049,319761118
29377687_3274733,CM021103.1,4,29377687,344539854,5836285,3274733,347814587,320029656
29382456_3435069,CM021103.1,4,29382456,344538824,4720123,3435069,347973893,320188962
29382456_3435128,CM021103.1,4,29382456,344538824,4720123,3435128,347973952,320189021
29382456_3435191,CM021103.1,4,29382456,344538824,4720123,3435191,347974015,320189084
29382456_3437270,CM021103.1,4,29382456,344538824,4720123,3437270,347976094,320191163
29382361_3796743,CM021103.1,4,29382361,344537412,3883077,3796743,348334155,320549224
29382361_3796792,CM021103.1,4,29382361,344537412,3883077,3796792,348334204,320549273
29382361_3796834,CM021103.1,4,29382361,344537412,3883077,3796834,348334246,320549315
29382361_3796850,CM021103.1,4,29382361,344537412,3883077,3796850,348334262,320549331
29382361_3796858,CM021103.1,4,29382361,344537412,3883077,3796858,348334270,320549339
29382361_3833784,CM021103.1,4,29382361,344537412,3883077,3833784,348371196,320586265
29377018_4234784,CM021103.1,4,29377018,344537409,5016891,4234784,348772193,320987262
29377018_4234864,CM021103.1,4,29377018,344537409,5016891,4234864,348772273,320987342
29377018_4359793,CM021103.1,4,29377018,344537409,5016891,4359793,348897202,321112271
29377018_4359840,CM021103.1,4,29377018,344537409,5016891,4359840,348897249,321112318
29377018_4386566,CM021103.1,4,29377018,344537409,5016891,4386566,348923975,321139044
29377018_4387126,CM021103.1,4,29377018,344537409,5016891,4387126,348924535,321139604
29377018_4387153,CM021103.1,4,29377018,344537409,5016891,4387153,348924562,321139631
29377018_4421166,CM021103.1,4,29377018,344537409,5016891,4421166,348958575,321173644
29377018_4421438,CM021103.1,4,29377018,344537409,5016891,4421438,348958847,321173916
29377687_4419929,CM021103.1,4,29377687,344539854,5836285,4419929,348959783,321174852
29377687_4419956,CM021103.1,4,29377687,344539854,5836285,4419956,348959810,321174879
29377687_4420058,CM021103.1,4,29377687,344539854,5836285,4420058,348959912,321174981
29377687_4495592,CM021103.1,4,29377687,344539854,5836285,4495592,349035446,321250515
29377687_4495597,CM021103.1,4,29377687,344539854,5836285,4495597,349035451,321250520
29377687_4495618,CM021103.1,4,29377687,344539854,5836285,4495618,349035472,321250541
29377687_4613522,CM021103.1,4,29377687,344539854,5836285,4613522,349153376,321368445
29377687_4872201,CM021103.1,4,29377687,344539854,5836285,4872201,349412055,321627124
29377687_4872285,CM021103.1,4,29377687,344539854,5836285,4872285,349412139,321627208
29377687_4872433,CM021103.1,4,29377687,344539854,5836285,4872433,349412287,321627356
29377687_4872496,CM021103.1,4,29377687,344539854,5836285,4872496,349412350,321627419
29377687_5741666,CM021103.1,4,29377687,344539854,5836285,5741666,350281520,322496589
29382092_30228,CM021103.1,4,29382092,350349079,2205124,30228,350379307,322594376
29382092_30295,CM021103.1,4,29382092,350349079,2205124,30295,350379374,322594443
29377247_84972,CM021103.1,4,29377247,350349079,1841525,84972,350434051,322649120
29377247_85143,CM021103.1,4,29377247,350349079,1841525,85143,350434222,322649291
29381646_97615,CM021103.1,4,29381646,350349078,7627625,97615,350446693,322661762
29377247_106632,CM021103.1,4,29377247,350349079,1841525,106632,350455711,322670780
29377247_144274,CM021103.1,4,29377247,350349079,1841525,144274,350493353,322708422
29379706_160487,CM021103.1,4,29379706,350349082,1226226,160487,350509569,322724638
29379650_325656,CM021103.1,4,29379650,350349080,3366678,325656,350674736,322889805
29380066_328827,CM021103.1,4,29380066,350350883,391994,328827,350679710,322894779
29380066_328833,CM021103.1,4,29380066,350350883,391994,328833,350679716,322894785
29380066_329035,CM021103.1,4,29380066,350350883,391994,329035,350679918,322894987
29380066_329058,CM021103.1,4,29380066,350350883,391994,329058,350679941,322895010
29380066_329102,CM021103.1,4,29380066,350350883,391994,329102,350679985,322895054
29380066_329111,CM021103.1,4,29380066,350350883,391994,329111,350679994,322895063
29381203_402191,CM021103.1,4,29381203,350349079,1204185,402191,350751270,322966339
29381203_402298,CM021103.1,4,29381203,350349079,1204185,402298,350751377,322966446
29381203_402377,CM021103.1,4,29381203,350349079,1204185,402377,350751456,322966525
29381203_402402,CM021103.1,4,29381203,350349079,1204185,402402,350751481,322966550
29381203_403837,CM021103.1,4,29381203,350349079,1204185,403837,350752916,322967985
29381646_486804,CM021103.1,4,29381646,350349078,7627625,486804,350835882,323050951
29352159_494892,CM021103.1,4,29352159,350351085,874132,494892,350845977,323061046
29352159_494899,CM021103.1,4,29352159,350351085,874132,494899,350845984,323061053
29352159_495057,CM021103.1,4,29352159,350351085,874132,495057,350846142,323061211
29352159_495070,CM021103.1,4,29352159,350351085,874132,495070,350846155,323061224
29352159_495084,CM021103.1,4,29352159,350351085,874132,495084,350846169,323061238
29382092_500364,CM021103.1,4,29382092,350349079,2205124,500364,350849443,323064512
29382092_500366,CM021103.1,4,29382092,350349079,2205124,500366,350849445,323064514
29382092_500612,CM021103.1,4,29382092,350349079,2205124,500612,350849691,323064760
29382092_500689,CM021103.1,4,29382092,350349079,2205124,500689,350849768,323064837
29382092_500797,CM021103.1,4,29382092,350349079,2205124,500797,350849876,323064945
29382092_508047,CM021103.1,4,29382092,350349079,2205124,508047,350857126,323072195
29382092_508078,CM021103.1,4,29382092,350349079,2205124,508078,350857157,323072226
29382092_604134,CM021103.1,4,29382092,350349079,2205124,604134,350953213,323168282
29380929_619373,CM021103.1,4,29380929,350349080,1508292,619373,350968453,323183522
29380929_619391,CM021103.1,4,29380929,350349080,1508292,619391,350968471,323183540
29377011_628105,CM021103.1,4,29377011,350349079,2132315,628105,350977184,323192253
29377247_644060,CM021103.1,4,29377247,350349079,1841525,644060,350993139,323208208
29381203_656468,CM021103.1,4,29381203,350349079,1204185,656468,351005547,323220616
29381203_656559,CM021103.1,4,29381203,350349079,1204185,656559,351005638,323220707
29377247_660675,CM021103.1,4,29377247,350349079,1841525,660675,351009754,323224823
29382092_665409,CM021103.1,4,29382092,350349079,2205124,665409,351014488,323229557
29381452_672454,CM021103.1,4,29381452,350349079,2105611,672454,351021533,323236602
29377247_725373,CM021103.1,4,29377247,350349079,1841525,725373,351074452,323289521
29377247_725397,CM021103.1,4,29377247,350349079,1841525,725397,351074476,323289545
29382092_767969,CM021103.1,4,29382092,350349079,2205124,767969,351117048,323332117
29382092_768040,CM021103.1,4,29382092,350349079,2205124,768040,351117119,323332188
29382092_768052,CM021103.1,4,29382092,350349079,2205124,768052,351117131,323332200
29382092_768345,CM021103.1,4,29382092,350349079,2205124,768345,351117424,323332493
29382092_768380,CM021103.1,4,29382092,350349079,2205124,768380,351117459,323332528
29382092_768426,CM021103.1,4,29382092,350349079,2205124,768426,351117505,323332574
29380929_776302,CM021103.1,4,29380929,350349080,1508292,776302,351125382,323340451
29380929_776387,CM021103.1,4,29380929,350349080,1508292,776387,351125467,323340536
29382092_780968,CM021103.1,4,29382092,350349079,2205124,780968,351130047,323345116
29380929_782367,CM021103.1,4,29380929,350349080,1508292,782367,351131447,323346516
29380929_782377,CM021103.1,4,29380929,350349080,1508292,782377,351131457,323346526
29380929_785387,CM021103.1,4,29380929,350349080,1508292,785387,351134467,323349536
29380929_786665,CM021103.1,4,29380929,350349080,1508292,786665,351135745,323350814
29380929_786672,CM021103.1,4,29380929,350349080,1508292,786672,351135752,323350821
29380929_786675,CM021103.1,4,29380929,350349080,1508292,786675,351135755,323350824
29380929_786765,CM021103.1,4,29380929,350349080,1508292,786765,351135845,323350914
29380929_786798,CM021103.1,4,29380929,350349080,1508292,786798,351135878,323350947
29380929_786801,CM021103.1,4,29380929,350349080,1508292,786801,351135881,323350950
29380929_786925,CM021103.1,4,29380929,350349080,1508292,786925,351136005,323351074
29380929_786957,CM021103.1,4,29380929,350349080,1508292,786957,351136037,323351106
29382092_792446,CM021103.1,4,29382092,350349079,2205124,792446,351141525,323356594
29382092_792816,CM021103.1,4,29382092,350349079,2205124,792816,351141895,323356964
29382092_792905,CM021103.1,4,29382092,350349079,2205124,792905,351141984,323357053
29382092_792927,CM021103.1,4,29382092,350349079,2205124,792927,351142006,323357075
29377247_807602,CM021103.1,4,29377247,350349079,1841525,807602,351156681,323371750
29377247_807621,CM021103.1,4,29377247,350349079,1841525,807621,351156700,323371769
29377087_812759,CM021103.1,4,29377087,350352505,1249182,812759,351165264,323380333
29379706_1004075,CM021103.1,4,29379706,350349082,1226226,1004075,351353157,323568226
29379706_1004088,CM021103.1,4,29379706,350349082,1226226,1004088,351353170,323568239
29379706_1004111,CM021103.1,4,29379706,350349082,1226226,1004111,351353193,323568262
29377247_1024381,CM021103.1,4,29377247,350349079,1841525,1024381,351373460,323588529
29377247_1024406,CM021103.1,4,29377247,350349079,1841525,1024406,351373485,323588554
29382092_1051625,CM021103.1,4,29382092,350349079,2205124,1051625,351400704,323615773
29382092_1051862,CM021103.1,4,29382092,350349079,2205124,1051862,351400941,323616010
29381452_1075669,CM021103.1,4,29381452,350349079,2105611,1075669,351424748,323639817
29382092_1082997,CM021103.1,4,29382092,350349079,2205124,1082997,351432076,323647145
29377247_1103612,CM021103.1,4,29377247,350349079,1841525,1103612,351452691,323667760
29381646_1367490,CM021103.1,4,29381646,350349078,7627625,1367490,351716568,323931637
29381646_1367510,CM021103.1,4,29381646,350349078,7627625,1367510,351716588,323931657
29381646_1367511,CM021103.1,4,29381646,350349078,7627625,1367511,351716589,323931658
29377969_1452476,CM021103.1,4,29377969,350349079,1490679,1452476,351801555,324016624
29382092_1672766,CM021103.1,4,29382092,350349079,2205124,1672766,352021845,324236914
29377247_1732617,CM021103.1,4,29377247,350349079,1841525,1732617,352081696,324296765
29382092_1803009,CM021103.1,4,29382092,350349079,2205124,1803009,352152088,324367157
29382092_1803118,CM021103.1,4,29382092,350349079,2205124,1803118,352152197,324367266
29382092_2009698,CM021103.1,4,29382092,350349079,2205124,2009698,352358777,324573846
29379650_2201152,CM021103.1,4,29379650,350349080,3366678,2201152,352550232,324765301
29379650_2201163,CM021103.1,4,29379650,350349080,3366678,2201163,352550243,324765312
29379650_2201234,CM021103.1,4,29379650,350349080,3366678,2201234,352550314,324765383
29367028_22132,CM021103.1,4,29367028,362827206,26319,22132,362849338,335064407
29378666_42030,CM021103.1,4,29378666,362825019,3223393,42030,362867049,335082118
29382107_44169,CM021103.1,4,29382107,362825016,1128182,44169,362869185,335084254
29382107_44174,CM021103.1,4,29382107,362825016,1128182,44174,362869190,335084259
29382107_44204,CM021103.1,4,29382107,362825016,1128182,44204,362869220,335084289
29378666_91480,CM021103.1,4,29378666,362825019,3223393,91480,362916499,335131568
29382107_98274,CM021103.1,4,29382107,362825016,1128182,98274,362923290,335138359
29377683_153894,CM021103.1,4,29377683,362825019,4296385,153894,362978913,335193982
29377683_153969,CM021103.1,4,29377683,362825019,4296385,153969,362978988,335194057
29377683_154004,CM021103.1,4,29377683,362825019,4296385,154004,362979023,335194092
29377683_154006,CM021103.1,4,29377683,362825019,4296385,154006,362979025,335194094
29377683_154068,CM021103.1,4,29377683,362825019,4296385,154068,362979087,335194156
29377683_154074,CM021103.1,4,29377683,362825019,4296385,154074,362979093,335194162
29377683_154076,CM021103.1,4,29377683,362825019,4296385,154076,362979095,335194164
29377683_154077,CM021103.1,4,29377683,362825019,4296385,154077,362979096,335194165
29377683_154136,CM021103.1,4,29377683,362825019,4296385,154136,362979155,335194224
29377683_154743,CM021103.1,4,29377683,362825019,4296385,154743,362979762,335194831
29378666_204721,CM021103.1,4,29378666,362825019,3223393,204721,363029740,335244809
29378666_224070,CM021103.1,4,29378666,362825019,3223393,224070,363049089,335264158
29378666_305036,CM021103.1,4,29378666,362825019,3223393,305036,363130055,335345124
29378666_305321,CM021103.1,4,29378666,362825019,3223393,305321,363130340,335345409
29378666_413661,CM021103.1,4,29378666,362825019,3223393,413661,363238680,335453749
29378874_518666,CM021103.1,4,29378874,362825022,3050794,518666,363343688,335558757
29378874_518687,CM021103.1,4,29378874,362825022,3050794,518687,363343709,335558778
29378874_518694,CM021103.1,4,29378874,362825022,3050794,518694,363343716,335558785
29378874_518710,CM021103.1,4,29378874,362825022,3050794,518710,363343732,335558801
29378874_518763,CM021103.1,4,29378874,362825022,3050794,518763,363343785,335558854
29377683_614339,CM021103.1,4,29377683,362825019,4296385,614339,363439358,335654427
29378874_701730,CM021103.1,4,29378874,362825022,3050794,701730,363526752,335741821
29378874_701766,CM021103.1,4,29378874,362825022,3050794,701766,363526788,335741857
29378874_701768,CM021103.1,4,29378874,362825022,3050794,701768,363526790,335741859
29378874_710073,CM021103.1,4,29378874,362825022,3050794,710073,363535095,335750164
29378874_710080,CM021103.1,4,29378874,362825022,3050794,710080,363535102,335750171
29378874_717823,CM021103.1,4,29378874,362825022,3050794,717823,363542845,335757914
29378874_717876,CM021103.1,4,29378874,362825022,3050794,717876,363542898,335757967
29378874_717928,CM021103.1,4,29378874,362825022,3050794,717928,363542950,335758019
29378874_718060,CM021103.1,4,29378874,362825022,3050794,718060,363543082,335758151
29378874_718090,CM021103.1,4,29378874,362825022,3050794,718090,363543112,335758181
29378276_727935,CM021103.1,4,29378276,362825020,4208145,727935,363552955,335768024
29378276_727941,CM021103.1,4,29378276,362825020,4208145,727941,363552961,335768030
29377683_924913,CM021103.1,4,29377683,362825019,4296385,924913,363749932,335965001
29380648_951554,CM021103.1,4,29380648,362828054,1288441,951554,363779608,335994677
29380648_951595,CM021103.1,4,29380648,362828054,1288441,951595,363779649,335994718
29378276_1022931,CM021103.1,4,29378276,362825020,4208145,1022931,363847951,336063020
29378666_1069200,CM021103.1,4,29378666,362825019,3223393,1069200,363894219,336109288
29378666_1071548,CM021103.1,4,29378666,362825019,3223393,1071548,363896567,336111636
29378276_1146128,CM021103.1,4,29378276,362825020,4208145,1146128,363971148,336186217
29380179_1154984,CM021103.1,4,29380179,362825019,2575781,1154984,363980003,336195072
29380179_1155106,CM021103.1,4,29380179,362825019,2575781,1155106,363980125,336195194
29378874_1321375,CM021103.1,4,29378874,362825022,3050794,1321375,364146397,336361466
29380179_1382932,CM021103.1,4,29380179,362825019,2575781,1382932,364207951,336423020
29380179_1382952,CM021103.1,4,29380179,362825019,2575781,1382952,364207971,336423040
29380179_1382976,CM021103.1,4,29380179,362825019,2575781,1382976,364207995,336423064
29380179_1382979,CM021103.1,4,29380179,362825019,2575781,1382979,364207998,336423067
29380179_1382985,CM021103.1,4,29380179,362825019,2575781,1382985,364208004,336423073
29380179_1382993,CM021103.1,4,29380179,362825019,2575781,1382993,364208012,336423081
29380179_1383005,CM021103.1,4,29380179,362825019,2575781,1383005,364208024,336423093
29380179_1383010,CM021103.1,4,29380179,362825019,2575781,1383010,364208029,336423098
29380179_1383015,CM021103.1,4,29380179,362825019,2575781,1383015,364208034,336423103
29380179_1383034,CM021103.1,4,29380179,362825019,2575781,1383034,364208053,336423122
29380179_1383042,CM021103.1,4,29380179,362825019,2575781,1383042,364208061,336423130
29380179_1383190,CM021103.1,4,29380179,362825019,2575781,1383190,364208209,336423278
29380179_1383199,CM021103.1,4,29380179,362825019,2575781,1383199,364208218,336423287
29380179_1384496,CM021103.1,4,29380179,362825019,2575781,1384496,364209515,336424584
29380179_1384534,CM021103.1,4,29380179,362825019,2575781,1384534,364209553,336424622
29380179_1384558,CM021103.1,4,29380179,362825019,2575781,1384558,364209577,336424646
29380179_1384579,CM021103.1,4,29380179,362825019,2575781,1384579,364209598,336424667
29380179_1495857,CM021103.1,4,29380179,362825019,2575781,1495857,364320876,336535945
29377683_1664286,CM021103.1,4,29377683,362825019,4296385,1664286,364489305,336704374
29377683_1664326,CM021103.1,4,29377683,362825019,4296385,1664326,364489345,336704414
29378874_1665107,CM021103.1,4,29378874,362825022,3050794,1665107,364490129,336705198
29380179_1710654,CM021103.1,4,29380179,362825019,2575781,1710654,364535673,336750742
29377683_1739742,CM021103.1,4,29377683,362825019,4296385,1739742,364564761,336779830
29377683_1739858,CM021103.1,4,29377683,362825019,4296385,1739858,364564877,336779946
29378874_1757693,CM021103.1,4,29378874,362825022,3050794,1757693,364582715,336797784
29378874_1806984,CM021103.1,4,29378874,362825022,3050794,1806984,364632006,336847075
29378276_1876155,CM021103.1,4,29378276,362825020,4208145,1876155,364701175,336916244
29380179_2147505,CM021103.1,4,29380179,362825019,2575781,2147505,364972524,337187593
29380179_2149651,CM021103.1,4,29380179,362825019,2575781,2149651,364974670,337189739
29377683_2290189,CM021103.1,4,29377683,362825019,4296385,2290189,365115208,337330277
29377683_2290264,CM021103.1,4,29377683,362825019,4296385,2290264,365115283,337330352
29377683_2290458,CM021103.1,4,29377683,362825019,4296385,2290458,365115477,337330546
29378666_2329604,CM021103.1,4,29378666,362825019,3223393,2329604,365154623,337369692
29378874_2633301,CM021103.1,4,29378874,362825022,3050794,2633301,365458323,337673392
29378874_2633333,CM021103.1,4,29378874,362825022,3050794,2633333,365458355,337673424
29378276_2902628,CM021103.1,4,29378276,362825020,4208145,2902628,365727648,337942717
29378666_2992269,CM021103.1,4,29378666,362825019,3223393,2992269,365817288,338032357
29378666_2992281,CM021103.1,4,29378666,362825019,3223393,2992281,365817300,338032369
29378666_2992297,CM021103.1,4,29378666,362825019,3223393,2992297,365817316,338032385
29377683_3046049,CM021103.1,4,29377683,362825019,4296385,3046049,365871068,338086137
29377683_3046121,CM021103.1,4,29377683,362825019,4296385,3046121,365871140,338086209
29378666_3222384,CM021103.1,4,29378666,362825019,3223393,3222384,366047403,338262472
29378666_3222451,CM021103.1,4,29378666,362825019,3223393,3222451,366047470,338262539
29378666_3222473,CM021103.1,4,29378666,362825019,3223393,3222473,366047492,338262561
29378666_3222501,CM021103.1,4,29378666,362825019,3223393,3222501,366047520,338262589
29378666_3222940,CM021103.1,4,29378666,362825019,3223393,3222940,366047959,338263028
29378666_3222955,CM021103.1,4,29378666,362825019,3223393,3222955,366047974,338263043
29378276_3228294,CM021103.1,4,29378276,362825020,4208145,3228294,366053314,338268383
29378276_3228617,CM021103.1,4,29378276,362825020,4208145,3228617,366053637,338268706
29378276_3386515,CM021103.1,4,29378276,362825020,4208145,3386515,366211535,338426604
29378276_3386549,CM021103.1,4,29378276,362825020,4208145,3386549,366211569,338426638
29378276_3482027,CM021103.1,4,29378276,362825020,4208145,3482027,366307047,338522116
29378276_3482150,CM021103.1,4,29378276,362825020,4208145,3482150,366307170,338522239
29378276_3482160,CM021103.1,4,29378276,362825020,4208145,3482160,366307180,338522249
29378276_3482188,CM021103.1,4,29378276,362825020,4208145,3482188,366307208,338522277
29378276_3482243,CM021103.1,4,29378276,362825020,4208145,3482243,366307263,338522332
29370702_8511,CM021103.1,4,29370702,371189054,14749,8511,371197565,343412634
29351962_84545,CM021103.1,4,29351962,383553628,148660,84545,383638173,355853242
29351962_84564,CM021103.1,4,29351962,383553628,148660,84564,383638192,355853261
29377069_117023,CM021103.1,4,29377069,383553628,242828,117023,383670651,355885720
29377069_117117,CM021103.1,4,29377069,383553628,242828,117117,383670745,355885814
29377069_117594,CM021103.1,4,29377069,383553628,242828,117594,383671222,355886291
29378231_397555,CM021103.1,4,29378231,383553629,1814480,397555,383951184,356166253
29378231_397613,CM021103.1,4,29378231,383553629,1814480,397613,383951242,356166311
29378231_716713,CM021103.1,4,29378231,383553629,1814480,716713,384270342,356485411
29378231_716716,CM021103.1,4,29378231,383553629,1814480,716716,384270345,356485414
29378231_716718,CM021103.1,4,29378231,383553629,1814480,716718,384270347,356485416
29378231_716734,CM021103.1,4,29378231,383553629,1814480,716734,384270363,356485432
29378231_716816,CM021103.1,4,29378231,383553629,1814480,716816,384270445,356485514
29378231_716853,CM021103.1,4,29378231,383553629,1814480,716853,384270482,356485551
29378231_751421,CM021103.1,4,29378231,383553629,1814480,751421,384305050,356520119
29378231_751524,CM021103.1,4,29378231,383553629,1814480,751524,384305153,356520222
29378231_751598,CM021103.1,4,29378231,383553629,1814480,751598,384305227,356520296
29378231_751637,CM021103.1,4,29378231,383553629,1814480,751637,384305266,356520335
29378231_849143,CM021103.1,4,29378231,383553629,1814480,849143,384402772,356617841
29378231_849234,CM021103.1,4,29378231,383553629,1814480,849234,384402863,356617932
29378231_849291,CM021103.1,4,29378231,383553629,1814480,849291,384402920,356617989
29378231_851452,CM021103.1,4,29378231,383553629,1814480,851452,384405081,356620150
29378231_905562,CM021103.1,4,29378231,383553629,1814480,905562,384459191,356674260
29343679_15499,CM021103.1,4,29343679,393955892,25803,15499,393971391,366186460
29343679_15530,CM021103.1,4,29343679,393955892,25803,15530,393971422,366186491
29380951_29957,CM021103.1,4,29380951,393955890,1551590,29957,393985847,366200916
29378581_75039,CM021103.1,4,29378581,393955895,2876780,75039,394030934,366246003
29381663_114617,CM021103.1,4,29381663,393955895,302721,114617,394070512,366285581
29381663_114656,CM021103.1,4,29381663,393955895,302721,114656,394070551,366285620
29381663_114665,CM021103.1,4,29381663,393955895,302721,114665,394070560,366285629
29381663_114667,CM021103.1,4,29381663,393955895,302721,114667,394070562,366285631
29379808_126869,CM021103.1,4,29379808,393955890,6306351,126869,394082759,366297828
29379808_126899,CM021103.1,4,29379808,393955890,6306351,126899,394082789,366297858
29378809_152810,CM021103.1,4,29378809,393957629,1298329,152810,394110439,366325508
29379808_156452,CM021103.1,4,29379808,393955890,6306351,156452,394112342,366327411
29379808_156511,CM021103.1,4,29379808,393955890,6306351,156511,394112401,366327470
29381361_185833,CM021103.1,4,29381361,393955892,332937,185833,394141725,366356794
29380449_197563,CM021103.1,4,29380449,393955891,4648876,197563,394153454,366368523
29379808_223389,CM021103.1,4,29379808,393955890,6306351,223389,394179279,366394348
29379808_223422,CM021103.1,4,29379808,393955890,6306351,223422,394179312,366394381
29379808_223474,CM021103.1,4,29379808,393955890,6306351,223474,394179364,366394433
29380834_247120,CM021103.1,4,29380834,393955892,654213,247120,394203012,366418081
29380951_304140,CM021103.1,4,29380951,393955890,1551590,304140,394260030,366475099
29380951_304162,CM021103.1,4,29380951,393955890,1551590,304162,394260052,366475121
29377805_347559,CM021103.1,4,29377805,393956997,2102103,347559,394304556,366519625
29377805_347659,CM021103.1,4,29377805,393956997,2102103,347659,394304656,366519725
29380951_375052,CM021103.1,4,29380951,393955890,1551590,375052,394330942,366546011
29380951_375059,CM021103.1,4,29380951,393955890,1551590,375059,394330949,366546018
29381655_378579,CM021103.1,4,29381655,393957936,1516652,378579,394336515,366551584
29381655_378644,CM021103.1,4,29381655,393957936,1516652,378644,394336580,366551649
29380951_421080,CM021103.1,4,29380951,393955890,1551590,421080,394376970,366592039
29380951_522693,CM021103.1,4,29380951,393955890,1551590,522693,394478583,366693652
29381484_633080,CM021103.1,4,29381484,393956995,939431,633080,394590075,366805144
29381484_633133,CM021103.1,4,29381484,393956995,939431,633133,394590128,366805197
29381484_633138,CM021103.1,4,29381484,393956995,939431,633138,394590133,366805202
29381484_633141,CM021103.1,4,29381484,393956995,939431,633141,394590136,366805205
29381484_633154,CM021103.1,4,29381484,393956995,939431,633154,394590149,366805218
29381484_633177,CM021103.1,4,29381484,393956995,939431,633177,394590172,366805241
29381484_633188,CM021103.1,4,29381484,393956995,939431,633188,394590183,366805252
29379400_637671,CM021103.1,4,29379400,393955892,1980942,637671,394593563,366808632
29380449_676146,CM021103.1,4,29380449,393955891,4648876,676146,394632037,366847106
29380449_676180,CM021103.1,4,29380449,393955891,4648876,676180,394632071,366847140
29380449_676201,CM021103.1,4,29380449,393955891,4648876,676201,394632092,366847161
29379808_692142,CM021103.1,4,29379808,393955890,6306351,692142,394648032,366863101
29379808_695548,CM021103.1,4,29379808,393955890,6306351,695548,394651438,366866507
29379808_695603,CM021103.1,4,29379808,393955890,6306351,695603,394651493,366866562
29381952_770118,CM021103.1,4,29381952,393955892,818310,770118,394726010,366941079
29381952_770194,CM021103.1,4,29381952,393955892,818310,770194,394726086,366941155
29381952_770229,CM021103.1,4,29381952,393955892,818310,770229,394726121,366941190
29381826_800969,CM021103.1,4,29381826,393955892,3019683,800969,394756861,366971930
29379808_810402,CM021103.1,4,29379808,393955890,6306351,810402,394766292,366981361
29379808_810407,CM021103.1,4,29379808,393955890,6306351,810407,394766297,366981366
29379808_810433,CM021103.1,4,29379808,393955890,6306351,810433,394766323,366981392
29380449_956142,CM021103.1,4,29380449,393955891,4648876,956142,394912033,367127102
29380449_956151,CM021103.1,4,29380449,393955891,4648876,956151,394912042,367127111
29380449_956218,CM021103.1,4,29380449,393955891,4648876,956218,394912109,367127178
29380951_969197,CM021103.1,4,29380951,393955890,1551590,969197,394925087,367140156
29379721_999396,CM021103.1,4,29379721,393955890,5146193,999396,394955286,367170355
29379721_999643,CM021103.1,4,29379721,393955890,5146193,999643,394955533,367170602
29381655_1112332,CM021103.1,4,29381655,393957936,1516652,1112332,395070268,367285337
29381655_1112355,CM021103.1,4,29381655,393957936,1516652,1112355,395070291,367285360
29381655_1112406,CM021103.1,4,29381655,393957936,1516652,1112406,395070342,367285411
29379808_1206946,CM021103.1,4,29379808,393955890,6306351,1206946,395162836,367377905
29379808_1206959,CM021103.1,4,29379808,393955890,6306351,1206959,395162849,367377918
29379808_1207030,CM021103.1,4,29379808,393955890,6306351,1207030,395162920,367377989
29379808_1207036,CM021103.1,4,29379808,393955890,6306351,1207036,395162926,367377995
29379808_1207060,CM021103.1,4,29379808,393955890,6306351,1207060,395162950,367378019
29379675_1256790,CM021103.1,4,29379675,393955895,1913329,1256790,395212685,367427754
29379675_1258746,CM021103.1,4,29379675,393955895,1913329,1258746,395214641,367429710
29379675_1259130,CM021103.1,4,29379675,393955895,1913329,1259130,395215025,367430094
29379675_1621861,CM021103.1,4,29379675,393955895,1913329,1621861,395577756,367792825
29379675_1623964,CM021103.1,4,29379675,393955895,1913329,1623964,395579859,367794928
29379675_1667444,CM021103.1,4,29379675,393955895,1913329,1667444,395623339,367838408
29379675_1667449,CM021103.1,4,29379675,393955895,1913329,1667449,395623344,367838413
29379675_1667962,CM021103.1,4,29379675,393955895,1913329,1667962,395623857,367838926
29379400_1811653,CM021103.1,4,29379400,393955892,1980942,1811653,395767545,367982614
29379400_1813231,CM021103.1,4,29379400,393955892,1980942,1813231,395769123,367984192
29379400_1813263,CM021103.1,4,29379400,393955892,1980942,1813263,395769155,367984224
29377805_1833964,CM021103.1,4,29377805,393956997,2102103,1833964,395790961,368006030
29377805_1833975,CM021103.1,4,29377805,393956997,2102103,1833975,395790972,368006041
29377805_1833990,CM021103.1,4,29377805,393956997,2102103,1833990,395790987,368006056
29379808_2129360,CM021103.1,4,29379808,393955890,6306351,2129360,396085250,368300319
29379808_2155719,CM021103.1,4,29379808,393955890,6306351,2155719,396111609,368326678
29378581_2193278,CM021103.1,4,29378581,393955895,2876780,2193278,396149173,368364242
29378581_2193499,CM021103.1,4,29378581,393955895,2876780,2193499,396149394,368364463
29378581_2209371,CM021103.1,4,29378581,393955895,2876780,2209371,396165266,368380335
29378581_2209718,CM021103.1,4,29378581,393955895,2876780,2209718,396165613,368380682
29378581_2209803,CM021103.1,4,29378581,393955895,2876780,2209803,396165698,368380767
29380449_2510055,CM021103.1,4,29380449,393955891,4648876,2510055,396465946,368681015
29380449_2596293,CM021103.1,4,29380449,393955891,4648876,2596293,396552184,368767253
29380449_2596353,CM021103.1,4,29380449,393955891,4648876,2596353,396552244,368767313
29380449_2646643,CM021103.1,4,29380449,393955891,4648876,2646643,396602534,368817603
29380449_2646645,CM021103.1,4,29380449,393955891,4648876,2646645,396602536,368817605
29380449_2646723,CM021103.1,4,29380449,393955891,4648876,2646723,396602614,368817683
29380449_2838160,CM021103.1,4,29380449,393955891,4648876,2838160,396794051,369009120
29380449_2838754,CM021103.1,4,29380449,393955891,4648876,2838754,396794645,369009714
29381826_2935491,CM021103.1,4,29381826,393955892,3019683,2935491,396891383,369106452
29380449_2953699,CM021103.1,4,29380449,393955891,4648876,2953699,396909590,369124659
29380449_2953770,CM021103.1,4,29380449,393955891,4648876,2953770,396909661,369124730
29380449_3019265,CM021103.1,4,29380449,393955891,4648876,3019265,396975156,369190225
29380449_3019294,CM021103.1,4,29380449,393955891,4648876,3019294,396975185,369190254
29380449_3019317,CM021103.1,4,29380449,393955891,4648876,3019317,396975208,369190277
29380449_3019318,CM021103.1,4,29380449,393955891,4648876,3019318,396975209,369190278
29380449_3019319,CM021103.1,4,29380449,393955891,4648876,3019319,396975210,369190279
29380449_3019504,CM021103.1,4,29380449,393955891,4648876,3019504,396975395,369190464
29380449_3054806,CM021103.1,4,29380449,393955891,4648876,3054806,397010697,369225766
29380449_3090220,CM021103.1,4,29380449,393955891,4648876,3090220,397046111,369261180
29380449_3090309,CM021103.1,4,29380449,393955891,4648876,3090309,397046200,369261269
29380449_3090382,CM021103.1,4,29380449,393955891,4648876,3090382,397046273,369261342
29380449_3137942,CM021103.1,4,29380449,393955891,4648876,3137942,397093833,369308902
29379808_3139728,CM021103.1,4,29379808,393955890,6306351,3139728,397095618,369310687
29379808_3140667,CM021103.1,4,29379808,393955890,6306351,3140667,397096557,369311626
29379808_3140758,CM021103.1,4,29379808,393955890,6306351,3140758,397096648,369311717
29379808_3140759,CM021103.1,4,29379808,393955890,6306351,3140759,397096649,369311718
29379808_3140763,CM021103.1,4,29379808,393955890,6306351,3140763,397096653,369311722
29379808_3140802,CM021103.1,4,29379808,393955890,6306351,3140802,397096692,369311761
29379808_3142409,CM021103.1,4,29379808,393955890,6306351,3142409,397098299,369313368
29380449_3368971,CM021103.1,4,29380449,393955891,4648876,3368971,397324862,369539931
29380449_3369029,CM021103.1,4,29380449,393955891,4648876,3369029,397324920,369539989
29380449_3369039,CM021103.1,4,29380449,393955891,4648876,3369039,397324930,369539999
29380449_3630517,CM021103.1,4,29380449,393955891,4648876,3630517,397586408,369801477
29380449_3630535,CM021103.1,4,29380449,393955891,4648876,3630535,397586426,369801495
29380449_3630536,CM021103.1,4,29380449,393955891,4648876,3630536,397586427,369801496
29380449_3630572,CM021103.1,4,29380449,393955891,4648876,3630572,397586463,369801532
29380449_3630578,CM021103.1,4,29380449,393955891,4648876,3630578,397586469,369801538
29380449_3638206,CM021103.1,4,29380449,393955891,4648876,3638206,397594097,369809166
29380449_3638213,CM021103.1,4,29380449,393955891,4648876,3638213,397594104,369809173
29379808_3810061,CM021103.1,4,29379808,393955890,6306351,3810061,397765951,369981020
29379808_4086664,CM021103.1,4,29379808,393955890,6306351,4086664,398042554,370257623
29379721_4711138,CM021103.1,4,29379721,393955890,5146193,4711138,398667028,370882097
29379808_5686541,CM021103.1,4,29379808,393955890,6306351,5686541,399642431,371857500
29379808_6175492,CM021103.1,4,29379808,393955890,6306351,6175492,400131382,372346451
29382468_90131,CM021103.1,4,29382468,415741117,1859861,90131,415831248,388046317
29382468_381823,CM021103.1,4,29382468,415741117,1859861,381823,416122940,388338009
29382468_435260,CM021103.1,4,29382468,415741117,1859861,435260,416176377,388391446
29382468_441928,CM021103.1,4,29382468,415741117,1859861,441928,416183045,388398114
29344437_11519,CM021103.1,4,29344437,417190037,40259,11519,417201556,389416625
29344437_11520,CM021103.1,4,29344437,417190037,40259,11520,417201557,389416626
29344437_11645,CM021103.1,4,29344437,417190037,40259,11645,417201682,389416751
29344437_16725,CM021103.1,4,29344437,417190037,40259,16725,417206762,389421831
29362647_20089,CM021103.1,4,29362647,417190036,197243,20089,417210125,389425194
29362647_21036,CM021103.1,4,29362647,417190036,197243,21036,417211072,389426141
29362647_95080,CM021103.1,4,29362647,417190036,197243,95080,417285116,389500185
29350596_133422,CM021103.1,4,29350596,417190037,630631,133422,417323459,389538528
29380937_192636,CM021103.1,4,29380937,417190028,2511608,192636,417382664,389597733
29378028_201003,CM021103.1,4,29378028,417190035,3767407,201003,417391038,389606107
29378028_201013,CM021103.1,4,29378028,417190035,3767407,201013,417391048,389606117
29378028_201073,CM021103.1,4,29378028,417190035,3767407,201073,417391108,389606177
29378028_201126,CM021103.1,4,29378028,417190035,3767407,201126,417391161,389606230
29382042_205195,CM021103.1,4,29382042,417190037,2872541,205195,417395232,389610301
29382042_205285,CM021103.1,4,29382042,417190037,2872541,205285,417395322,389610391
29382042_205604,CM021103.1,4,29382042,417190037,2872541,205604,417395641,389610710
29382042_205613,CM021103.1,4,29382042,417190037,2872541,205613,417395650,389610719
29378524_240233,CM021103.1,4,29378524,417190037,4923529,240233,417430270,389645339
29378524_240300,CM021103.1,4,29378524,417190037,4923529,240300,417430337,389645406
29382042_276485,CM021103.1,4,29382042,417190037,2872541,276485,417466522,389681591
29382042_276493,CM021103.1,4,29382042,417190037,2872541,276493,417466530,389681599
29382042_276514,CM021103.1,4,29382042,417190037,2872541,276514,417466551,389681620
29382042_346075,CM021103.1,4,29382042,417190037,2872541,346075,417536112,389751181
29380194_357175,CM021103.1,4,29380194,417190036,8381957,357175,417547211,389762280
29377811_376848,CM021103.1,4,29377811,417190040,1915734,376848,417566888,389781957
29377811_378836,CM021103.1,4,29377811,417190040,1915734,378836,417568876,389783945
29377811_383082,CM021103.1,4,29377811,417190040,1915734,383082,417573122,389788191
29377811_383242,CM021103.1,4,29377811,417190040,1915734,383242,417573282,389788351
29377811_383291,CM021103.1,4,29377811,417190040,1915734,383291,417573331,389788400
29377811_383365,CM021103.1,4,29377811,417190040,1915734,383365,417573405,389788474
29380194_414017,CM021103.1,4,29380194,417190036,8381957,414017,417604053,389819122
29380194_414065,CM021103.1,4,29380194,417190036,8381957,414065,417604101,389819170
29380194_414107,CM021103.1,4,29380194,417190036,8381957,414107,417604143,389819212
29380194_414163,CM021103.1,4,29380194,417190036,8381957,414163,417604199,389819268
29378524_488659,CM021103.1,4,29378524,417190037,4923529,488659,417678696,389893765
29378524_488668,CM021103.1,4,29378524,417190037,4923529,488668,417678705,389893774
29382042_727254,CM021103.1,4,29382042,417190037,2872541,727254,417917291,390132360
29382042_729635,CM021103.1,4,29382042,417190037,2872541,729635,417919672,390134741
29382042_729654,CM021103.1,4,29382042,417190037,2872541,729654,417919691,390134760
29382042_729657,CM021103.1,4,29382042,417190037,2872541,729657,417919694,390134763
29382042_729666,CM021103.1,4,29382042,417190037,2872541,729666,417919703,390134772
29382042_729670,CM021103.1,4,29382042,417190037,2872541,729670,417919707,390134776
29382042_729681,CM021103.1,4,29382042,417190037,2872541,729681,417919718,390134787
29382042_729693,CM021103.1,4,29382042,417190037,2872541,729693,417919730,390134799
29382042_729695,CM021103.1,4,29382042,417190037,2872541,729695,417919732,390134801
29380062_767327,CM021103.1,4,29380062,417190036,2538756,767327,417957363,390172432
29380062_769918,CM021103.1,4,29380062,417190036,2538756,769918,417959954,390175023
29380062_771812,CM021103.1,4,29380062,417190036,2538756,771812,417961848,390176917
29382042_833667,CM021103.1,4,29382042,417190037,2872541,833667,418023704,390238773
29378028_894321,CM021103.1,4,29378028,417190035,3767407,894321,418084356,390299425
29378028_894404,CM021103.1,4,29378028,417190035,3767407,894404,418084439,390299508
29378028_894517,CM021103.1,4,29378028,417190035,3767407,894517,418084552,390299621
29380194_915077,CM021103.1,4,29380194,417190036,8381957,915077,418105113,390320182
29378131_1006706,CM021103.1,4,29378131,417192335,5802733,1006706,418199041,390414110
29378131_1006775,CM021103.1,4,29378131,417192335,5802733,1006775,418199110,390414179
29378131_1007087,CM021103.1,4,29378131,417192335,5802733,1007087,418199422,390414491
29382042_1017565,CM021103.1,4,29382042,417190037,2872541,1017565,418207602,390422671
29378131_1022502,CM021103.1,4,29378131,417192335,5802733,1022502,418214837,390429906
29378131_1022537,CM021103.1,4,29378131,417192335,5802733,1022537,418214872,390429941
29382042_1098375,CM021103.1,4,29382042,417190037,2872541,1098375,418288412,390503481
29382042_1098399,CM021103.1,4,29382042,417190037,2872541,1098399,418288436,390503505
29380194_1170659,CM021103.1,4,29380194,417190036,8381957,1170659,418360695,390575764
29379503_1263565,CM021103.1,4,29379503,417192303,3509104,1263565,418455868,390670937
29379503_1263628,CM021103.1,4,29379503,417192303,3509104,1263628,418455931,390671000
29379503_1263669,CM021103.1,4,29379503,417192303,3509104,1263669,418455972,390671041
29378131_1296239,CM021103.1,4,29378131,417192335,5802733,1296239,418488574,390703643
29378131_1296279,CM021103.1,4,29378131,417192335,5802733,1296279,418488614,390703683
29378131_1298113,CM021103.1,4,29378131,417192335,5802733,1298113,418490448,390705517
29378131_1298128,CM021103.1,4,29378131,417192335,5802733,1298128,418490463,390705532
29378131_1298339,CM021103.1,4,29378131,417192335,5802733,1298339,418490674,390705743
29378131_1298748,CM021103.1,4,29378131,417192335,5802733,1298748,418491083,390706152
29378028_1354349,CM021103.1,4,29378028,417190035,3767407,1354349,418544384,390759453
29378028_1359119,CM021103.1,4,29378028,417190035,3767407,1359119,418549154,390764223
29378028_1359242,CM021103.1,4,29378028,417190035,3767407,1359242,418549277,390764346
29378028_1359357,CM021103.1,4,29378028,417190035,3767407,1359357,418549392,390764461
29378028_1359538,CM021103.1,4,29378028,417190035,3767407,1359538,418549573,390764642
29378028_1359679,CM021103.1,4,29378028,417190035,3767407,1359679,418549714,390764783
29380937_1464801,CM021103.1,4,29380937,417190028,2511608,1464801,418654829,390869898
29378524_1534106,CM021103.1,4,29378524,417190037,4923529,1534106,418724143,390939212
29378524_1534381,CM021103.1,4,29378524,417190037,4923529,1534381,418724418,390939487
29378524_1556005,CM021103.1,4,29378524,417190037,4923529,1556005,418746042,390961111
29378524_1556083,CM021103.1,4,29378524,417190037,4923529,1556083,418746120,390961189
29377811_1604163,CM021103.1,4,29377811,417190040,1915734,1604163,418794203,391009272
29377811_1605322,CM021103.1,4,29377811,417190040,1915734,1605322,418795362,391010431
29382042_1672992,CM021103.1,4,29382042,417190037,2872541,1672992,418863029,391078098
29382042_1676733,CM021103.1,4,29382042,417190037,2872541,1676733,418866770,391081839
29382042_1676817,CM021103.1,4,29382042,417190037,2872541,1676817,418866854,391081923
29382042_1676852,CM021103.1,4,29382042,417190037,2872541,1676852,418866889,391081958
29382042_1676863,CM021103.1,4,29382042,417190037,2872541,1676863,418866900,391081969
29382042_1676942,CM021103.1,4,29382042,417190037,2872541,1676942,418866979,391082048
29382042_1707139,CM021103.1,4,29382042,417190037,2872541,1707139,418897176,391112245
29377811_1770161,CM021103.1,4,29377811,417190040,1915734,1770161,418960201,391175270
29377256_1778728,CM021103.1,4,29377256,417190037,2044758,1778728,418968765,391183834
29377256_1782362,CM021103.1,4,29377256,417190037,2044758,1782362,418972399,391187468
29382042_1819531,CM021103.1,4,29382042,417190037,2872541,1819531,419009568,391224637
29378131_1879368,CM021103.1,4,29378131,417192335,5802733,1879368,419071703,391286772
29378131_1879417,CM021103.1,4,29378131,417192335,5802733,1879417,419071752,391286821
29378131_1879423,CM021103.1,4,29378131,417192335,5802733,1879423,419071758,391286827
29378131_1879496,CM021103.1,4,29378131,417192335,5802733,1879496,419071831,391286900
29378131_1879498,CM021103.1,4,29378131,417192335,5802733,1879498,419071833,391286902
29378131_1882711,CM021103.1,4,29378131,417192335,5802733,1882711,419075046,391290115
29378524_1934035,CM021103.1,4,29378524,417190037,4923529,1934035,419124072,391339141
29378524_1934496,CM021103.1,4,29378524,417190037,4923529,1934496,419124533,391339602
29380937_2198027,CM021103.1,4,29380937,417190028,2511608,2198027,419388055,391603124
29380937_2198039,CM021103.1,4,29380937,417190028,2511608,2198039,419388067,391603136
29380937_2201387,CM021103.1,4,29380937,417190028,2511608,2201387,419391415,391606484
29380937_2201439,CM021103.1,4,29380937,417190028,2511608,2201439,419391467,391606536
29380062_2368802,CM021103.1,4,29380062,417190036,2538756,2368802,419558838,391773907
29380937_2378647,CM021103.1,4,29380937,417190028,2511608,2378647,419568675,391783744
29380937_2378667,CM021103.1,4,29380937,417190028,2511608,2378667,419568695,391783764
29380937_2378694,CM021103.1,4,29380937,417190028,2511608,2378694,419568722,391783791
29380937_2378740,CM021103.1,4,29380937,417190028,2511608,2378740,419568768,391783837
29380062_2383844,CM021103.1,4,29380062,417190036,2538756,2383844,419573880,391788949
29380062_2384467,CM021103.1,4,29380062,417190036,2538756,2384467,419574503,391789572
29380062_2384545,CM021103.1,4,29380062,417190036,2538756,2384545,419574581,391789650
29382042_2653892,CM021103.1,4,29382042,417190037,2872541,2653892,419843929,392058998
29382042_2653944,CM021103.1,4,29382042,417190037,2872541,2653944,419843981,392059050
29382042_2713500,CM021103.1,4,29382042,417190037,2872541,2713500,419903537,392118606
29378131_2722253,CM021103.1,4,29378131,417192335,5802733,2722253,419914588,392129657
29378131_2723325,CM021103.1,4,29378131,417192335,5802733,2723325,419915660,392130729
29378028_2940299,CM021103.1,4,29378028,417190035,3767407,2940299,420130334,392345403
29378028_2940305,CM021103.1,4,29378028,417190035,3767407,2940305,420130340,392345409
29378028_2940314,CM021103.1,4,29378028,417190035,3767407,2940314,420130349,392345418
29378028_2940370,CM021103.1,4,29378028,417190035,3767407,2940370,420130405,392345474
29378028_2940383,CM021103.1,4,29378028,417190035,3767407,2940383,420130418,392345487
29378028_2940419,CM021103.1,4,29378028,417190035,3767407,2940419,420130454,392345523
29378028_2940424,CM021103.1,4,29378028,417190035,3767407,2940424,420130459,392345528
29378028_2940521,CM021103.1,4,29378028,417190035,3767407,2940521,420130556,392345625
29378131_3051707,CM021103.1,4,29378131,417192335,5802733,3051707,420244042,392459111
29378131_3051904,CM021103.1,4,29378131,417192335,5802733,3051904,420244239,392459308
29378028_3091525,CM021103.1,4,29378028,417190035,3767407,3091525,420281560,392496629
29380194_3150687,CM021103.1,4,29380194,417190036,8381957,3150687,420340723,392555792
29380194_3150733,CM021103.1,4,29380194,417190036,8381957,3150733,420340769,392555838
29380194_3150761,CM021103.1,4,29380194,417190036,8381957,3150761,420340797,392555866
29378131_3278786,CM021103.1,4,29378131,417192335,5802733,3278786,420471121,392686190
29378131_3279241,CM021103.1,4,29378131,417192335,5802733,3279241,420471576,392686645
29378028_3712101,CM021103.1,4,29378028,417190035,3767407,3712101,420902136,393117205
29378028_3712118,CM021103.1,4,29378028,417190035,3767407,3712118,420902153,393117222
29378028_3712159,CM021103.1,4,29378028,417190035,3767407,3712159,420902194,393117263
29378028_3712170,CM021103.1,4,29378028,417190035,3767407,3712170,420902205,393117274
29378028_3712201,CM021103.1,4,29378028,417190035,3767407,3712201,420902236,393117305
29378524_3735173,CM021103.1,4,29378524,417190037,4923529,3735173,420925210,393140279
29378524_3779359,CM021103.1,4,29378524,417190037,4923529,3779359,420969396,393184465
29378524_3779404,CM021103.1,4,29378524,417190037,4923529,3779404,420969441,393184510
29378524_3779423,CM021103.1,4,29378524,417190037,4923529,3779423,420969460,393184529
29378524_3791477,CM021103.1,4,29378524,417190037,4923529,3791477,420981514,393196583
29378524_3791483,CM021103.1,4,29378524,417190037,4923529,3791483,420981520,393196589
29378524_3911654,CM021103.1,4,29378524,417190037,4923529,3911654,421101691,393316760
29378524_3911677,CM021103.1,4,29378524,417190037,4923529,3911677,421101714,393316783
29378524_3911717,CM021103.1,4,29378524,417190037,4923529,3911717,421101754,393316823
29378524_3918965,CM021103.1,4,29378524,417190037,4923529,3918965,421109002,393324071
29378524_3957229,CM021103.1,4,29378524,417190037,4923529,3957229,421147266,393362335
29378524_3957331,CM021103.1,4,29378524,417190037,4923529,3957331,421147368,393362437
29378524_3957516,CM021103.1,4,29378524,417190037,4923529,3957516,421147553,393362622
29378131_4215744,CM021103.1,4,29378131,417192335,5802733,4215744,421408079,393623148
29378131_4215934,CM021103.1,4,29378131,417192335,5802733,4215934,421408269,393623338
29378131_4215946,CM021103.1,4,29378131,417192335,5802733,4215946,421408281,393623350
29378131_4216047,CM021103.1,4,29378131,417192335,5802733,4216047,421408382,393623451
29378524_4281977,CM021103.1,4,29378524,417190037,4923529,4281977,421472014,393687083
29378524_4282041,CM021103.1,4,29378524,417190037,4923529,4282041,421472078,393687147
29378524_4323078,CM021103.1,4,29378524,417190037,4923529,4323078,421513115,393728184
29378524_4323091,CM021103.1,4,29378524,417190037,4923529,4323091,421513128,393728197
29380194_4408606,CM021103.1,4,29380194,417190036,8381957,4408606,421598642,393813711
29380194_4408622,CM021103.1,4,29380194,417190036,8381957,4408622,421598658,393813727
29380194_4408624,CM021103.1,4,29380194,417190036,8381957,4408624,421598660,393813729
29380194_4408626,CM021103.1,4,29380194,417190036,8381957,4408626,421598662,393813731
29380194_4408628,CM021103.1,4,29380194,417190036,8381957,4408628,421598664,393813733
29380194_4408684,CM021103.1,4,29380194,417190036,8381957,4408684,421598720,393813789
29380194_4408720,CM021103.1,4,29380194,417190036,8381957,4408720,421598756,393813825
29380194_4408736,CM021103.1,4,29380194,417190036,8381957,4408736,421598772,393813841
29380194_4408738,CM021103.1,4,29380194,417190036,8381957,4408738,421598774,393813843
29380194_4408742,CM021103.1,4,29380194,417190036,8381957,4408742,421598778,393813847
29380194_4408743,CM021103.1,4,29380194,417190036,8381957,4408743,421598779,393813848
29380194_4408772,CM021103.1,4,29380194,417190036,8381957,4408772,421598808,393813877
29380194_4408775,CM021103.1,4,29380194,417190036,8381957,4408775,421598811,393813880
29378524_4690215,CM021103.1,4,29378524,417190037,4923529,4690215,421880252,394095321
29378524_4690271,CM021103.1,4,29378524,417190037,4923529,4690271,421880308,394095377
29378524_4721744,CM021103.1,4,29378524,417190037,4923529,4721744,421911781,394126850
29378524_4723486,CM021103.1,4,29378524,417190037,4923529,4723486,421913523,394128592
29378524_4870511,CM021103.1,4,29378524,417190037,4923529,4870511,422060548,394275617
29378131_5438493,CM021103.1,4,29378131,417192335,5802733,5438493,422630828,394845897
29378131_5439066,CM021103.1,4,29378131,417192335,5802733,5439066,422631401,394846470
29378131_5439084,CM021103.1,4,29378131,417192335,5802733,5439084,422631419,394846488
29378913_6021289,CM021103.1,4,29378913,417190036,8366297,6021289,423211325,395426394
29378913_6079056,CM021103.1,4,29378913,417190036,8366297,6079056,423269092,395484161
29380194_6589207,CM021103.1,4,29380194,417190036,8381957,6589207,423779243,395994312
29356690_16899,CM021103.1,4,29356690,424178690,45693,16899,424195589,396410658
29356690_16902,CM021103.1,4,29356690,424178690,45693,16902,424195592,396410661
29356690_16906,CM021103.1,4,29356690,424178690,45693,16906,424195596,396410665
29378913_7054955,CM021103.1,4,29378913,417190036,8366297,7054955,424244991,396460060
29378913_7055021,CM021103.1,4,29378913,417190036,8366297,7055021,424245057,396460126
29378913_7055026,CM021103.1,4,29378913,417190036,8366297,7055026,424245062,396460131
29360544_5944,CM021103.1,4,29360544,453573050,18701,5944,453578994,425794063
29360544_5947,CM021103.1,4,29360544,453573050,18701,5947,453578997,425794066
29360544_5959,CM021103.1,4,29360544,453573050,18701,5959,453579009,425794078
29378980_22761,CM021103.1,4,29378980,453573055,889678,22761,453595816,425810885
29378980_22816,CM021103.1,4,29378980,453573055,889678,22816,453595871,425810940
29382227_253279,CM021103.1,4,29382227,453573535,689560,253279,453826814,426041883
29382227_253288,CM021103.1,4,29382227,453573535,689560,253288,453826823,426041892
29382227_253294,CM021103.1,4,29382227,453573535,689560,253294,453826829,426041898
29382227_253310,CM021103.1,4,29382227,453573535,689560,253310,453826845,426041914
29382227_253311,CM021103.1,4,29382227,453573535,689560,253311,453826846,426041915
29382227_253313,CM021103.1,4,29382227,453573535,689560,253313,453826848,426041917
29382227_253318,CM021103.1,4,29382227,453573535,689560,253318,453826853,426041922
29382227_253340,CM021103.1,4,29382227,453573535,689560,253340,453826875,426041944
29382227_253364,CM021103.1,4,29382227,453573535,689560,253364,453826899,426041968
29382227_253369,CM021103.1,4,29382227,453573535,689560,253369,453826904,426041973
29382227_253376,CM021103.1,4,29382227,453573535,689560,253376,453826911,426041980
29382227_253383,CM021103.1,4,29382227,453573535,689560,253383,453826918,426041987
29382227_277338,CM021103.1,4,29382227,453573535,689560,277338,453850873,426065942
29382227_277394,CM021103.1,4,29382227,453573535,689560,277394,453850929,426065998
29382227_277404,CM021103.1,4,29382227,453573535,689560,277404,453850939,426066008
29382227_277424,CM021103.1,4,29382227,453573535,689560,277424,453850959,426066028
29382227_277452,CM021103.1,4,29382227,453573535,689560,277452,453850987,426066056
29378460_452334,CM021103.1,4,29378460,453573736,1735591,452334,454026070,426241139
29378460_452342,CM021103.1,4,29378460,453573736,1735591,452342,454026078,426241147
29378460_452456,CM021103.1,4,29378460,453573736,1735591,452456,454026192,426241261
29382227_662625,CM021103.1,4,29382227,453573535,689560,662625,454236160,426451229
29382227_662679,CM021103.1,4,29382227,453573535,689560,662679,454236214,426451283
29382227_662740,CM021103.1,4,29382227,453573535,689560,662740,454236275,426451344
29382227_662744,CM021103.1,4,29382227,453573535,689560,662744,454236279,426451348
29382227_662764,CM021103.1,4,29382227,453573535,689560,662764,454236299,426451368
29382227_662769,CM021103.1,4,29382227,453573535,689560,662769,454236304,426451373
29382227_662777,CM021103.1,4,29382227,453573535,689560,662777,454236312,426451381
29378466_663806,CM021103.1,4,29378466,453573649,1201714,663806,454237455,426452524
29378466_663869,CM021103.1,4,29378466,453573649,1201714,663869,454237518,426452587
29378466_665243,CM021103.1,4,29378466,453573649,1201714,665243,454238892,426453961
29378466_665252,CM021103.1,4,29378466,453573649,1201714,665252,454238901,426453970
29379062_666514,CM021103.1,4,29379062,453573055,774029,666514,454239569,426454638
29379062_666526,CM021103.1,4,29379062,453573055,774029,666526,454239581,426454650
29379062_666559,CM021103.1,4,29379062,453573055,774029,666559,454239614,426454683
29378466_667965,CM021103.1,4,29378466,453573649,1201714,667965,454241614,426456683
29378466_668087,CM021103.1,4,29378466,453573649,1201714,668087,454241736,426456805
29378460_692204,CM021103.1,4,29378460,453573736,1735591,692204,454265940,426481009
29378460_726072,CM021103.1,4,29378460,453573736,1735591,726072,454299808,426514877
29378460_726091,CM021103.1,4,29378460,453573736,1735591,726091,454299827,426514896
29378460_726141,CM021103.1,4,29378460,453573736,1735591,726141,454299877,426514946
29378460_726165,CM021103.1,4,29378460,453573736,1735591,726165,454299901,426514970
29378460_972344,CM021103.1,4,29378460,453573736,1735591,972344,454546080,426761149
29378460_972420,CM021103.1,4,29378460,453573736,1735591,972420,454546156,426761225
29378460_972422,CM021103.1,4,29378460,453573736,1735591,972422,454546158,426761227
29378460_972423,CM021103.1,4,29378460,453573736,1735591,972423,454546159,426761228
29378460_972440,CM021103.1,4,29378460,453573736,1735591,972440,454546176,426761245
29378460_972817,CM021103.1,4,29378460,453573736,1735591,972817,454546553,426761622
29378466_982018,CM021103.1,4,29378466,453573649,1201714,982018,454555667,426770736
29378466_1173694,CM021103.1,4,29378466,453573649,1201714,1173694,454747343,426962412
29378466_1173767,CM021103.1,4,29378466,453573649,1201714,1173767,454747416,426962485
29378466_1173784,CM021103.1,4,29378466,453573649,1201714,1173784,454747433,426962502
29378466_1173828,CM021103.1,4,29378466,453573649,1201714,1173828,454747477,426962546
29378460_1248371,CM021103.1,4,29378460,453573736,1735591,1248371,454822107,427037176
29378460_1248387,CM021103.1,4,29378460,453573736,1735591,1248387,454822123,427037192
29378460_1248399,CM021103.1,4,29378460,453573736,1735591,1248399,454822135,427037204
29378460_1338310,CM021103.1,4,29378460,453573736,1735591,1338310,454912046,427127115
29344537_833,CM021103.1,4,29344537,458891605,282694,833,458892438,431107507
29378296_157769,CM021103.1,4,29378296,458889634,276465,157769,459047403,431262472
29378296_157857,CM021103.1,4,29378296,458889634,276465,157857,459047491,431262560
29378296_191435,CM021103.1,4,29378296,458889634,276465,191435,459081069,431296138
29378815_370444,CM021103.1,4,29378815,458888881,577790,370444,459259325,431474394
29378815_430245,CM021103.1,4,29378815,458888881,577790,430245,459319126,431534195
29378379_1171173,CM021103.1,4,29378379,458888907,2618589,1171173,460060080,432275149
29378379_1171277,CM021103.1,4,29378379,458888907,2618589,1171277,460060184,432275253
29378379_1171289,CM021103.1,4,29378379,458888907,2618589,1171289,460060196,432275265
29379529_90409,CM021103.1,4,29379529,464747838,219737,90409,464838247,437053316
29379529_90424,CM021103.1,4,29379529,464747838,219737,90424,464838262,437053331
29379529_90453,CM021103.1,4,29379529,464747838,219737,90453,464838291,437053360
29379529_168129,CM021103.1,4,29379529,464747838,219737,168129,464915967,437131036
29380558_130253,CM021103.1,4,29380558,492683723,475341,130253,492813976,465029045
29342311_219660,CM021103.1,4,29342311,492683725,568816,219660,492903385,465118454
29342311_219723,CM021103.1,4,29342311,492683725,568816,219723,492903448,465118517
28421154_7989,CM021103.1,4,28421154,502541096,8518,7989,502549085,474764154
29379604_101200,CM021103.1,4,29379604,524681354,101802,101200,524782554,496997623
29379604_101215,CM021103.1,4,29379604,524681354,101802,101215,524782569,496997638
29360033_14475,CM021103.1,4,29360033,546357407,15435,14475,546371882,518586951
29355061_50634,CM021103.1,4,29355061,546357406,140532,50634,546408040,518623109
29355061_50669,CM021103.1,4,29355061,546357406,140532,50669,546408075,518623144
29355061_50675,CM021103.1,4,29355061,546357406,140532,50675,546408081,518623150
29355061_50690,CM021103.1,4,29355061,546357406,140532,50690,546408096,518623165
29380328_172939,CM021103.1,4,29380328,546357407,300355,172939,546530346,518745415
29379931_361344,CM021103.1,4,29379931,553089842,773016,361344,553451186,525666255
29379931_361363,CM021103.1,4,29379931,553089842,773016,361363,553451205,525666274
29379931_383022,CM021103.1,4,29379931,553089842,773016,383022,553472864,525687933
29379931_408430,CM021103.1,4,29379931,553089842,773016,408430,553498272,525713341
29379931_410167,CM021103.1,4,29379931,553089842,773016,410167,553500009,525715078
29379931_410224,CM021103.1,4,29379931,553089842,773016,410224,553500066,525715135
29379977_30209,CM021103.1,4,29379977,564006406,888690,30209,564036615,536251684
29379977_30212,CM021103.1,4,29379977,564006406,888690,30212,564036618,536251687
29379977_321258,CM021103.1,4,29379977,564006406,888690,321258,564327664,536542733
29379977_431465,CM021103.1,4,29379977,564006406,888690,431465,564437871,536652940
29379977_445421,CM021103.1,4,29379977,564006406,888690,445421,564451827,536666896
29379977_445502,CM021103.1,4,29379977,564006406,888690,445502,564451908,536666977
29379977_445516,CM021103.1,4,29379977,564006406,888690,445516,564451922,536666991
29373428_478898,CM021103.1,4,29373428,564006398,586005,478898,564485296,536700365
29381759_1542975,CM021103.1,4,29381759,564006406,1656430,1542975,565549381,537764450
29381759_1542985,CM021103.1,4,29381759,564006406,1656430,1542985,565549391,537764460
29381759_1543021,CM021103.1,4,29381759,564006406,1656430,1543021,565549427,537764496
29381759_1543034,CM021103.1,4,29381759,564006406,1656430,1543034,565549440,537764509
29381759_1543042,CM021103.1,4,29381759,564006406,1656430,1543042,565549448,537764517
29381759_1543055,CM021103.1,4,29381759,564006406,1656430,1543055,565549461,537764530
29381759_1543076,CM021103.1,4,29381759,564006406,1656430,1543076,565549482,537764551
29381759_1543090,CM021103.1,4,29381759,564006406,1656430,1543090,565549496,537764565
29381759_1543113,CM021103.1,4,29381759,564006406,1656430,1543113,565549519,537764588
29381759_1543114,CM021103.1,4,29381759,564006406,1656430,1543114,565549520,537764589
29379325_168512,CM021103.1,4,29379325,565456819,204982,168512,565625331,537840400
29379325_168520,CM021103.1,4,29379325,565456819,204982,168520,565625339,537840408
29377336_483894,CM021103.1,4,29377336,570966231,1433206,483894,571450125,543665194
29377336_483996,CM021103.1,4,29377336,570966231,1433206,483996,571450227,543665296
29377336_493927,CM021103.1,4,29377336,570966231,1433206,493927,571460158,543675227
29377336_580557,CM021103.1,4,29377336,570966231,1433206,580557,571546788,543761857
29377336_675458,CM021103.1,4,29377336,570966231,1433206,675458,571641689,543856758
29377336_1012617,CM021103.1,4,29377336,570966231,1433206,1012617,571978848,544193917
29377336_1012653,CM021103.1,4,29377336,570966231,1433206,1012653,571978884,544193953
29377336_1012880,CM021103.1,4,29377336,570966231,1433206,1012880,571979111,544194180
29377336_1012957,CM021103.1,4,29377336,570966231,1433206,1012957,571979188,544194257
29377336_1013984,CM021103.1,4,29377336,570966231,1433206,1013984,571980215,544195284
29377336_1056719,CM021103.1,4,29377336,570966231,1433206,1056719,572022950,544238019
29377336_1084369,CM021103.1,4,29377336,570966231,1433206,1084369,572050600,544265669
29377336_1084923,CM021103.1,4,29377336,570966231,1433206,1084923,572051154,544266223
29377336_1084952,CM021103.1,4,29377336,570966231,1433206,1084952,572051183,544266252
29377336_1376762,CM021103.1,4,29377336,570966231,1433206,1376762,572342993,544558062
29377843_136532,CM021103.1,4,29377843,592338949,516324,136532,592475481,564690550
29377843_136605,CM021103.1,4,29377843,592338949,516324,136605,592475554,564690623
29377843_447627,CM021103.1,4,29377843,592338949,516324,447627,592786576,565001645
29360585_3025,CM021103.1,4,29360585,603855294,20075,3025,603858319,576073388
29380550_241606,CM021103.1,4,29380550,603854378,399104,241606,604095984,576311053
29381828_125807,CM021103.1,4,29381828,615503986,298309,125807,615629793,587844862
29381828_125812,CM021103.1,4,29381828,615503986,298309,125812,615629798,587844867
29380272_188704,CM021103.1,4,29380272,615500422,618127,188704,615689126,587904195
29380605_267994,CM021103.1,4,29380605,615500426,352123,267994,615768420,587983489
29380272_432457,CM021103.1,4,29380272,615500422,618127,432457,615932879,588147948
29380272_432466,CM021103.1,4,29380272,615500422,618127,432466,615932888,588147957
29380272_432467,CM021103.1,4,29380272,615500422,618127,432467,615932889,588147958
29380272_432602,CM021103.1,4,29380272,615500422,618127,432602,615933024,588148093
29382143_466069,CM021103.1,4,29382143,615500419,1583022,466069,615966488,588181557
29382143_466135,CM021103.1,4,29382143,615500419,1583022,466135,615966554,588181623
29382244_510564,CM021103.1,4,29382244,615502895,5458338,510564,616013459,588228528
29382244_510590,CM021103.1,4,29382244,615502895,5458338,510590,616013485,588228554
29382244_510593,CM021103.1,4,29382244,615502895,5458338,510593,616013488,588228557
29382244_510606,CM021103.1,4,29382244,615502895,5458338,510606,616013501,588228570
29382244_510608,CM021103.1,4,29382244,615502895,5458338,510608,616013503,588228572
29382244_510663,CM021103.1,4,29382244,615502895,5458338,510663,616013558,588228627
29382244_510667,CM021103.1,4,29382244,615502895,5458338,510667,616013562,588228631
29382244_510770,CM021103.1,4,29382244,615502895,5458338,510770,616013665,588228734
29382244_510807,CM021103.1,4,29382244,615502895,5458338,510807,616013702,588228771
29382244_510843,CM021103.1,4,29382244,615502895,5458338,510843,616013738,588228807
29382244_510845,CM021103.1,4,29382244,615502895,5458338,510845,616013740,588228809
29379844_511749,CM021103.1,4,29379844,615504121,2597263,511749,616015870,588230939
29380272_576695,CM021103.1,4,29380272,615500422,618127,576695,616077117,588292186
29382143_599584,CM021103.1,4,29382143,615500419,1583022,599584,616100003,588315072
29382143_599618,CM021103.1,4,29382143,615500419,1583022,599618,616100037,588315106
29379483_696027,CM021103.1,4,29379483,615500426,1089493,696027,616196453,588411522
29382244_1157828,CM021103.1,4,29382244,615502895,5458338,1157828,616660723,588875792
29379765_1586098,CM021103.1,4,29379765,615500425,6001592,1586098,617086523,589301592
29382244_1734090,CM021103.1,4,29382244,615502895,5458338,1734090,617236985,589452054
29379765_2137186,CM021103.1,4,29379765,615500425,6001592,2137186,617637611,589852680
29379765_2148263,CM021103.1,4,29379765,615500425,6001592,2148263,617648688,589863757
29379765_2148375,CM021103.1,4,29379765,615500425,6001592,2148375,617648800,589863869
29379765_2148861,CM021103.1,4,29379765,615500425,6001592,2148861,617649286,589864355
29379765_2149491,CM021103.1,4,29379765,615500425,6001592,2149491,617649916,589864985
29379765_2151147,CM021103.1,4,29379765,615500425,6001592,2151147,617651572,589866641
29379765_2151154,CM021103.1,4,29379765,615500425,6001592,2151154,617651579,589866648
29379765_2469864,CM021103.1,4,29379765,615500425,6001592,2469864,617970289,590185358
29382244_2798527,CM021103.1,4,29382244,615502895,5458338,2798527,618301422,590516491
29382244_3299361,CM021103.1,4,29382244,615502895,5458338,3299361,618802256,591017325
29379765_3572460,CM021103.1,4,29379765,615500425,6001592,3572460,619072885,591287954
29379765_3576856,CM021103.1,4,29379765,615500425,6001592,3576856,619077281,591292350
29382244_3626256,CM021103.1,4,29382244,615502895,5458338,3626256,619129151,591344220
29382244_4164023,CM021103.1,4,29382244,615502895,5458338,4164023,619666918,591881987
29382244_4396851,CM021103.1,4,29382244,615502895,5458338,4396851,619899746,592114815
29382244_4419995,CM021103.1,4,29382244,615502895,5458338,4419995,619922890,592137959
29382244_4420587,CM021103.1,4,29382244,615502895,5458338,4420587,619923482,592138551
29382244_4420768,CM021103.1,4,29382244,615502895,5458338,4420768,619923663,592138732
29382244_4937998,CM021103.1,4,29382244,615502895,5458338,4937998,620440893,592655962
29382244_5328418,CM021103.1,4,29382244,615502895,5458338,5328418,620831313,593046382
29381729_1126116,CM021103.1,4,29381729,622313854,2582843,1126116,623439970,595655039
29381729_1126118,CM021103.1,4,29381729,622313854,2582843,1126118,623439972,595655041
29381729_1126156,CM021103.1,4,29381729,622313854,2582843,1126156,623440010,595655079
29378316_146707,CM021103.1,4,29378316,632842198,204417,146707,632988905,605203974
29379997_117706,CM021103.1,4,29379997,645845499,4804203,117706,645963205,618178274
29379997_117717,CM021103.1,4,29379997,645845499,4804203,117717,645963216,618178285
29379997_117726,CM021103.1,4,29379997,645845499,4804203,117726,645963225,618178294
29379997_117802,CM021103.1,4,29379997,645845499,4804203,117802,645963301,618178370
29377012_175201,CM021103.1,4,29377012,645852027,1102218,175201,646027228,618242297
29377012_175210,CM021103.1,4,29377012,645852027,1102218,175210,646027237,618242306
29377012_175233,CM021103.1,4,29377012,645852027,1102218,175233,646027260,618242329
29377012_175264,CM021103.1,4,29377012,645852027,1102218,175264,646027291,618242360
29377012_175279,CM021103.1,4,29377012,645852027,1102218,175279,646027306,618242375
29377012_175291,CM021103.1,4,29377012,645852027,1102218,175291,646027318,618242387
29377012_181163,CM021103.1,4,29377012,645852027,1102218,181163,646033190,618248259
29377012_181181,CM021103.1,4,29377012,645852027,1102218,181181,646033208,618248277
29377012_181216,CM021103.1,4,29377012,645852027,1102218,181216,646033243,618248312
29377012_181217,CM021103.1,4,29377012,645852027,1102218,181217,646033244,618248313
29377012_181222,CM021103.1,4,29377012,645852027,1102218,181222,646033249,618248318
29354740_220504,CM021103.1,4,29354740,645848674,273425,220504,646069178,618284247
29354740_220552,CM021103.1,4,29354740,645848674,273425,220552,646069226,618284295
29354740_220565,CM021103.1,4,29354740,645848674,273425,220565,646069239,618284308
29354740_220631,CM021103.1,4,29354740,645848674,273425,220631,646069305,618284374
29354740_220642,CM021103.1,4,29354740,645848674,273425,220642,646069316,618284385
29379918_272598,CM021103.1,4,29379918,645843611,2464570,272598,646116209,618331278
29379918_272604,CM021103.1,4,29379918,645843611,2464570,272604,646116215,618331284
29379918_287538,CM021103.1,4,29379918,645843611,2464570,287538,646131149,618346218
29379918_287607,CM021103.1,4,29379918,645843611,2464570,287607,646131218,618346287
29379918_288118,CM021103.1,4,29379918,645843611,2464570,288118,646131729,618346798
29377012_292550,CM021103.1,4,29377012,645852027,1102218,292550,646144577,618359646
29377012_293226,CM021103.1,4,29377012,645852027,1102218,293226,646145253,618360322
29382239_293501,CM021103.1,4,29382239,645851799,2705537,293501,646145300,618360369
29382239_353192,CM021103.1,4,29382239,645851799,2705537,353192,646204991,618420060
29382239_353242,CM021103.1,4,29382239,645851799,2705537,353242,646205041,618420110
29382239_353244,CM021103.1,4,29382239,645851799,2705537,353244,646205043,618420112
29378903_353716,CM021103.1,4,29378903,645851688,4554366,353716,646205404,618420473
29378903_353726,CM021103.1,4,29378903,645851688,4554366,353726,646205414,618420483
29378903_353740,CM021103.1,4,29378903,645851688,4554366,353740,646205428,618420497
29378903_353762,CM021103.1,4,29378903,645851688,4554366,353762,646205450,618420519
29378903_353764,CM021103.1,4,29378903,645851688,4554366,353764,646205452,618420521
29378903_353792,CM021103.1,4,29378903,645851688,4554366,353792,646205480,618420549
29378903_353802,CM021103.1,4,29378903,645851688,4554366,353802,646205490,618420559
29378903_353821,CM021103.1,4,29378903,645851688,4554366,353821,646205509,618420578
29378903_353943,CM021103.1,4,29378903,645851688,4554366,353943,646205631,618420700
29378903_353947,CM021103.1,4,29378903,645851688,4554366,353947,646205635,618420704
29378903_353985,CM021103.1,4,29378903,645851688,4554366,353985,646205673,618420742
29378903_354013,CM021103.1,4,29378903,645851688,4554366,354013,646205701,618420770
29378903_354048,CM021103.1,4,29378903,645851688,4554366,354048,646205736,618420805
29378903_354100,CM021103.1,4,29378903,645851688,4554366,354100,646205788,618420857
29378903_354113,CM021103.1,4,29378903,645851688,4554366,354113,646205801,618420870
29378903_354128,CM021103.1,4,29378903,645851688,4554366,354128,646205816,618420885
29378903_354135,CM021103.1,4,29378903,645851688,4554366,354135,646205823,618420892
29378903_354136,CM021103.1,4,29378903,645851688,4554366,354136,646205824,618420893
29378903_354141,CM021103.1,4,29378903,645851688,4554366,354141,646205829,618420898
29378903_354190,CM021103.1,4,29378903,645851688,4554366,354190,646205878,618420947
29378903_354202,CM021103.1,4,29378903,645851688,4554366,354202,646205890,618420959
29378903_354210,CM021103.1,4,29378903,645851688,4554366,354210,646205898,618420967
29378903_354231,CM021103.1,4,29378903,645851688,4554366,354231,646205919,618420988
29378903_354239,CM021103.1,4,29378903,645851688,4554366,354239,646205927,618420996
29379375_422375,CM021103.1,4,29379375,645843615,11900479,422375,646265990,618481059
29381114_420093,CM021103.1,4,29381114,645852159,2413551,420093,646272252,618487321
29381114_426009,CM021103.1,4,29381114,645852159,2413551,426009,646278168,618493237
29381114_426043,CM021103.1,4,29381114,645852159,2413551,426043,646278202,618493271
29382116_565328,CM021103.1,4,29382116,645843615,2040272,565328,646408943,618624012
29382116_565340,CM021103.1,4,29382116,645843615,2040272,565340,646408955,618624024
29379918_588578,CM021103.1,4,29379918,645843611,2464570,588578,646432189,618647258
29378770_638819,CM021103.1,4,29378770,645851766,1206693,638819,646490585,618705654
29377012_644945,CM021103.1,4,29377012,645852027,1102218,644945,646496972,618712041
29377012_646438,CM021103.1,4,29377012,645852027,1102218,646438,646498465,618713534
29377012_646501,CM021103.1,4,29377012,645852027,1102218,646501,646498528,618713597
29379918_659987,CM021103.1,4,29379918,645843611,2464570,659987,646503598,618718667
29379918_681761,CM021103.1,4,29379918,645843611,2464570,681761,646525372,618740441
29379918_681765,CM021103.1,4,29379918,645843611,2464570,681765,646525376,618740445
29379918_681859,CM021103.1,4,29379918,645843611,2464570,681859,646525470,618740539
29379918_712063,CM021103.1,4,29379918,645843611,2464570,712063,646555674,618770743
29380511_753381,CM021103.1,4,29380511,645843616,3249082,753381,646596997,618812066
29380511_753491,CM021103.1,4,29380511,645843616,3249082,753491,646597107,618812176
29381114_780456,CM021103.1,4,29381114,645852159,2413551,780456,646632615,618847684
29379997_811956,CM021103.1,4,29379997,645845499,4804203,811956,646657455,618872524
29381114_869256,CM021103.1,4,29381114,645852159,2413551,869256,646721415,618936484
29379997_894853,CM021103.1,4,29379997,645845499,4804203,894853,646740352,618955421
29379997_894854,CM021103.1,4,29379997,645845499,4804203,894854,646740353,618955422
29379997_894887,CM021103.1,4,29379997,645845499,4804203,894887,646740386,618955455
29379375_907339,CM021103.1,4,29379375,645843615,11900479,907339,646750954,618966023
29379375_907465,CM021103.1,4,29379375,645843615,11900479,907465,646751080,618966149
29380511_949955,CM021103.1,4,29380511,645843616,3249082,949955,646793571,619008640
29380511_950003,CM021103.1,4,29380511,645843616,3249082,950003,646793619,619008688
29380511_950056,CM021103.1,4,29380511,645843616,3249082,950056,646793672,619008741
29380511_950062,CM021103.1,4,29380511,645843616,3249082,950062,646793678,619008747
29380511_950066,CM021103.1,4,29380511,645843616,3249082,950066,646793682,619008751
29379997_949309,CM021103.1,4,29379997,645845499,4804203,949309,646794808,619009877
29379997_949332,CM021103.1,4,29379997,645845499,4804203,949332,646794831,619009900
29379997_949352,CM021103.1,4,29379997,645845499,4804203,949352,646794851,619009920
29378903_1058234,CM021103.1,4,29378903,645851688,4554366,1058234,646909922,619124991
29378903_1058468,CM021103.1,4,29378903,645851688,4554366,1058468,646910156,619125225
29378903_1063272,CM021103.1,4,29378903,645851688,4554366,1063272,646914960,619130029
29379304_1173428,CM021103.1,4,29379304,645853606,4477105,1173428,647027034,619242103
29380788_1234798,CM021103.1,4,29380788,645843611,2460662,1234798,647078409,619293478
29380788_1234822,CM021103.1,4,29380788,645843611,2460662,1234822,647078433,619293502
29380788_1234825,CM021103.1,4,29380788,645843611,2460662,1234825,647078436,619293505
29378903_1322474,CM021103.1,4,29378903,645851688,4554366,1322474,647174162,619389231
29378903_1322489,CM021103.1,4,29378903,645851688,4554366,1322489,647174177,619389246
29378903_1322552,CM021103.1,4,29378903,645851688,4554366,1322552,647174240,619389309
29378903_1322555,CM021103.1,4,29378903,645851688,4554366,1322555,647174243,619389312
29378903_1322581,CM021103.1,4,29378903,645851688,4554366,1322581,647174269,619389338
29378903_1322584,CM021103.1,4,29378903,645851688,4554366,1322584,647174272,619389341
29378903_1328064,CM021103.1,4,29378903,645851688,4554366,1328064,647179752,619394821
29378903_1328391,CM021103.1,4,29378903,645851688,4554366,1328391,647180079,619395148
29378903_1369220,CM021103.1,4,29378903,645851688,4554366,1369220,647220908,619435977
29380511_1382886,CM021103.1,4,29380511,645843616,3249082,1382886,647226502,619441571
29379997_1404232,CM021103.1,4,29379997,645845499,4804203,1404232,647249731,619464800
29379997_1404370,CM021103.1,4,29379997,645845499,4804203,1404370,647249869,619464938
29379997_1464882,CM021103.1,4,29379997,645845499,4804203,1464882,647310381,619525450
29379997_1465704,CM021103.1,4,29379997,645845499,4804203,1465704,647311203,619526272
29379997_1470147,CM021103.1,4,29379997,645845499,4804203,1470147,647315646,619530715
29379997_1470193,CM021103.1,4,29379997,645845499,4804203,1470193,647315692,619530761
29382239_1549250,CM021103.1,4,29382239,645851799,2705537,1549250,647401049,619616118
29382239_1549265,CM021103.1,4,29382239,645851799,2705537,1549265,647401064,619616133
29382239_1549310,CM021103.1,4,29382239,645851799,2705537,1549310,647401109,619616178
29382239_1549312,CM021103.1,4,29382239,645851799,2705537,1549312,647401111,619616180
29381114_1572915,CM021103.1,4,29381114,645852159,2413551,1572915,647425074,619640143
29379304_1582191,CM021103.1,4,29379304,645853606,4477105,1582191,647435797,619650866
29379304_1582211,CM021103.1,4,29379304,645853606,4477105,1582211,647435817,619650886
29381114_1591416,CM021103.1,4,29381114,645852159,2413551,1591416,647443575,619658644
29381114_1595518,CM021103.1,4,29381114,645852159,2413551,1595518,647447677,619662746
29379997_1639199,CM021103.1,4,29379997,645845499,4804203,1639199,647484698,619699767
29382116_1686681,CM021103.1,4,29382116,645843615,2040272,1686681,647530296,619745365
29382116_1686722,CM021103.1,4,29382116,645843615,2040272,1686722,647530337,619745406
29382116_1686863,CM021103.1,4,29382116,645843615,2040272,1686863,647530478,619745547
29382116_1688856,CM021103.1,4,29382116,645843615,2040272,1688856,647532471,619747540
29382116_1688889,CM021103.1,4,29382116,645843615,2040272,1688889,647532504,619747573
29379304_1680049,CM021103.1,4,29379304,645853606,4477105,1680049,647533655,619748724
29379304_1680059,CM021103.1,4,29379304,645853606,4477105,1680059,647533665,619748734
29379304_1680362,CM021103.1,4,29379304,645853606,4477105,1680362,647533968,619749037
29379304_1746174,CM021103.1,4,29379304,645853606,4477105,1746174,647599780,619814849
29380788_1772662,CM021103.1,4,29380788,645843611,2460662,1772662,647616273,619831342
29380788_1772725,CM021103.1,4,29380788,645843611,2460662,1772725,647616336,619831405
29380788_1772734,CM021103.1,4,29380788,645843611,2460662,1772734,647616345,619831414
29380788_1772757,CM021103.1,4,29380788,645843611,2460662,1772757,647616368,619831437
29380019_1765930,CM021103.1,4,29380019,645852123,2931653,1765930,647618053,619833122
29379997_1773472,CM021103.1,4,29379997,645845499,4804203,1773472,647618971,619834040
29379997_1773485,CM021103.1,4,29379997,645845499,4804203,1773485,647618984,619834053
29381857_1776710,CM021103.1,4,29381857,645843614,3300888,1776710,647620324,619835393
29380019_1768483,CM021103.1,4,29380019,645852123,2931653,1768483,647620606,619835675
29380511_1829632,CM021103.1,4,29380511,645843616,3249082,1829632,647673248,619888317
29379918_2007709,CM021103.1,4,29379918,645843611,2464570,2007709,647851320,620066389
29381857_2210058,CM021103.1,4,29381857,645843614,3300888,2210058,648053672,620268741
29381857_2210136,CM021103.1,4,29381857,645843614,3300888,2210136,648053750,620268819
29380511_2279886,CM021103.1,4,29380511,645843616,3249082,2279886,648123502,620338571
29380511_2279898,CM021103.1,4,29380511,645843616,3249082,2279898,648123514,620338583
29382239_2344770,CM021103.1,4,29382239,645851799,2705537,2344770,648196569,620411638
29378903_2415605,CM021103.1,4,29378903,645851688,4554366,2415605,648267293,620482362
29377187_2518031,CM021103.1,4,29377187,645843616,5376885,2518031,648361647,620576716
29377187_2518041,CM021103.1,4,29377187,645843616,5376885,2518041,648361657,620576726
29377187_2518081,CM021103.1,4,29377187,645843616,5376885,2518081,648361697,620576766
29377187_2518108,CM021103.1,4,29377187,645843616,5376885,2518108,648361724,620576793
29377187_2518113,CM021103.1,4,29377187,645843616,5376885,2518113,648361729,620576798
29382239_2638668,CM021103.1,4,29382239,645851799,2705537,2638668,648490467,620705536
29380019_2649058,CM021103.1,4,29380019,645852123,2931653,2649058,648501181,620716250
29380019_2649124,CM021103.1,4,29380019,645852123,2931653,2649124,648501247,620716316
29378903_2668397,CM021103.1,4,29378903,645851688,4554366,2668397,648520085,620735154
29381857_3143469,CM021103.1,4,29381857,645843614,3300888,3143469,648987083,621202152
29381857_3208274,CM021103.1,4,29381857,645843614,3300888,3208274,649051888,621266957
29381857_3208457,CM021103.1,4,29381857,645843614,3300888,3208457,649052071,621267140
29381857_3208573,CM021103.1,4,29381857,645843614,3300888,3208573,649052187,621267256
29379997_3324464,CM021103.1,4,29379997,645845499,4804203,3324464,649169963,621385032
29377187_3329480,CM021103.1,4,29377187,645843616,5376885,3329480,649173096,621388165
29379304_3325612,CM021103.1,4,29379304,645853606,4477105,3325612,649179218,621394287
29379304_3325650,CM021103.1,4,29379304,645853606,4477105,3325650,649179256,621394325
29377187_3666254,CM021103.1,4,29377187,645843616,5376885,3666254,649509870,621724939
29377187_3666259,CM021103.1,4,29377187,645843616,5376885,3666259,649509875,621724944
29377187_3666302,CM021103.1,4,29377187,645843616,5376885,3666302,649509918,621724987
29379997_3774877,CM021103.1,4,29379997,645845499,4804203,3774877,649620376,621835445
29378903_4005149,CM021103.1,4,29378903,645851688,4554366,4005149,649856837,622071906
29378903_4028438,CM021103.1,4,29378903,645851688,4554366,4028438,649880126,622095195
29378903_4050346,CM021103.1,4,29378903,645851688,4554366,4050346,649902034,622117103
29379997_4253333,CM021103.1,4,29379997,645845499,4804203,4253333,650098832,622313901
29379997_4253361,CM021103.1,4,29379997,645845499,4804203,4253361,650098860,622313929
29379375_8559920,CM021103.1,4,29379375,645843615,11900479,8559920,654403535,626618604
29379375_8612185,CM021103.1,4,29379375,645843615,11900479,8612185,654455800,626670869
29379375_8612277,CM021103.1,4,29379375,645843615,11900479,8612277,654455892,626670961
29379375_9269332,CM021103.1,4,29379375,645843615,11900479,9269332,655112947,627328016
29379375_9269335,CM021103.1,4,29379375,645843615,11900479,9269335,655112950,627328019
29379375_9269337,CM021103.1,4,29379375,645843615,11900479,9269337,655112952,627328021
29379375_9269349,CM021103.1,4,29379375,645843615,11900479,9269349,655112964,627328033
29379375_9269355,CM021103.1,4,29379375,645843615,11900479,9269355,655112970,627328039
29379375_9269388,CM021103.1,4,29379375,645843615,11900479,9269388,655113003,627328072
29379375_9269395,CM021103.1,4,29379375,645843615,11900479,9269395,655113010,627328079
29379375_9269417,CM021103.1,4,29379375,645843615,11900479,9269417,655113032,627328101
29379375_9269421,CM021103.1,4,29379375,645843615,11900479,9269421,655113036,627328105
29379375_9269427,CM021103.1,4,29379375,645843615,11900479,9269427,655113042,627328111
29379375_9269435,CM021103.1,4,29379375,645843615,11900479,9269435,655113050,627328119
29379375_9269437,CM021103.1,4,29379375,645843615,11900479,9269437,655113052,627328121
29379375_9276327,CM021103.1,4,29379375,645843615,11900479,9276327,655119942,627335011
29379375_9281673,CM021103.1,4,29379375,645843615,11900479,9281673,655125288,627340357
29379375_9281820,CM021103.1,4,29379375,645843615,11900479,9281820,655125435,627340504
29379375_9436098,CM021103.1,4,29379375,645843615,11900479,9436098,655279713,627494782
29379375_9436187,CM021103.1,4,29379375,645843615,11900479,9436187,655279802,627494871
29379375_11060807,CM021103.1,4,29379375,645843615,11900479,11060807,656904422,629119491
28541923_5072,CM021103.1,4,28541923,658814598,7715,5072,658819670,631034739
28541923_5077,CM021103.1,4,28541923,658814598,7715,5077,658819675,631034744
29382357_212091,CM021103.1,4,29382357,680721156,4885066,212091,680933247,653148316
29382357_212213,CM021103.1,4,29382357,680721156,4885066,212213,680933369,653148438
29382357_212233,CM021103.1,4,29382357,680721156,4885066,212233,680933389,653148458
29382357_212282,CM021103.1,4,29382357,680721156,4885066,212282,680933438,653148507
29377242_271700,CM021103.1,4,29377242,680723477,744450,271700,680995177,653210246
29377242_271738,CM021103.1,4,29377242,680723477,744450,271738,680995215,653210284
29381493_304251,CM021103.1,4,29381493,680721151,4071722,304251,681025402,653240471
29381493_304310,CM021103.1,4,29381493,680721151,4071722,304310,681025461,653240530
29379862_320474,CM021103.1,4,29379862,680721156,2303179,320474,681041630,653256699
29379862_320547,CM021103.1,4,29379862,680721156,2303179,320547,681041703,653256772
29379862_320608,CM021103.1,4,29379862,680721156,2303179,320608,681041764,653256833
29378173_364986,CM021103.1,4,29378173,680721414,2062160,364986,681086400,653301469
29378173_364987,CM021103.1,4,29378173,680721414,2062160,364987,681086401,653301470
29378173_364998,CM021103.1,4,29378173,680721414,2062160,364998,681086412,653301481
29381493_412990,CM021103.1,4,29381493,680721151,4071722,412990,681134141,653349210
29379862_419351,CM021103.1,4,29379862,680721156,2303179,419351,681140507,653355576
29377242_509622,CM021103.1,4,29377242,680723477,744450,509622,681233099,653448168
29377242_509656,CM021103.1,4,29377242,680723477,744450,509656,681233133,653448202
29377242_511514,CM021103.1,4,29377242,680723477,744450,511514,681234991,653450060
29377242_511615,CM021103.1,4,29377242,680723477,744450,511615,681235092,653450161
29382357_523416,CM021103.1,4,29382357,680721156,4885066,523416,681244572,653459641
29381554_737818,CM021103.1,4,29381554,680721879,2297396,737818,681459697,653674766
29381554_773967,CM021103.1,4,29381554,680721879,2297396,773967,681495846,653710915
29381554_773989,CM021103.1,4,29381554,680721879,2297396,773989,681495868,653710937
29381554_774061,CM021103.1,4,29381554,680721879,2297396,774061,681495940,653711009
29381554_774080,CM021103.1,4,29381554,680721879,2297396,774080,681495959,653711028
29382357_845633,CM021103.1,4,29382357,680721156,4885066,845633,681566789,653781858
29382357_845678,CM021103.1,4,29382357,680721156,4885066,845678,681566834,653781903
29381554_928711,CM021103.1,4,29381554,680721879,2297396,928711,681650590,653865659
29382357_1107326,CM021103.1,4,29382357,680721156,4885066,1107326,681828482,654043551
29378173_1419072,CM021103.1,4,29378173,680721414,2062160,1419072,682140486,654355555
29380719_1463153,CM021103.1,4,29380719,680721695,2475840,1463153,682184848,654399917
29380719_1463165,CM021103.1,4,29380719,680721695,2475840,1463165,682184860,654399929
29378173_1730295,CM021103.1,4,29378173,680721414,2062160,1730295,682451709,654666778
29380719_1856691,CM021103.1,4,29380719,680721695,2475840,1856691,682578386,654793455
29380719_1856733,CM021103.1,4,29380719,680721695,2475840,1856733,682578428,654793497
29380719_1856747,CM021103.1,4,29380719,680721695,2475840,1856747,682578442,654793511
29381493_1891014,CM021103.1,4,29381493,680721151,4071722,1891014,682612165,654827234
29379862_1940905,CM021103.1,4,29379862,680721156,2303179,1940905,682662061,654877130
29379862_1940966,CM021103.1,4,29379862,680721156,2303179,1940966,682662122,654877191
29379862_1941025,CM021103.1,4,29379862,680721156,2303179,1941025,682662181,654877250
29379862_1941058,CM021103.1,4,29379862,680721156,2303179,1941058,682662214,654877283
29381554_2028556,CM021103.1,4,29381554,680721879,2297396,2028556,682750435,654965504
29381554_2028577,CM021103.1,4,29381554,680721879,2297396,2028577,682750456,654965525
29381554_2028613,CM021103.1,4,29381554,680721879,2297396,2028613,682750492,654965561
29381554_2028673,CM021103.1,4,29381554,680721879,2297396,2028673,682750552,654965621
29381554_2028685,CM021103.1,4,29381554,680721879,2297396,2028685,682750564,654965633
29381554_2028728,CM021103.1,4,29381554,680721879,2297396,2028728,682750607,654965676
29381554_2028759,CM021103.1,4,29381554,680721879,2297396,2028759,682750638,654965707
29381554_2028760,CM021103.1,4,29381554,680721879,2297396,2028760,682750639,654965708
29381554_2028764,CM021103.1,4,29381554,680721879,2297396,2028764,682750643,654965712
29381554_2028825,CM021103.1,4,29381554,680721879,2297396,2028825,682750704,654965773
29381554_2028843,CM021103.1,4,29381554,680721879,2297396,2028843,682750722,654965791
29381554_2028911,CM021103.1,4,29381554,680721879,2297396,2028911,682750790,654965859
29381554_2028958,CM021103.1,4,29381554,680721879,2297396,2028958,682750837,654965906
29381554_2029089,CM021103.1,4,29381554,680721879,2297396,2029089,682750968,654966037
29381554_2037730,CM021103.1,4,29381554,680721879,2297396,2037730,682759609,654974678
29381493_2193846,CM021103.1,4,29381493,680721151,4071722,2193846,682914997,655130066
29381493_2193872,CM021103.1,4,29381493,680721151,4071722,2193872,682915023,655130092
29381554_2290534,CM021103.1,4,29381554,680721879,2297396,2290534,683012413,655227482
29381554_2290551,CM021103.1,4,29381554,680721879,2297396,2290551,683012430,655227499
29381554_2290582,CM021103.1,4,29381554,680721879,2297396,2290582,683012461,655227530
29382357_2307955,CM021103.1,4,29382357,680721156,4885066,2307955,683029111,655244180
29382357_2308027,CM021103.1,4,29382357,680721156,4885066,2308027,683029183,655244252
29377568_8771,CM021103.1,4,29377568,697541915,1668780,8771,697550686,669765755
29377568_8785,CM021103.1,4,29377568,697541915,1668780,8785,697550700,669765769
29377568_9695,CM021103.1,4,29377568,697541915,1668780,9695,697551610,669766679
29377568_9751,CM021103.1,4,29377568,697541915,1668780,9751,697551666,669766735
29377568_9755,CM021103.1,4,29377568,697541915,1668780,9755,697551670,669766739
29377568_9756,CM021103.1,4,29377568,697541915,1668780,9756,697551671,669766740
29377515_241075,CM021103.1,4,29377515,697543206,310322,241075,697784281,669999350
29377515_241121,CM021103.1,4,29377515,697543206,310322,241121,697784327,669999396
29377515_241335,CM021103.1,4,29377515,697543206,310322,241335,697784541,669999610
29377568_353507,CM021103.1,4,29377568,697541915,1668780,353507,697895422,670110491
29377568_353521,CM021103.1,4,29377568,697541915,1668780,353521,697895436,670110505
29377568_353693,CM021103.1,4,29377568,697541915,1668780,353693,697895608,670110677
29377702_412928,CM021103.1,4,29377702,697543066,1030344,412928,697955994,670171063
29377702_413063,CM021103.1,4,29377702,697543066,1030344,413063,697956129,670171198
29377568_1598614,CM021103.1,4,29377568,697541915,1668780,1598614,699140529,671355598
29377568_1599809,CM021103.1,4,29377568,697541915,1668780,1599809,699141724,671356793
29380439_62750,CM021103.1,4,29380439,716458691,330241,62750,716521441,688736510
29338708_6528,CM021103.1,4,29338708,721624419,19361,6528,721630947,693846016
29126773_4129,CM021104.1,5,29126773,2611767,6758,4129,2615896,4129
29126773_4320,CM021104.1,5,29126773,2611767,6758,4320,2616087,4320
28192406_219,CM021104.1,5,28192406,5029962,4428,219,5030181,2418414
29292793_7380,CM021104.1,5,29292793,5028265,7838,7380,5035645,2423878
28153607_207,CM021104.1,5,28153607,5731768,7348,207,5731975,3120208
29336428_49263,CM021104.1,5,29336428,18107422,54770,49263,18156685,15544918
29336428_49273,CM021104.1,5,29336428,18107422,54770,49273,18156695,15544928
29336428_49279,CM021104.1,5,29336428,18107422,54770,49279,18156701,15544934
29336428_49292,CM021104.1,5,29336428,18107422,54770,49292,18156714,15544947
29336428_49297,CM021104.1,5,29336428,18107422,54770,49297,18156719,15544952
29336428_49318,CM021104.1,5,29336428,18107422,54770,49318,18156740,15544973
29379135_248522,CM021104.1,5,29379135,19936317,346936,248522,20184839,17573072
29379135_248572,CM021104.1,5,29379135,19936317,346936,248572,20184889,17573122
29379135_248631,CM021104.1,5,29379135,19936317,346936,248631,20184948,17573181
29349500_2483,CM021104.1,5,29349500,48789004,33591,2483,48791487,46179720
29349500_2524,CM021104.1,5,29349500,48789004,33591,2524,48791528,46179761
29349500_2538,CM021104.1,5,29349500,48789004,33591,2538,48791542,46179775
29360016_16541,CM021104.1,5,29360016,56742849,32342,16541,56759390,54147623
29362621_88059,CM021104.1,5,29362621,73278298,463872,88059,73366357,70754590
29340478_33410,CM021104.1,5,29340478,103980325,55220,33410,104013735,101401968
29340478_33451,CM021104.1,5,29340478,103980325,55220,33451,104013776,101402009
29340478_33471,CM021104.1,5,29340478,103980325,55220,33471,104013796,101402029
29340478_33478,CM021104.1,5,29340478,103980325,55220,33478,104013803,101402036
29340478_33485,CM021104.1,5,29340478,103980325,55220,33485,104013810,101402043
29340478_33493,CM021104.1,5,29340478,103980325,55220,33493,104013818,101402051
29340478_33509,CM021104.1,5,29340478,103980325,55220,33509,104013834,101402067
29340478_33516,CM021104.1,5,29340478,103980325,55220,33516,104013841,101402074
29340478_33541,CM021104.1,5,29340478,103980325,55220,33541,104013866,101402099
29340478_33565,CM021104.1,5,29340478,103980325,55220,33565,104013890,101402123
29340478_33573,CM021104.1,5,29340478,103980325,55220,33573,104013898,101402131
29340478_33613,CM021104.1,5,29340478,103980325,55220,33613,104013938,101402171
29340478_33614,CM021104.1,5,29340478,103980325,55220,33614,104013939,101402172
29340478_33617,CM021104.1,5,29340478,103980325,55220,33617,104013942,101402175
29340478_33625,CM021104.1,5,29340478,103980325,55220,33625,104013950,101402183
29340478_33637,CM021104.1,5,29340478,103980325,55220,33637,104013962,101402195
29340478_33653,CM021104.1,5,29340478,103980325,55220,33653,104013978,101402211
29344990_120566,CM021104.1,5,29344990,103980603,127200,120566,104101169,101489402
29344990_120602,CM021104.1,5,29344990,103980603,127200,120602,104101205,101489438
29344990_120668,CM021104.1,5,29344990,103980603,127200,120668,104101271,101489504
29382407_480251,CM021104.1,5,29382407,103980312,626837,480251,104460563,101848796
29382407_537208,CM021104.1,5,29382407,103980312,626837,537208,104517520,101905753
29382407_576113,CM021104.1,5,29382407,103980312,626837,576113,104556425,101944658
29382407_576148,CM021104.1,5,29382407,103980312,626837,576148,104556460,101944693
29382407_576155,CM021104.1,5,29382407,103980312,626837,576155,104556467,101944700
29382407_576164,CM021104.1,5,29382407,103980312,626837,576164,104556476,101944709
29382407_576176,CM021104.1,5,29382407,103980312,626837,576176,104556488,101944721
29382407_576191,CM021104.1,5,29382407,103980312,626837,576191,104556503,101944736
29382407_576199,CM021104.1,5,29382407,103980312,626837,576199,104556511,101944744
29382407_576249,CM021104.1,5,29382407,103980312,626837,576249,104556561,101944794
29382407_576251,CM021104.1,5,29382407,103980312,626837,576251,104556563,101944796
29382407_576317,CM021104.1,5,29382407,103980312,626837,576317,104556629,101944862
29382407_576347,CM021104.1,5,29382407,103980312,626837,576347,104556659,101944892
29382407_576348,CM021104.1,5,29382407,103980312,626837,576348,104556660,101944893
29382407_596474,CM021104.1,5,29382407,103980312,626837,596474,104576786,101965019
29382407_596477,CM021104.1,5,29382407,103980312,626837,596477,104576789,101965022
29377113_4454,CM021104.1,5,29377113,119849715,1577613,4454,119854169,117242402
29377113_27477,CM021104.1,5,29377113,119849715,1577613,27477,119877192,117265425
29377113_27482,CM021104.1,5,29377113,119849715,1577613,27482,119877197,117265430
29377113_27502,CM021104.1,5,29377113,119849715,1577613,27502,119877217,117265450
29377113_27549,CM021104.1,5,29377113,119849715,1577613,27549,119877264,117265497
29377113_27558,CM021104.1,5,29377113,119849715,1577613,27558,119877273,117265506
29377113_27566,CM021104.1,5,29377113,119849715,1577613,27566,119877281,117265514
29377113_27568,CM021104.1,5,29377113,119849715,1577613,27568,119877283,117265516
29377113_27589,CM021104.1,5,29377113,119849715,1577613,27589,119877304,117265537
29381959_61974,CM021104.1,5,29381959,119850342,3032127,61974,119912316,117300549
29379927_93264,CM021104.1,5,29379927,119849715,1469338,93264,119942979,117331212
29379927_93270,CM021104.1,5,29379927,119849715,1469338,93270,119942985,117331218
29379927_93710,CM021104.1,5,29379927,119849715,1469338,93710,119943425,117331658
29379498_222832,CM021104.1,5,29379498,119849718,9533343,222832,120072550,117460783
29379498_227695,CM021104.1,5,29379498,119849718,9533343,227695,120077413,117465646
29379498_236411,CM021104.1,5,29379498,119849718,9533343,236411,120086129,117474362
29379975_244491,CM021104.1,5,29379975,119853451,2471274,244491,120097942,117486175
29379498_275411,CM021104.1,5,29379498,119849718,9533343,275411,120125129,117513362
29379968_321330,CM021104.1,5,29379968,119849716,4796720,321330,120171046,117559279
29379968_321355,CM021104.1,5,29379968,119849716,4796720,321355,120171071,117559304
29379968_321358,CM021104.1,5,29379968,119849716,4796720,321358,120171074,117559307
29379968_321373,CM021104.1,5,29379968,119849716,4796720,321373,120171089,117559322
29379968_321399,CM021104.1,5,29379968,119849716,4796720,321399,120171115,117559348
29379968_321407,CM021104.1,5,29379968,119849716,4796720,321407,120171123,117559356
29379968_321417,CM021104.1,5,29379968,119849716,4796720,321417,120171133,117559366
29379968_321614,CM021104.1,5,29379968,119849716,4796720,321614,120171330,117559563
29379968_321624,CM021104.1,5,29379968,119849716,4796720,321624,120171340,117559573
29377361_313540,CM021104.1,5,29377361,119857808,1437926,313540,120171348,117559581
29379968_321697,CM021104.1,5,29379968,119849716,4796720,321697,120171413,117559646
29379968_321723,CM021104.1,5,29379968,119849716,4796720,321723,120171439,117559672
29379968_321742,CM021104.1,5,29379968,119849716,4796720,321742,120171458,117559691
29381900_322198,CM021104.1,5,29381900,119855151,519670,322198,120177349,117565582
29380689_379032,CM021104.1,5,29380689,119854265,673397,379032,120233297,117621530
29377113_406895,CM021104.1,5,29377113,119849715,1577613,406895,120256610,117644843
29379927_408742,CM021104.1,5,29379927,119849715,1469338,408742,120258457,117646690
29378026_432745,CM021104.1,5,29378026,119852711,1722287,432745,120285456,117673689
29378026_432750,CM021104.1,5,29378026,119852711,1722287,432750,120285461,117673694
29378026_433220,CM021104.1,5,29378026,119852711,1722287,433220,120285931,117674164
29379975_545008,CM021104.1,5,29379975,119853451,2471274,545008,120398459,117786692
29379975_576576,CM021104.1,5,29379975,119853451,2471274,576576,120430027,117818260
29380805_577788,CM021104.1,5,29380805,119853182,4278679,577788,120430970,117819203
29380805_577887,CM021104.1,5,29380805,119853182,4278679,577887,120431069,117819302
29380805_577890,CM021104.1,5,29380805,119853182,4278679,577890,120431072,117819305
29380805_579144,CM021104.1,5,29380805,119853182,4278679,579144,120432326,117820559
29380805_581365,CM021104.1,5,29380805,119853182,4278679,581365,120434547,117822780
29380805_581385,CM021104.1,5,29380805,119853182,4278679,581385,120434567,117822800
29380805_581725,CM021104.1,5,29380805,119853182,4278679,581725,120434907,117823140
29377832_646725,CM021104.1,5,29377832,119854047,3802254,646725,120500772,117889005
29377832_646820,CM021104.1,5,29377832,119854047,3802254,646820,120500867,117889100
29379975_677510,CM021104.1,5,29379975,119853451,2471274,677510,120530961,117919194
29379582_719574,CM021104.1,5,29379582,119849714,1587908,719574,120569288,117957521
29377361_748219,CM021104.1,5,29377361,119857808,1437926,748219,120606027,117994260
29377361_748220,CM021104.1,5,29377361,119857808,1437926,748220,120606028,117994261
29377361_748221,CM021104.1,5,29377361,119857808,1437926,748221,120606029,117994262
29377361_748251,CM021104.1,5,29377361,119857808,1437926,748251,120606059,117994292
29377361_748290,CM021104.1,5,29377361,119857808,1437926,748290,120606098,117994331
29379968_771583,CM021104.1,5,29379968,119849716,4796720,771583,120621299,118009532
29379968_771638,CM021104.1,5,29379968,119849716,4796720,771638,120621354,118009587
29379968_771711,CM021104.1,5,29379968,119849716,4796720,771711,120621427,118009660
29379968_771714,CM021104.1,5,29379968,119849716,4796720,771714,120621430,118009663
29379975_808100,CM021104.1,5,29379975,119853451,2471274,808100,120661551,118049784
29379975_808120,CM021104.1,5,29379975,119853451,2471274,808120,120661571,118049804
29380982_833255,CM021104.1,5,29380982,119854606,977909,833255,120687861,118076094
29380982_863959,CM021104.1,5,29380982,119854606,977909,863959,120718565,118106798
29380982_863960,CM021104.1,5,29380982,119854606,977909,863960,120718566,118106799
29380982_872271,CM021104.1,5,29380982,119854606,977909,872271,120726877,118115110
29380982_937958,CM021104.1,5,29380982,119854606,977909,937958,120792564,118180797
29380982_959960,CM021104.1,5,29380982,119854606,977909,959960,120814566,118202799
29380982_960481,CM021104.1,5,29380982,119854606,977909,960481,120815087,118203320
29379498_973522,CM021104.1,5,29379498,119849718,9533343,973522,120823240,118211473
29379498_973524,CM021104.1,5,29379498,119849718,9533343,973524,120823242,118211475
29379498_973559,CM021104.1,5,29379498,119849718,9533343,973559,120823277,118211510
29377832_981325,CM021104.1,5,29377832,119854047,3802254,981325,120835372,118223605
29377832_981400,CM021104.1,5,29377832,119854047,3802254,981400,120835447,118223680
29377832_993241,CM021104.1,5,29377832,119854047,3802254,993241,120847288,118235521
29377832_993508,CM021104.1,5,29377832,119854047,3802254,993508,120847555,118235788
29380657_1012435,CM021104.1,5,29380657,119849716,2311254,1012435,120862151,118250384
29379975_1049277,CM021104.1,5,29379975,119853451,2471274,1049277,120902728,118290961
29379975_1049370,CM021104.1,5,29379975,119853451,2471274,1049370,120902821,118291054
29377832_1232161,CM021104.1,5,29377832,119854047,3802254,1232161,121086208,118474441
29377832_1232176,CM021104.1,5,29377832,119854047,3802254,1232176,121086223,118474456
29377361_1231844,CM021104.1,5,29377361,119857808,1437926,1231844,121089652,118477885
29377361_1231925,CM021104.1,5,29377361,119857808,1437926,1231925,121089733,118477966
29379975_1283989,CM021104.1,5,29379975,119853451,2471274,1283989,121137440,118525673
29379975_1284018,CM021104.1,5,29379975,119853451,2471274,1284018,121137469,118525702
29377361_1389363,CM021104.1,5,29377361,119857808,1437926,1389363,121247171,118635404
29377361_1389373,CM021104.1,5,29377361,119857808,1437926,1389373,121247181,118635414
29377113_1403587,CM021104.1,5,29377113,119849715,1577613,1403587,121253302,118641535
29377113_1403608,CM021104.1,5,29377113,119849715,1577613,1403608,121253323,118641556
29377113_1508126,CM021104.1,5,29377113,119849715,1577613,1508126,121357841,118746074
29377113_1508243,CM021104.1,5,29377113,119849715,1577613,1508243,121357958,118746191
29377113_1508253,CM021104.1,5,29377113,119849715,1577613,1508253,121357968,118746201
29377113_1508587,CM021104.1,5,29377113,119849715,1577613,1508587,121358302,118746535
29377113_1508638,CM021104.1,5,29377113,119849715,1577613,1508638,121358353,118746586
29377113_1508653,CM021104.1,5,29377113,119849715,1577613,1508653,121358368,118746601
29377113_1508778,CM021104.1,5,29377113,119849715,1577613,1508778,121358493,118746726
29381959_1601024,CM021104.1,5,29381959,119850342,3032127,1601024,121451366,118839599
29379968_1682844,CM021104.1,5,29379968,119849716,4796720,1682844,121532560,118920793
29377832_1754645,CM021104.1,5,29377832,119854047,3802254,1754645,121608692,118996925
29377832_1795461,CM021104.1,5,29377832,119854047,3802254,1795461,121649508,119037741
29377832_1795719,CM021104.1,5,29377832,119854047,3802254,1795719,121649766,119037999
29377832_1795744,CM021104.1,5,29377832,119854047,3802254,1795744,121649791,119038024
29381959_1822892,CM021104.1,5,29381959,119850342,3032127,1822892,121673234,119061467
29377832_1825413,CM021104.1,5,29377832,119854047,3802254,1825413,121679460,119067693
29377832_1825476,CM021104.1,5,29377832,119854047,3802254,1825476,121679523,119067756
29377832_1825506,CM021104.1,5,29377832,119854047,3802254,1825506,121679553,119067786
29377832_1825623,CM021104.1,5,29377832,119854047,3802254,1825623,121679670,119067903
29377832_1825626,CM021104.1,5,29377832,119854047,3802254,1825626,121679673,119067906
29377832_1825676,CM021104.1,5,29377832,119854047,3802254,1825676,121679723,119067956
29379968_1886222,CM021104.1,5,29379968,119849716,4796720,1886222,121735938,119124171
29380805_2297438,CM021104.1,5,29380805,119853182,4278679,2297438,122150620,119538853
29380805_3068216,CM021104.1,5,29380805,119853182,4278679,3068216,122921398,120309631
29379498_3786673,CM021104.1,5,29379498,119849718,9533343,3786673,123636391,121024624
29379968_4375804,CM021104.1,5,29379968,119849716,4796720,4375804,124225520,121613753
29379968_4375805,CM021104.1,5,29379968,119849716,4796720,4375805,124225521,121613754
29379968_4375843,CM021104.1,5,29379968,119849716,4796720,4375843,124225559,121613792
29379968_4375877,CM021104.1,5,29379968,119849716,4796720,4375877,124225593,121613826
29379968_4375920,CM021104.1,5,29379968,119849716,4796720,4375920,124225636,121613869
29379968_4375922,CM021104.1,5,29379968,119849716,4796720,4375922,124225638,121613871
29379968_4375928,CM021104.1,5,29379968,119849716,4796720,4375928,124225644,121613877
29379498_4797110,CM021104.1,5,29379498,119849718,9533343,4797110,124646828,122035061
29379498_4797119,CM021104.1,5,29379498,119849718,9533343,4797119,124646837,122035070
29379498_5602458,CM021104.1,5,29379498,119849718,9533343,5602458,125452176,122840409
29379498_5717779,CM021104.1,5,29379498,119849718,9533343,5717779,125567497,122955730
29379498_5718319,CM021104.1,5,29379498,119849718,9533343,5718319,125568037,122956270
29379498_5718356,CM021104.1,5,29379498,119849718,9533343,5718356,125568074,122956307
29379498_5748404,CM021104.1,5,29379498,119849718,9533343,5748404,125598122,122986355
29379498_5748433,CM021104.1,5,29379498,119849718,9533343,5748433,125598151,122986384
29379498_6720895,CM021104.1,5,29379498,119849718,9533343,6720895,126570613,123958846
29379498_6720897,CM021104.1,5,29379498,119849718,9533343,6720897,126570615,123958848
29379498_6848347,CM021104.1,5,29379498,119849718,9533343,6848347,126698065,124086298
29379498_6848355,CM021104.1,5,29379498,119849718,9533343,6848355,126698073,124086306
29379498_6848373,CM021104.1,5,29379498,119849718,9533343,6848373,126698091,124086324
29379498_6848376,CM021104.1,5,29379498,119849718,9533343,6848376,126698094,124086327
29379498_6848381,CM021104.1,5,29379498,119849718,9533343,6848381,126698099,124086332
29379498_6848391,CM021104.1,5,29379498,119849718,9533343,6848391,126698109,124086342
29379498_6848441,CM021104.1,5,29379498,119849718,9533343,6848441,126698159,124086392
29379498_6848445,CM021104.1,5,29379498,119849718,9533343,6848445,126698163,124086396
29379498_6848455,CM021104.1,5,29379498,119849718,9533343,6848455,126698173,124086406
29379498_6848460,CM021104.1,5,29379498,119849718,9533343,6848460,126698178,124086411
29379498_6848520,CM021104.1,5,29379498,119849718,9533343,6848520,126698238,124086471
29379498_6848533,CM021104.1,5,29379498,119849718,9533343,6848533,126698251,124086484
29379498_6848545,CM021104.1,5,29379498,119849718,9533343,6848545,126698263,124086496
29380541_25967,CM021104.1,5,29380541,139943220,2581298,25967,139969187,137357420
29380541_27731,CM021104.1,5,29380541,139943220,2581298,27731,139970951,137359184
29378927_58863,CM021104.1,5,29378927,139940436,1485949,58863,139999299,137387532
29380734_184869,CM021104.1,5,29380734,139945923,1341354,184869,140130792,137519025
29380734_195211,CM021104.1,5,29380734,139945923,1341354,195211,140141134,137529367
29380734_195618,CM021104.1,5,29380734,139945923,1341354,195618,140141541,137529774
29380734_195656,CM021104.1,5,29380734,139945923,1341354,195656,140141579,137529812
29380734_218577,CM021104.1,5,29380734,139945923,1341354,218577,140164500,137552733
29380734_218617,CM021104.1,5,29380734,139945923,1341354,218617,140164540,137552773
29380734_218655,CM021104.1,5,29380734,139945923,1341354,218655,140164578,137552811
29378518_239840,CM021104.1,5,29378518,139944437,378535,239840,140184277,137572510
29378518_239846,CM021104.1,5,29378518,139944437,378535,239846,140184283,137572516
29377994_304868,CM021104.1,5,29377994,139940433,5547879,304868,140245301,137633534
29380734_517559,CM021104.1,5,29380734,139945923,1341354,517559,140463482,137851715
29380734_517560,CM021104.1,5,29380734,139945923,1341354,517560,140463483,137851716
29379929_632172,CM021104.1,5,29379929,139940433,837294,632172,140572605,137960838
29377622_684761,CM021104.1,5,29377622,139943866,782166,684761,140628627,138016860
29377622_684799,CM021104.1,5,29377622,139943866,782166,684799,140628665,138016898
29377622_684812,CM021104.1,5,29377622,139943866,782166,684812,140628678,138016911
29377622_684853,CM021104.1,5,29377622,139943866,782166,684853,140628719,138016952
29377622_685449,CM021104.1,5,29377622,139943866,782166,685449,140629315,138017548
29377622_685473,CM021104.1,5,29377622,139943866,782166,685473,140629339,138017572
29377622_685496,CM021104.1,5,29377622,139943866,782166,685496,140629362,138017595
29377622_685515,CM021104.1,5,29377622,139943866,782166,685515,140629381,138017614
29377622_685518,CM021104.1,5,29377622,139943866,782166,685518,140629384,138017617
29377622_685530,CM021104.1,5,29377622,139943866,782166,685530,140629396,138017629
29377622_685534,CM021104.1,5,29377622,139943866,782166,685534,140629400,138017633
29377622_685555,CM021104.1,5,29377622,139943866,782166,685555,140629421,138017654
29380541_861491,CM021104.1,5,29380541,139943220,2581298,861491,140804711,138192944
29380541_861494,CM021104.1,5,29380541,139943220,2581298,861494,140804714,138192947
29380541_861556,CM021104.1,5,29380541,139943220,2581298,861556,140804776,138193009
29380541_861574,CM021104.1,5,29380541,139943220,2581298,861574,140804794,138193027
29381914_906105,CM021104.1,5,29381914,139943739,2264602,906105,140849844,138238077
29381914_906129,CM021104.1,5,29381914,139943739,2264602,906129,140849868,138238101
29381914_906130,CM021104.1,5,29381914,139943739,2264602,906130,140849869,138238102
29381914_906157,CM021104.1,5,29381914,139943739,2264602,906157,140849896,138238129
29381914_906216,CM021104.1,5,29381914,139943739,2264602,906216,140849955,138238188
29381914_906235,CM021104.1,5,29381914,139943739,2264602,906235,140849974,138238207
29381914_906239,CM021104.1,5,29381914,139943739,2264602,906239,140849978,138238211
29381914_906247,CM021104.1,5,29381914,139943739,2264602,906247,140849986,138238219
29380541_1021385,CM021104.1,5,29380541,139943220,2581298,1021385,140964605,138352838
29380541_1021392,CM021104.1,5,29380541,139943220,2581298,1021392,140964612,138352845
29380541_1021624,CM021104.1,5,29380541,139943220,2581298,1021624,140964844,138353077
29380541_1021626,CM021104.1,5,29380541,139943220,2581298,1021626,140964846,138353079
29380541_1055136,CM021104.1,5,29380541,139943220,2581298,1055136,140998356,138386589
29380541_1055160,CM021104.1,5,29380541,139943220,2581298,1055160,140998380,138386613
29380541_1055196,CM021104.1,5,29380541,139943220,2581298,1055196,140998416,138386649
29380541_1055199,CM021104.1,5,29380541,139943220,2581298,1055199,140998419,138386652
29380541_1055240,CM021104.1,5,29380541,139943220,2581298,1055240,140998460,138386693
29380541_1055372,CM021104.1,5,29380541,139943220,2581298,1055372,140998592,138386825
29380503_1062548,CM021104.1,5,29380503,139943641,1107674,1062548,141006189,138394422
29380541_1096044,CM021104.1,5,29380541,139943220,2581298,1096044,141039264,138427497
29380541_1118382,CM021104.1,5,29380541,139943220,2581298,1118382,141061602,138449835
29380541_1118454,CM021104.1,5,29380541,139943220,2581298,1118454,141061674,138449907
29380541_1118499,CM021104.1,5,29380541,139943220,2581298,1118499,141061719,138449952
29380541_1118511,CM021104.1,5,29380541,139943220,2581298,1118511,141061731,138449964
29380541_1118521,CM021104.1,5,29380541,139943220,2581298,1118521,141061741,138449974
29380541_1118581,CM021104.1,5,29380541,139943220,2581298,1118581,141061801,138450034
29380541_1120890,CM021104.1,5,29380541,139943220,2581298,1120890,141064110,138452343
29380541_1121990,CM021104.1,5,29380541,139943220,2581298,1121990,141065210,138453443
29379350_1306249,CM021104.1,5,29379350,139945192,2324979,1306249,141251441,138639674
29379350_1306293,CM021104.1,5,29379350,139945192,2324979,1306293,141251485,138639718
29379350_1306528,CM021104.1,5,29379350,139945192,2324979,1306528,141251720,138639953
29380017_3459932,CM021104.1,5,29380017,139944061,4504629,3459932,143403993,140792226
29377421_3570652,CM021104.1,5,29377421,139943800,4478479,3570652,143514452,140902685
29377421_3602796,CM021104.1,5,29377421,139943800,4478479,3602796,143546596,140934829
29377994_4109535,CM021104.1,5,29377994,139940433,5547879,4109535,144049968,141438201
29377994_4109537,CM021104.1,5,29377994,139940433,5547879,4109537,144049970,141438203
29377421_4294586,CM021104.1,5,29377421,139943800,4478479,4294586,144238386,141626619
29377421_4295382,CM021104.1,5,29377421,139943800,4478479,4295382,144239182,141627415
29377421_4308279,CM021104.1,5,29377421,139943800,4478479,4308279,144252079,141640312
29377994_5018275,CM021104.1,5,29377994,139940433,5547879,5018275,144958708,142346941
29377994_5019376,CM021104.1,5,29377994,139940433,5547879,5019376,144959809,142348042
29377994_5277841,CM021104.1,5,29377994,139940433,5547879,5277841,145218274,142606507
29377994_5277842,CM021104.1,5,29377994,139940433,5547879,5277842,145218275,142606508
29377994_5277850,CM021104.1,5,29377994,139940433,5547879,5277850,145218283,142606516
29377994_5277933,CM021104.1,5,29377994,139940433,5547879,5277933,145218366,142606599
29377994_5277984,CM021104.1,5,29377994,139940433,5547879,5277984,145218417,142606650
29381844_928,CM021104.1,5,29381844,156247216,1122509,928,156248144,153636377
29381844_1028,CM021104.1,5,29381844,156247216,1122509,1028,156248244,153636477
29381844_1106,CM021104.1,5,29381844,156247216,1122509,1106,156248322,153636555
29381844_1172,CM021104.1,5,29381844,156247216,1122509,1172,156248388,153636621
29381844_1178,CM021104.1,5,29381844,156247216,1122509,1178,156248394,153636627
29345128_16180,CM021104.1,5,29345128,156244996,32052,16180,156261176,153649409
29345128_16194,CM021104.1,5,29345128,156244996,32052,16194,156261190,153649423
29377451_58796,CM021104.1,5,29377451,156244819,2293203,58796,156303615,153691848
29377451_76116,CM021104.1,5,29377451,156244819,2293203,76116,156320935,153709168
29378335_128249,CM021104.1,5,29378335,156244824,1366753,128249,156373073,153761306
29378335_128270,CM021104.1,5,29378335,156244824,1366753,128270,156373094,153761327
29378335_128283,CM021104.1,5,29378335,156244824,1366753,128283,156373107,153761340
29378335_128407,CM021104.1,5,29378335,156244824,1366753,128407,156373231,153761464
29378335_128412,CM021104.1,5,29378335,156244824,1366753,128412,156373236,153761469
29379239_140458,CM021104.1,5,29379239,156247085,1796740,140458,156387543,153775776
29379239_187194,CM021104.1,5,29379239,156247085,1796740,187194,156434279,153822512
29379239_187215,CM021104.1,5,29379239,156247085,1796740,187215,156434300,153822533
29379239_233915,CM021104.1,5,29379239,156247085,1796740,233915,156481000,153869233
29379239_233921,CM021104.1,5,29379239,156247085,1796740,233921,156481006,153869239
29379239_234476,CM021104.1,5,29379239,156247085,1796740,234476,156481561,153869794
29379239_234477,CM021104.1,5,29379239,156247085,1796740,234477,156481562,153869795
29379239_234492,CM021104.1,5,29379239,156247085,1796740,234492,156481577,153869810
29379239_234517,CM021104.1,5,29379239,156247085,1796740,234517,156481602,153869835
29379239_234560,CM021104.1,5,29379239,156247085,1796740,234560,156481645,153869878
29378165_263470,CM021104.1,5,29378165,156244824,453947,263470,156508294,153896527
29378165_286148,CM021104.1,5,29378165,156244824,453947,286148,156530972,153919205
29378165_286224,CM021104.1,5,29378165,156244824,453947,286224,156531048,153919281
29381523_377075,CM021104.1,5,29381523,156244818,8019197,377075,156621893,154010126
29381523_377121,CM021104.1,5,29381523,156244818,8019197,377121,156621939,154010172
29381523_377156,CM021104.1,5,29381523,156244818,8019197,377156,156621974,154010207
29380419_387723,CM021104.1,5,29380419,156245397,906008,387723,156633120,154021353
29379239_659148,CM021104.1,5,29379239,156247085,1796740,659148,156906233,154294466
29380593_691027,CM021104.1,5,29380593,156245170,3177657,691027,156936197,154324430
29379039_774691,CM021104.1,5,29379039,156244824,1283668,774691,157019515,154407748
29379039_774762,CM021104.1,5,29379039,156244824,1283668,774762,157019586,154407819
29377451_971080,CM021104.1,5,29377451,156244819,2293203,971080,157215899,154604132
29377451_971289,CM021104.1,5,29377451,156244819,2293203,971289,157216108,154604341
29377451_971387,CM021104.1,5,29377451,156244819,2293203,971387,157216206,154604439
29379877_1023848,CM021104.1,5,29379877,156245689,3704811,1023848,157269537,154657770
29380261_1031919,CM021104.1,5,29380261,156246142,5857581,1031919,157278061,154666294
29380261_1032046,CM021104.1,5,29380261,156246142,5857581,1032046,157278188,154666421
29380261_1063820,CM021104.1,5,29380261,156246142,5857581,1063820,157309962,154698195
29379239_1090045,CM021104.1,5,29379239,156247085,1796740,1090045,157337130,154725363
29379239_1090070,CM021104.1,5,29379239,156247085,1796740,1090070,157337155,154725388
29379239_1225514,CM021104.1,5,29379239,156247085,1796740,1225514,157472599,154860832
29379877_1270512,CM021104.1,5,29379877,156245689,3704811,1270512,157516201,154904434
29379877_1270519,CM021104.1,5,29379877,156245689,3704811,1270519,157516208,154904441
29379877_1270566,CM021104.1,5,29379877,156245689,3704811,1270566,157516255,154904488
29379877_1270728,CM021104.1,5,29379877,156245689,3704811,1270728,157516417,154904650
29381117_1297523,CM021104.1,5,29381117,156246287,3557451,1297523,157543810,154932043
29381117_1297584,CM021104.1,5,29381117,156246287,3557451,1297584,157543871,154932104
29381117_1337293,CM021104.1,5,29381117,156246287,3557451,1337293,157583580,154971813
29377451_1452722,CM021104.1,5,29377451,156244819,2293203,1452722,157697541,155085774
29379877_1888668,CM021104.1,5,29379877,156245689,3704811,1888668,158134357,155522590
29379877_1888679,CM021104.1,5,29379877,156245689,3704811,1888679,158134368,155522601
29380593_1979101,CM021104.1,5,29380593,156245170,3177657,1979101,158224271,155612504
29380593_1979199,CM021104.1,5,29380593,156245170,3177657,1979199,158224369,155612602
29380593_1979276,CM021104.1,5,29380593,156245170,3177657,1979276,158224446,155612679
29380593_1979384,CM021104.1,5,29380593,156245170,3177657,1979384,158224554,155612787
29377077_2201920,CM021104.1,5,29377077,156245067,3763397,2201920,158446987,155835220
29381117_2448910,CM021104.1,5,29381117,156246287,3557451,2448910,158695197,156083430
29381117_2449118,CM021104.1,5,29381117,156246287,3557451,2449118,158695405,156083638
29381117_2449528,CM021104.1,5,29381117,156246287,3557451,2449528,158695815,156084048
29381117_2753473,CM021104.1,5,29381117,156246287,3557451,2753473,158999760,156387993
29377077_2888660,CM021104.1,5,29377077,156245067,3763397,2888660,159133727,156521960
29381117_2992243,CM021104.1,5,29381117,156246287,3557451,2992243,159238530,156626763
29381117_2992247,CM021104.1,5,29381117,156246287,3557451,2992247,159238534,156626767
29381117_2992317,CM021104.1,5,29381117,156246287,3557451,2992317,159238604,156626837
29381117_3014896,CM021104.1,5,29381117,156246287,3557451,3014896,159261183,156649416
29381117_3040922,CM021104.1,5,29381117,156246287,3557451,3040922,159287209,156675442
29381117_3096798,CM021104.1,5,29381117,156246287,3557451,3096798,159343085,156731318
29381523_3155215,CM021104.1,5,29381523,156244818,8019197,3155215,159400033,156788266
29380261_3860823,CM021104.1,5,29380261,156246142,5857581,3860823,160106965,157495198
29380261_3886254,CM021104.1,5,29380261,156246142,5857581,3886254,160132396,157520629
29381523_4088788,CM021104.1,5,29381523,156244818,8019197,4088788,160333606,157721839
29380261_4191898,CM021104.1,5,29380261,156246142,5857581,4191898,160438040,157826273
29380261_4191940,CM021104.1,5,29380261,156246142,5857581,4191940,160438082,157826315
29380261_4797821,CM021104.1,5,29380261,156246142,5857581,4797821,161043963,158432196
29380261_4827497,CM021104.1,5,29380261,156246142,5857581,4827497,161073639,158461872
29381523_4866290,CM021104.1,5,29381523,156244818,8019197,4866290,161111108,158499341
29381523_4866334,CM021104.1,5,29381523,156244818,8019197,4866334,161111152,158499385
29381523_6977270,CM021104.1,5,29381523,156244818,8019197,6977270,163222088,160610321
29381523_6977289,CM021104.1,5,29381523,156244818,8019197,6977289,163222107,160610340
29381523_6986913,CM021104.1,5,29381523,156244818,8019197,6986913,163231731,160619964
29381523_6986978,CM021104.1,5,29381523,156244818,8019197,6986978,163231796,160620029
29381523_6987044,CM021104.1,5,29381523,156244818,8019197,6987044,163231862,160620095
29381523_7038206,CM021104.1,5,29381523,156244818,8019197,7038206,163283024,160671257
29381523_7635505,CM021104.1,5,29381523,156244818,8019197,7635505,163880323,161268556
29381523_7893860,CM021104.1,5,29381523,156244818,8019197,7893860,164138678,161526911
29381523_7924496,CM021104.1,5,29381523,156244818,8019197,7924496,164169314,161557547
29360633_233877,CM021104.1,5,29360633,176847195,328175,233877,177081072,174469305
29379063_270143,CM021104.1,5,29379063,176847195,673194,270143,177117338,174505571
29379063_270173,CM021104.1,5,29379063,176847195,673194,270173,177117368,174505601
29378425_281511,CM021104.1,5,29378425,176847194,1072881,281511,177128705,174516938
29378425_283758,CM021104.1,5,29378425,176847194,1072881,283758,177130952,174519185
29378425_283807,CM021104.1,5,29378425,176847194,1072881,283807,177131001,174519234
29379745_574666,CM021104.1,5,29379745,176847208,1067868,574666,177421874,174810107
29380312_1001436,CM021104.1,5,29380312,176847195,1601629,1001436,177848631,175236864
29341567_356965,CM021104.1,5,29341567,182140656,517460,356965,182497621,179885854
29382100_3473,CM021104.1,5,29382100,223764677,4159129,3473,223768150,221156383
29382100_3475,CM021104.1,5,29382100,223764677,4159129,3475,223768152,221156385
29382100_3478,CM021104.1,5,29382100,223764677,4159129,3478,223768155,221156388
29382100_3486,CM021104.1,5,29382100,223764677,4159129,3486,223768163,221156396
29379725_32579,CM021104.1,5,29379725,223764806,372170,32579,223797385,221185618
29379725_32619,CM021104.1,5,29379725,223764806,372170,32619,223797425,221185658
29379725_32622,CM021104.1,5,29379725,223764806,372170,32622,223797428,221185661
29379725_32624,CM021104.1,5,29379725,223764806,372170,32624,223797430,221185663
29379725_32682,CM021104.1,5,29379725,223764806,372170,32682,223797488,221185721
29382100_34505,CM021104.1,5,29382100,223764677,4159129,34505,223799182,221187415
29382100_34590,CM021104.1,5,29382100,223764677,4159129,34590,223799267,221187500
29382100_34609,CM021104.1,5,29382100,223764677,4159129,34609,223799286,221187519
29379725_145035,CM021104.1,5,29379725,223764806,372170,145035,223909841,221298074
29379725_145093,CM021104.1,5,29379725,223764806,372170,145093,223909899,221298132
29379725_145129,CM021104.1,5,29379725,223764806,372170,145129,223909935,221298168
29346777_317112,CM021104.1,5,29346777,223768886,602746,317112,224085998,221474231
29382100_397547,CM021104.1,5,29382100,223764677,4159129,397547,224162224,221550457
29382100_397568,CM021104.1,5,29382100,223764677,4159129,397568,224162245,221550478
29382100_398931,CM021104.1,5,29382100,223764677,4159129,398931,224163608,221551841
29382100_399064,CM021104.1,5,29382100,223764677,4159129,399064,224163741,221551974
29382100_399205,CM021104.1,5,29382100,223764677,4159129,399205,224163882,221552115
29378635_525282,CM021104.1,5,29378635,223764677,1291074,525282,224289959,221678192
29382100_568538,CM021104.1,5,29382100,223764677,4159129,568538,224333215,221721448
29382100_568586,CM021104.1,5,29382100,223764677,4159129,568586,224333263,221721496
29382100_568593,CM021104.1,5,29382100,223764677,4159129,568593,224333270,221721503
29382100_568666,CM021104.1,5,29382100,223764677,4159129,568666,224333343,221721576
29382100_568667,CM021104.1,5,29382100,223764677,4159129,568667,224333344,221721577
29382100_1114488,CM021104.1,5,29382100,223764677,4159129,1114488,224879165,222267398
29382100_1226126,CM021104.1,5,29382100,223764677,4159129,1226126,224990803,222379036
29382100_1226469,CM021104.1,5,29382100,223764677,4159129,1226469,224991146,222379379
29382100_1226549,CM021104.1,5,29382100,223764677,4159129,1226549,224991226,222379459
29382100_1226553,CM021104.1,5,29382100,223764677,4159129,1226553,224991230,222379463
29382100_1226595,CM021104.1,5,29382100,223764677,4159129,1226595,224991272,222379505
29382100_1226604,CM021104.1,5,29382100,223764677,4159129,1226604,224991281,222379514
29382100_1226641,CM021104.1,5,29382100,223764677,4159129,1226641,224991318,222379551
29382100_1226757,CM021104.1,5,29382100,223764677,4159129,1226757,224991434,222379667
29382100_1226790,CM021104.1,5,29382100,223764677,4159129,1226790,224991467,222379700
29382100_1226834,CM021104.1,5,29382100,223764677,4159129,1226834,224991511,222379744
29382069_1915989,CM021104.1,5,29382069,223764869,2946044,1915989,225680858,223069091
29382069_1915990,CM021104.1,5,29382069,223764869,2946044,1915990,225680859,223069092
29382069_1916103,CM021104.1,5,29382069,223764869,2946044,1916103,225680972,223069205
29382069_1916120,CM021104.1,5,29382069,223764869,2946044,1916120,225680989,223069222
29382100_2994904,CM021104.1,5,29382100,223764677,4159129,2994904,226759581,224147814
29382100_3366241,CM021104.1,5,29382100,223764677,4159129,3366241,227130918,224519151
29382100_3366267,CM021104.1,5,29382100,223764677,4159129,3366267,227130944,224519177
29382100_3366330,CM021104.1,5,29382100,223764677,4159129,3366330,227131007,224519240
29378297_51755,CM021104.1,5,29378297,229984534,909627,51755,230036289,227424522
29378297_51757,CM021104.1,5,29378297,229984534,909627,51757,230036291,227424524
29378297_51792,CM021104.1,5,29378297,229984534,909627,51792,230036326,227424559
29378297_51821,CM021104.1,5,29378297,229984534,909627,51821,230036355,227424588
29378297_52080,CM021104.1,5,29378297,229984534,909627,52080,230036614,227424847
29378297_264919,CM021104.1,5,29378297,229984534,909627,264919,230249453,227637686
29378297_265018,CM021104.1,5,29378297,229984534,909627,265018,230249552,227637785
29378297_265031,CM021104.1,5,29378297,229984534,909627,265031,230249565,227637798
29378297_265075,CM021104.1,5,29378297,229984534,909627,265075,230249609,227637842
29378297_430859,CM021104.1,5,29378297,229984534,909627,430859,230415393,227803626
29378297_431089,CM021104.1,5,29378297,229984534,909627,431089,230415623,227803856
29378297_542492,CM021104.1,5,29378297,229984534,909627,542492,230527026,227915259
29382436_720442,CM021104.1,5,29382436,229984531,837187,720442,230704973,228093206
29382436_720536,CM021104.1,5,29382436,229984531,837187,720536,230705067,228093300
29381318_722535,CM021104.1,5,29381318,229984518,1548438,722535,230707053,228095286
29381318_722693,CM021104.1,5,29381318,229984518,1548438,722693,230707211,228095444
29381318_1162424,CM021104.1,5,29381318,229984518,1548438,1162424,231146942,228535175
29381318_1162579,CM021104.1,5,29381318,229984518,1548438,1162579,231147097,228535330
29381318_1162589,CM021104.1,5,29381318,229984518,1548438,1162589,231147107,228535340
29381318_1267212,CM021104.1,5,29381318,229984518,1548438,1267212,231251730,228639963
29381318_1267213,CM021104.1,5,29381318,229984518,1548438,1267213,231251731,228639964
29381318_1267237,CM021104.1,5,29381318,229984518,1548438,1267237,231251755,228639988
29381318_1267238,CM021104.1,5,29381318,229984518,1548438,1267238,231251756,228639989
29381318_1267297,CM021104.1,5,29381318,229984518,1548438,1267297,231251815,228640048
29381318_1267336,CM021104.1,5,29381318,229984518,1548438,1267336,231251854,228640087
29381318_1267344,CM021104.1,5,29381318,229984518,1548438,1267344,231251862,228640095
29381318_1267365,CM021104.1,5,29381318,229984518,1548438,1267365,231251883,228640116
29379613_86563,CM021104.1,5,29379613,237791233,745414,86563,237877796,235266029
29379613_86635,CM021104.1,5,29379613,237791233,745414,86635,237877868,235266101
29380362_287221,CM021104.1,5,29380362,237791236,1287311,287221,238078457,235466690
29380362_287233,CM021104.1,5,29380362,237791236,1287311,287233,238078469,235466702
29380362_287283,CM021104.1,5,29380362,237791236,1287311,287283,238078519,235466752
29377021_380343,CM021104.1,5,29377021,237792732,411664,380343,238173075,235561308
29377021_380375,CM021104.1,5,29377021,237792732,411664,380375,238173107,235561340
29377021_380376,CM021104.1,5,29377021,237792732,411664,380376,238173108,235561341
29377021_380407,CM021104.1,5,29377021,237792732,411664,380407,238173139,235561372
29377021_380621,CM021104.1,5,29377021,237792732,411664,380621,238173353,235561586
29381800_490583,CM021104.1,5,29381800,237791236,1984922,490583,238281819,235670052
29381800_490628,CM021104.1,5,29381800,237791236,1984922,490628,238281864,235670097
29381800_491461,CM021104.1,5,29381800,237791236,1984922,491461,238282697,235670930
29380557_867567,CM021104.1,5,29380557,237791236,879694,867567,238658803,236047036
29380557_870213,CM021104.1,5,29380557,237791236,879694,870213,238661449,236049682
29380557_870241,CM021104.1,5,29380557,237791236,879694,870241,238661477,236049710
29380557_870245,CM021104.1,5,29380557,237791236,879694,870245,238661481,236049714
29380557_871063,CM021104.1,5,29380557,237791236,879694,871063,238662299,236050532
29380557_871072,CM021104.1,5,29380557,237791236,879694,871072,238662308,236050541
29380557_871087,CM021104.1,5,29380557,237791236,879694,871087,238662323,236050556
29381800_1241730,CM021104.1,5,29381800,237791236,1984922,1241730,239032966,236421199
29381800_1241731,CM021104.1,5,29381800,237791236,1984922,1241731,239032967,236421200
29381800_1241790,CM021104.1,5,29381800,237791236,1984922,1241790,239033026,236421259
29381800_1241829,CM021104.1,5,29381800,237791236,1984922,1241829,239033065,236421298
29381800_1241863,CM021104.1,5,29381800,237791236,1984922,1241863,239033099,236421332
29381800_1241948,CM021104.1,5,29381800,237791236,1984922,1241948,239033184,236421417
29378998_41536,CM021104.1,5,29378998,240474024,852671,41536,240515560,237903793
29378998_850989,CM021104.1,5,29378998,240474024,852671,850989,241325013,238713246
29210178_6747,CM021104.1,5,29210178,245952030,7412,6747,245958777,243347010
29381491_63618,CM021104.1,5,29381491,247057528,3736220,63618,247121146,244509379
29381491_63656,CM021104.1,5,29381491,247057528,3736220,63656,247121184,244509417
29359391_64686,CM021104.1,5,29359391,247057439,166706,64686,247122125,244510358
29377962_124279,CM021104.1,5,29377962,247058502,2187682,124279,247182781,244571014
29366289_131549,CM021104.1,5,29366289,247056573,160566,131549,247188122,244576355
29366289_131559,CM021104.1,5,29366289,247056573,160566,131559,247188132,244576365
29366289_131570,CM021104.1,5,29366289,247056573,160566,131570,247188143,244576376
29366289_131586,CM021104.1,5,29366289,247056573,160566,131586,247188159,244576392
29366289_131604,CM021104.1,5,29366289,247056573,160566,131604,247188177,244576410
29366289_131617,CM021104.1,5,29366289,247056573,160566,131617,247188190,244576423
29366289_131646,CM021104.1,5,29366289,247056573,160566,131646,247188219,244576452
29366289_131649,CM021104.1,5,29366289,247056573,160566,131649,247188222,244576455
29366289_131651,CM021104.1,5,29366289,247056573,160566,131651,247188224,244576457
29366289_131656,CM021104.1,5,29366289,247056573,160566,131656,247188229,244576462
29366289_131674,CM021104.1,5,29366289,247056573,160566,131674,247188247,244576480
29377631_196897,CM021104.1,5,29377631,247056573,341128,196897,247253470,244641703
29378996_313012,CM021104.1,5,29378996,247058671,808977,313012,247371683,244759916
29378075_397182,CM021104.1,5,29378075,247057362,2550603,397182,247454544,244842777
29381491_439827,CM021104.1,5,29381491,247057528,3736220,439827,247497355,244885588
29382131_539220,CM021104.1,5,29382131,247056570,2624850,539220,247595790,244984023
29378996_577838,CM021104.1,5,29378996,247058671,808977,577838,247636509,245024742
29378996_577939,CM021104.1,5,29378996,247058671,808977,577939,247636610,245024843
29381491_751791,CM021104.1,5,29381491,247057528,3736220,751791,247809319,245197552
29381491_866760,CM021104.1,5,29381491,247057528,3736220,866760,247924288,245312521
29381491_866765,CM021104.1,5,29381491,247057528,3736220,866765,247924293,245312526
29381941_866632,CM021104.1,5,29381941,247059892,1000591,866632,247926524,245314757
29381941_866729,CM021104.1,5,29381941,247059892,1000591,866729,247926621,245314854
29381491_896061,CM021104.1,5,29381491,247057528,3736220,896061,247953589,245341822
29381491_896095,CM021104.1,5,29381491,247057528,3736220,896095,247953623,245341856
29381491_993555,CM021104.1,5,29381491,247057528,3736220,993555,248051083,245439316
29378482_1161785,CM021104.1,5,29378482,247056573,1424409,1161785,248218358,245606591
29378482_1161820,CM021104.1,5,29378482,247056573,1424409,1161820,248218393,245606626
29381491_1179566,CM021104.1,5,29381491,247057528,3736220,1179566,248237094,245625327
29380292_1204388,CM021104.1,5,29380292,247057866,1523814,1204388,248262254,245650487
29381491_1279314,CM021104.1,5,29381491,247057528,3736220,1279314,248336842,245725075
29381491_1311343,CM021104.1,5,29381491,247057528,3736220,1311343,248368871,245757104
29381491_1311509,CM021104.1,5,29381491,247057528,3736220,1311509,248369037,245757270
29381491_1358417,CM021104.1,5,29381491,247057528,3736220,1358417,248415945,245804178
29381491_1358437,CM021104.1,5,29381491,247057528,3736220,1358437,248415965,245804198
29381491_1358463,CM021104.1,5,29381491,247057528,3736220,1358463,248415991,245804224
29381491_1358464,CM021104.1,5,29381491,247057528,3736220,1358464,248415992,245804225
29381491_1358478,CM021104.1,5,29381491,247057528,3736220,1358478,248416006,245804239
29381491_1358515,CM021104.1,5,29381491,247057528,3736220,1358515,248416043,245804276
29379924_1643302,CM021104.1,5,29379924,247056998,2140901,1643302,248700300,246088533
29379924_1643331,CM021104.1,5,29379924,247056998,2140901,1643331,248700329,246088562
29378075_1666895,CM021104.1,5,29378075,247057362,2550603,1666895,248724257,246112490
29378075_1667013,CM021104.1,5,29378075,247057362,2550603,1667013,248724375,246112608
29378075_1667128,CM021104.1,5,29378075,247057362,2550603,1667128,248724490,246112723
29378075_1755657,CM021104.1,5,29378075,247057362,2550603,1755657,248813019,246201252
29381491_1827141,CM021104.1,5,29381491,247057528,3736220,1827141,248884669,246272902
29381491_1827172,CM021104.1,5,29381491,247057528,3736220,1827172,248884700,246272933
29381491_1827243,CM021104.1,5,29381491,247057528,3736220,1827243,248884771,246273004
29381491_1827253,CM021104.1,5,29381491,247057528,3736220,1827253,248884781,246273014
29381491_1827255,CM021104.1,5,29381491,247057528,3736220,1827255,248884783,246273016
29381491_1827269,CM021104.1,5,29381491,247057528,3736220,1827269,248884797,246273030
29381491_1827280,CM021104.1,5,29381491,247057528,3736220,1827280,248884808,246273041
29381491_1827302,CM021104.1,5,29381491,247057528,3736220,1827302,248884830,246273063
29381491_1827303,CM021104.1,5,29381491,247057528,3736220,1827303,248884831,246273064
29381491_1827360,CM021104.1,5,29381491,247057528,3736220,1827360,248884888,246273121
29381491_1827361,CM021104.1,5,29381491,247057528,3736220,1827361,248884889,246273122
29381491_1887385,CM021104.1,5,29381491,247057528,3736220,1887385,248944913,246333146
29381491_1887428,CM021104.1,5,29381491,247057528,3736220,1887428,248944956,246333189
29381491_1887478,CM021104.1,5,29381491,247057528,3736220,1887478,248945006,246333239
29377962_1933492,CM021104.1,5,29377962,247058502,2187682,1933492,248991994,246380227
29379924_1993873,CM021104.1,5,29379924,247056998,2140901,1993873,249050871,246439104
29381491_2012498,CM021104.1,5,29381491,247057528,3736220,2012498,249070026,246458259
29381491_2012542,CM021104.1,5,29381491,247057528,3736220,2012542,249070070,246458303
29381491_2228944,CM021104.1,5,29381491,247057528,3736220,2228944,249286472,246674705
29381491_2228990,CM021104.1,5,29381491,247057528,3736220,2228990,249286518,246674751
29381491_2228995,CM021104.1,5,29381491,247057528,3736220,2228995,249286523,246674756
29381491_2229060,CM021104.1,5,29381491,247057528,3736220,2229060,249286588,246674821
29381491_2233104,CM021104.1,5,29381491,247057528,3736220,2233104,249290632,246678865
29381491_2233134,CM021104.1,5,29381491,247057528,3736220,2233134,249290662,246678895
29381491_2233163,CM021104.1,5,29381491,247057528,3736220,2233163,249290691,246678924
29381491_2233308,CM021104.1,5,29381491,247057528,3736220,2233308,249290836,246679069
29381491_2233323,CM021104.1,5,29381491,247057528,3736220,2233323,249290851,246679084
29381491_2233335,CM021104.1,5,29381491,247057528,3736220,2233335,249290863,246679096
29381491_2233340,CM021104.1,5,29381491,247057528,3736220,2233340,249290868,246679101
29381491_2251840,CM021104.1,5,29381491,247057528,3736220,2251840,249309368,246697601
29381491_2518471,CM021104.1,5,29381491,247057528,3736220,2518471,249575999,246964232
29381491_2518485,CM021104.1,5,29381491,247057528,3736220,2518485,249576013,246964246
29381491_2760226,CM021104.1,5,29381491,247057528,3736220,2760226,249817754,247205987
29381491_2760244,CM021104.1,5,29381491,247057528,3736220,2760244,249817772,247206005
29334860_58168,CM021104.1,5,29334860,249779612,104301,58168,249837780,247226013
29334860_58183,CM021104.1,5,29334860,249779612,104301,58183,249837795,247226028
29334860_58219,CM021104.1,5,29334860,249779612,104301,58219,249837831,247226064
29334860_58237,CM021104.1,5,29334860,249779612,104301,58237,249837849,247226082
29334860_58346,CM021104.1,5,29334860,249779612,104301,58346,249837958,247226191
29334860_74429,CM021104.1,5,29334860,249779612,104301,74429,249854041,247242274
29381491_2926108,CM021104.1,5,29381491,247057528,3736220,2926108,249983636,247371869
29381491_2929196,CM021104.1,5,29381491,247057528,3736220,2929196,249986724,247374957
29381491_3492163,CM021104.1,5,29381491,247057528,3736220,3492163,250549691,247937924
29381491_3605020,CM021104.1,5,29381491,247057528,3736220,3605020,250662548,248050781
29381491_3607249,CM021104.1,5,29381491,247057528,3736220,3607249,250664777,248053010
29381491_3607254,CM021104.1,5,29381491,247057528,3736220,3607254,250664782,248053015
29381094_3766,CM021104.1,5,29381094,252241367,682174,3766,252245133,249633366
29381094_3774,CM021104.1,5,29381094,252241367,682174,3774,252245141,249633374
29381094_3777,CM021104.1,5,29381094,252241367,682174,3777,252245144,249633377
29381094_3828,CM021104.1,5,29381094,252241367,682174,3828,252245195,249633428
29381094_3901,CM021104.1,5,29381094,252241367,682174,3901,252245268,249633501
29381094_3903,CM021104.1,5,29381094,252241367,682174,3903,252245270,249633503
29381094_3923,CM021104.1,5,29381094,252241367,682174,3923,252245290,249633523
29381094_3929,CM021104.1,5,29381094,252241367,682174,3929,252245296,249633529
29381094_3941,CM021104.1,5,29381094,252241367,682174,3941,252245308,249633541
29379419_5273,CM021104.1,5,29379419,252256718,227964,5273,252261991,249650224
29379419_5371,CM021104.1,5,29379419,252256718,227964,5371,252262089,249650322
29379419_5377,CM021104.1,5,29379419,252256718,227964,5377,252262095,249650328
29379419_5386,CM021104.1,5,29379419,252256718,227964,5386,252262104,249650337
29379419_5436,CM021104.1,5,29379419,252256718,227964,5436,252262154,249650387
29379419_5442,CM021104.1,5,29379419,252256718,227964,5442,252262160,249650393
29379419_5463,CM021104.1,5,29379419,252256718,227964,5463,252262181,249650414
29351823_9235,CM021104.1,5,29351823,252255988,52958,9235,252265223,249653456
29351823_9249,CM021104.1,5,29351823,252255988,52958,9249,252265237,249653470
29351823_9253,CM021104.1,5,29351823,252255988,52958,9253,252265241,249653474
29351823_9259,CM021104.1,5,29351823,252255988,52958,9259,252265247,249653480
29351823_9292,CM021104.1,5,29351823,252255988,52958,9292,252265280,249653513
29378552_43579,CM021104.1,5,29378552,252254722,1697473,43579,252298301,249686534
29378552_43587,CM021104.1,5,29378552,252254722,1697473,43587,252298309,249686542
29378552_43842,CM021104.1,5,29378552,252254722,1697473,43842,252298564,249686797
29378552_43871,CM021104.1,5,29378552,252254722,1697473,43871,252298593,249686826
29378552_43958,CM021104.1,5,29378552,252254722,1697473,43958,252298680,249686913
29377183_80377,CM021104.1,5,29377183,252254556,85791,80377,252334933,249723166
29378552_94157,CM021104.1,5,29378552,252254722,1697473,94157,252348879,249737112
29378552_94201,CM021104.1,5,29378552,252254722,1697473,94201,252348923,249737156
29378552_104633,CM021104.1,5,29378552,252254722,1697473,104633,252359355,249747588
29378552_104634,CM021104.1,5,29378552,252254722,1697473,104634,252359356,249747589
29382018_113341,CM021104.1,5,29382018,252252673,749258,113341,252366014,249754247
29382018_113391,CM021104.1,5,29382018,252252673,749258,113391,252366064,249754297
29382018_113414,CM021104.1,5,29382018,252252673,749258,113414,252366087,249754320
29382018_113429,CM021104.1,5,29382018,252252673,749258,113429,252366102,249754335
29382018_113465,CM021104.1,5,29382018,252252673,749258,113465,252366138,249754371
29382018_113486,CM021104.1,5,29382018,252252673,749258,113486,252366159,249754392
29382018_113533,CM021104.1,5,29382018,252252673,749258,113533,252366206,249754439
29382018_113559,CM021104.1,5,29382018,252252673,749258,113559,252366232,249754465
29381893_138787,CM021104.1,5,29381893,252252910,4678128,138787,252391697,249779930
29381893_138897,CM021104.1,5,29381893,252252910,4678128,138897,252391807,249780040
29381893_138988,CM021104.1,5,29381893,252252910,4678128,138988,252391898,249780131
29377988_182204,CM021104.1,5,29377988,252248177,717536,182204,252430381,249818614
29378552_234684,CM021104.1,5,29378552,252254722,1697473,234684,252489406,249877639
29378552_234758,CM021104.1,5,29378552,252254722,1697473,234758,252489480,249877713
29378552_234806,CM021104.1,5,29378552,252254722,1697473,234806,252489528,249877761
29378552_234989,CM021104.1,5,29378552,252254722,1697473,234989,252489711,249877944
29378552_235021,CM021104.1,5,29378552,252254722,1697473,235021,252489743,249877976
29378552_235034,CM021104.1,5,29378552,252254722,1697473,235034,252489756,249877989
29378552_235068,CM021104.1,5,29378552,252254722,1697473,235068,252489790,249878023
29378552_235127,CM021104.1,5,29378552,252254722,1697473,235127,252489849,249878082
29378552_241478,CM021104.1,5,29378552,252254722,1697473,241478,252496200,249884433
29378552_241479,CM021104.1,5,29378552,252254722,1697473,241479,252496201,249884434
29378552_241480,CM021104.1,5,29378552,252254722,1697473,241480,252496202,249884435
29378552_241528,CM021104.1,5,29378552,252254722,1697473,241528,252496250,249884483
29378552_241604,CM021104.1,5,29378552,252254722,1697473,241604,252496326,249884559
29378552_241678,CM021104.1,5,29378552,252254722,1697473,241678,252496400,249884633
29378552_255735,CM021104.1,5,29378552,252254722,1697473,255735,252510457,249898690
29378552_255736,CM021104.1,5,29378552,252254722,1697473,255736,252510458,249898691
29378552_255808,CM021104.1,5,29378552,252254722,1697473,255808,252510530,249898763
29378552_264094,CM021104.1,5,29378552,252254722,1697473,264094,252518816,249907049
29381003_308479,CM021104.1,5,29381003,252251440,5548828,308479,252559919,249948152
29377770_324485,CM021104.1,5,29377770,252241378,2335283,324485,252565863,249954096
29378552_312789,CM021104.1,5,29378552,252254722,1697473,312789,252567511,249955744
29378552_312866,CM021104.1,5,29378552,252254722,1697473,312866,252567588,249955821
29378552_312888,CM021104.1,5,29378552,252254722,1697473,312888,252567610,249955843
29378552_313018,CM021104.1,5,29378552,252254722,1697473,313018,252567740,249955973
29381622_323776,CM021104.1,5,29381622,252254785,1538585,323776,252578561,249966794
29381622_323794,CM021104.1,5,29381622,252254785,1538585,323794,252578579,249966812
29381622_332317,CM021104.1,5,29381622,252254785,1538585,332317,252587102,249975335
29381622_332401,CM021104.1,5,29381622,252254785,1538585,332401,252587186,249975419
29379061_349109,CM021104.1,5,29379061,252253316,4183276,349109,252602425,249990658
29379061_349210,CM021104.1,5,29379061,252253316,4183276,349210,252602526,249990759
29377770_382965,CM021104.1,5,29377770,252241378,2335283,382965,252624343,250012576
29377770_383240,CM021104.1,5,29377770,252241378,2335283,383240,252624618,250012851
29377770_383357,CM021104.1,5,29377770,252241378,2335283,383357,252624735,250012968
29377770_383358,CM021104.1,5,29377770,252241378,2335283,383358,252624736,250012969
29379517_388078,CM021104.1,5,29379517,252243121,1440971,388078,252631199,250019432
29377770_409554,CM021104.1,5,29377770,252241378,2335283,409554,252650932,250039165
29377770_409583,CM021104.1,5,29377770,252241378,2335283,409583,252650961,250039194
29379957_419968,CM021104.1,5,29379957,252252455,1548355,419968,252672423,250060656
29379957_423522,CM021104.1,5,29379957,252252455,1548355,423522,252675977,250064210
29379957_423621,CM021104.1,5,29379957,252252455,1548355,423621,252676076,250064309
29379957_426219,CM021104.1,5,29379957,252252455,1548355,426219,252678674,250066907
29379957_426269,CM021104.1,5,29379957,252252455,1548355,426269,252678724,250066957
29379957_426332,CM021104.1,5,29379957,252252455,1548355,426332,252678787,250067020
29382018_606280,CM021104.1,5,29382018,252252673,749258,606280,252858953,250247186
29380998_619407,CM021104.1,5,29380998,252253342,2072406,619407,252872749,250260982
29381791_624735,CM021104.1,5,29381791,252252282,3314297,624735,252877017,250265250
29379517_658550,CM021104.1,5,29379517,252243121,1440971,658550,252901671,250289904
29379517_659250,CM021104.1,5,29379517,252243121,1440971,659250,252902371,250290604
29382018_684790,CM021104.1,5,29382018,252252673,749258,684790,252937463,250325696
29382018_684802,CM021104.1,5,29382018,252252673,749258,684802,252937475,250325708
29382018_684820,CM021104.1,5,29382018,252252673,749258,684820,252937493,250325726
29382018_684942,CM021104.1,5,29382018,252252673,749258,684942,252937615,250325848
29382018_684960,CM021104.1,5,29382018,252252673,749258,684960,252937633,250325866
29382018_684983,CM021104.1,5,29382018,252252673,749258,684983,252937656,250325889
29379061_685030,CM021104.1,5,29379061,252253316,4183276,685030,252938346,250326579
29379061_685063,CM021104.1,5,29379061,252253316,4183276,685063,252938379,250326612
29379061_685068,CM021104.1,5,29379061,252253316,4183276,685068,252938384,250326617
29379061_685226,CM021104.1,5,29379061,252253316,4183276,685226,252938542,250326775
29380477_737213,CM021104.1,5,29380477,252252156,2158290,737213,252989369,250377602
29379957_759394,CM021104.1,5,29379957,252252455,1548355,759394,253011849,250400082
29379957_759421,CM021104.1,5,29379957,252252455,1548355,759421,253011876,250400109
29379957_759474,CM021104.1,5,29379957,252252455,1548355,759474,253011929,250400162
29379957_759480,CM021104.1,5,29379957,252252455,1548355,759480,253011935,250400168
29379957_759554,CM021104.1,5,29379957,252252455,1548355,759554,253012009,250400242
29379957_764514,CM021104.1,5,29379957,252252455,1548355,764514,253016969,250405202
29379957_764590,CM021104.1,5,29379957,252252455,1548355,764590,253017045,250405278
29379957_765252,CM021104.1,5,29379957,252252455,1548355,765252,253017707,250405940
29377770_806343,CM021104.1,5,29377770,252241378,2335283,806343,253047721,250435954
29377770_806383,CM021104.1,5,29377770,252241378,2335283,806383,253047761,250435994
29377770_806400,CM021104.1,5,29377770,252241378,2335283,806400,253047778,250436011
29377770_806420,CM021104.1,5,29377770,252241378,2335283,806420,253047798,250436031
29377770_809475,CM021104.1,5,29377770,252241378,2335283,809475,253050853,250439086
29377770_809478,CM021104.1,5,29377770,252241378,2335283,809478,253050856,250439089
29377770_809605,CM021104.1,5,29377770,252241378,2335283,809605,253050983,250439216
29377770_818713,CM021104.1,5,29377770,252241378,2335283,818713,253060091,250448324
29380477_817958,CM021104.1,5,29380477,252252156,2158290,817958,253070114,250458347
29380477_819935,CM021104.1,5,29380477,252252156,2158290,819935,253072091,250460324
29380477_819982,CM021104.1,5,29380477,252252156,2158290,819982,253072138,250460371
29380477_820408,CM021104.1,5,29380477,252252156,2158290,820408,253072564,250460797
29380477_820437,CM021104.1,5,29380477,252252156,2158290,820437,253072593,250460826
29379417_827006,CM021104.1,5,29379417,252253290,1431266,827006,253080296,250468529
29379417_827162,CM021104.1,5,29379417,252253290,1431266,827162,253080452,250468685
29379417_827230,CM021104.1,5,29379417,252253290,1431266,827230,253080520,250468753
29381893_833437,CM021104.1,5,29381893,252252910,4678128,833437,253086347,250474580
29381893_875834,CM021104.1,5,29381893,252252910,4678128,875834,253128744,250516977
29377068_896554,CM021104.1,5,29377068,252245728,3267364,896554,253142282,250530515
29377343_898646,CM021104.1,5,29377343,252252166,5353630,898646,253150812,250539045
29377343_898821,CM021104.1,5,29377343,252252166,5353630,898821,253150987,250539220
29379417_916305,CM021104.1,5,29379417,252253290,1431266,916305,253169595,250557828
29382500_962119,CM021104.1,5,29382500,252252257,2718258,962119,253214376,250602609
29382500_962159,CM021104.1,5,29382500,252252257,2718258,962159,253214416,250602649
29382500_962178,CM021104.1,5,29382500,252252257,2718258,962178,253214435,250602668
29382500_962350,CM021104.1,5,29382500,252252257,2718258,962350,253214607,250602840
29382500_962377,CM021104.1,5,29382500,252252257,2718258,962377,253214634,250602867
29381699_994787,CM021104.1,5,29381699,252251576,1829284,994787,253246363,250634596
29381699_994800,CM021104.1,5,29381699,252251576,1829284,994800,253246376,250634609
29381699_994839,CM021104.1,5,29381699,252251576,1829284,994839,253246415,250634648
29381699_994842,CM021104.1,5,29381699,252251576,1829284,994842,253246418,250634651
29381699_994862,CM021104.1,5,29381699,252251576,1829284,994862,253246438,250634671
29381699_994866,CM021104.1,5,29381699,252251576,1829284,994866,253246442,250634675
29381275_1048139,CM021104.1,5,29381275,252252449,1240105,1048139,253300588,250688821
29381275_1048219,CM021104.1,5,29381275,252252449,1240105,1048219,253300668,250688901
29379957_1060735,CM021104.1,5,29379957,252252455,1548355,1060735,253313190,250701423
29379957_1060989,CM021104.1,5,29379957,252252455,1548355,1060989,253313444,250701677
29381699_1074836,CM021104.1,5,29381699,252251576,1829284,1074836,253326412,250714645
29381699_1075199,CM021104.1,5,29381699,252251576,1829284,1075199,253326775,250715008
29381699_1075248,CM021104.1,5,29381699,252251576,1829284,1075248,253326824,250715057
29381699_1075480,CM021104.1,5,29381699,252251576,1829284,1075480,253327056,250715289
29380477_1164091,CM021104.1,5,29380477,252252156,2158290,1164091,253416247,250804480
29380477_1164092,CM021104.1,5,29380477,252252156,2158290,1164092,253416248,250804481
29380477_1176322,CM021104.1,5,29380477,252252156,2158290,1176322,253428478,250816711
29380477_1176363,CM021104.1,5,29380477,252252156,2158290,1176363,253428519,250816752
29380477_1176505,CM021104.1,5,29380477,252252156,2158290,1176505,253428661,250816894
29380477_1176515,CM021104.1,5,29380477,252252156,2158290,1176515,253428671,250816904
29380477_1176516,CM021104.1,5,29380477,252252156,2158290,1176516,253428672,250816905
29380477_1223489,CM021104.1,5,29380477,252252156,2158290,1223489,253475645,250863878
29381003_1251305,CM021104.1,5,29381003,252251440,5548828,1251305,253502745,250890978
29380998_1280395,CM021104.1,5,29380998,252253342,2072406,1280395,253533737,250921970
29381893_1299400,CM021104.1,5,29381893,252252910,4678128,1299400,253552310,250940543
29377788_1397247,CM021104.1,5,29377788,252251529,1414342,1397247,253648776,251037009
29377788_1397249,CM021104.1,5,29377788,252251529,1414342,1397249,253648778,251037011
29377788_1397287,CM021104.1,5,29377788,252251529,1414342,1397287,253648816,251037049
29377788_1401247,CM021104.1,5,29377788,252251529,1414342,1401247,253652776,251041009
29377788_1401320,CM021104.1,5,29377788,252251529,1414342,1401320,253652849,251041082
29377788_1401330,CM021104.1,5,29377788,252251529,1414342,1401330,253652859,251041092
29377788_1401337,CM021104.1,5,29377788,252251529,1414342,1401337,253652866,251041099
29381622_1495222,CM021104.1,5,29381622,252254785,1538585,1495222,253750007,251138240
29382500_1514987,CM021104.1,5,29382500,252252257,2718258,1514987,253767244,251155477
29382500_1515069,CM021104.1,5,29382500,252252257,2718258,1515069,253767326,251155559
29382500_1515107,CM021104.1,5,29382500,252252257,2718258,1515107,253767364,251155597
29382500_1515118,CM021104.1,5,29382500,252252257,2718258,1515118,253767375,251155608
29382500_1515197,CM021104.1,5,29382500,252252257,2718258,1515197,253767454,251155687
29382500_1515198,CM021104.1,5,29382500,252252257,2718258,1515198,253767455,251155688
29382500_1515216,CM021104.1,5,29382500,252252257,2718258,1515216,253767473,251155706
29380477_1533002,CM021104.1,5,29380477,252252156,2158290,1533002,253785158,251173391
29382500_1558642,CM021104.1,5,29382500,252252257,2718258,1558642,253810899,251199132
29382500_1558658,CM021104.1,5,29382500,252252257,2718258,1558658,253810915,251199148
29382500_1558745,CM021104.1,5,29382500,252252257,2718258,1558745,253811002,251199235
29382500_1558749,CM021104.1,5,29382500,252252257,2718258,1558749,253811006,251199239
29382500_1558766,CM021104.1,5,29382500,252252257,2718258,1558766,253811023,251199256
29382500_1558796,CM021104.1,5,29382500,252252257,2718258,1558796,253811053,251199286
29382102_1569089,CM021104.1,5,29382102,252252299,4964630,1569089,253821388,251209621
29382102_1569101,CM021104.1,5,29382102,252252299,4964630,1569101,253821400,251209633
29382102_1569162,CM021104.1,5,29382102,252252299,4964630,1569162,253821461,251209694
29382102_1569572,CM021104.1,5,29382102,252252299,4964630,1569572,253821871,251210104
29382102_1569575,CM021104.1,5,29382102,252252299,4964630,1569575,253821874,251210107
29382102_1569576,CM021104.1,5,29382102,252252299,4964630,1569576,253821875,251210108
29382102_1569621,CM021104.1,5,29382102,252252299,4964630,1569621,253821920,251210153
29382500_1600014,CM021104.1,5,29382500,252252257,2718258,1600014,253852271,251240504
29382500_1600357,CM021104.1,5,29382500,252252257,2718258,1600357,253852614,251240847
29382500_1600369,CM021104.1,5,29382500,252252257,2718258,1600369,253852626,251240859
29382500_1600392,CM021104.1,5,29382500,252252257,2718258,1600392,253852649,251240882
29382500_1600447,CM021104.1,5,29382500,252252257,2718258,1600447,253852704,251240937
29381893_1612874,CM021104.1,5,29381893,252252910,4678128,1612874,253865784,251254017
29381893_1612877,CM021104.1,5,29381893,252252910,4678128,1612877,253865787,251254020
29381893_1612878,CM021104.1,5,29381893,252252910,4678128,1612878,253865788,251254021
29381893_1612904,CM021104.1,5,29381893,252252910,4678128,1612904,253865814,251254047
29381893_1612930,CM021104.1,5,29381893,252252910,4678128,1612930,253865840,251254073
29381893_1612969,CM021104.1,5,29381893,252252910,4678128,1612969,253865879,251254112
29381893_1612983,CM021104.1,5,29381893,252252910,4678128,1612983,253865893,251254126
29381893_1612989,CM021104.1,5,29381893,252252910,4678128,1612989,253865899,251254132
29381893_1613006,CM021104.1,5,29381893,252252910,4678128,1613006,253865916,251254149
29380477_1619897,CM021104.1,5,29380477,252252156,2158290,1619897,253872053,251260286
29377693_1693820,CM021104.1,5,29377693,252251666,3575591,1693820,253945486,251333719
29377693_1736454,CM021104.1,5,29377693,252251666,3575591,1736454,253988120,251376353
29377693_1736787,CM021104.1,5,29377693,252251666,3575591,1736787,253988453,251376686
29377911_1940661,CM021104.1,5,29377911,252253387,2163219,1940661,254194048,251582281
29377911_1940703,CM021104.1,5,29377911,252253387,2163219,1940703,254194090,251582323
29379226_2028143,CM021104.1,5,29379226,252241376,4437285,2028143,254269519,251657752
29379226_2028198,CM021104.1,5,29379226,252241376,4437285,2028198,254269574,251657807
29379226_2028209,CM021104.1,5,29379226,252241376,4437285,2028209,254269585,251657818
29379226_2046893,CM021104.1,5,29379226,252241376,4437285,2046893,254288269,251676502
29379226_2046967,CM021104.1,5,29379226,252241376,4437285,2046967,254288343,251676576
29379226_2046973,CM021104.1,5,29379226,252241376,4437285,2046973,254288349,251676582
29379226_2047014,CM021104.1,5,29379226,252241376,4437285,2047014,254288390,251676623
29381893_2055360,CM021104.1,5,29381893,252252910,4678128,2055360,254308270,251696503
29377520_2097535,CM021104.1,5,29377520,252251971,6051951,2097535,254349506,251737739
29377520_2097585,CM021104.1,5,29377520,252251971,6051951,2097585,254349556,251737789
29377520_2097624,CM021104.1,5,29377520,252251971,6051951,2097624,254349595,251737828
29377520_2097643,CM021104.1,5,29377520,252251971,6051951,2097643,254349614,251737847
29377520_2097661,CM021104.1,5,29377520,252251971,6051951,2097661,254349632,251737865
29377520_2098603,CM021104.1,5,29377520,252251971,6051951,2098603,254350574,251738807
29377520_2098617,CM021104.1,5,29377520,252251971,6051951,2098617,254350588,251738821
29377068_2187279,CM021104.1,5,29377068,252245728,3267364,2187279,254433007,251821240
29377068_2187289,CM021104.1,5,29377068,252245728,3267364,2187289,254433017,251821250
29377068_2187291,CM021104.1,5,29377068,252245728,3267364,2187291,254433019,251821252
29377068_2187317,CM021104.1,5,29377068,252245728,3267364,2187317,254433045,251821278
29379226_2208379,CM021104.1,5,29379226,252241376,4437285,2208379,254449755,251837988
29377068_2265395,CM021104.1,5,29377068,252245728,3267364,2265395,254511123,251899356
29377068_2265486,CM021104.1,5,29377068,252245728,3267364,2265486,254511214,251899447
29379226_2281853,CM021104.1,5,29379226,252241376,4437285,2281853,254523229,251911462
29382102_2309570,CM021104.1,5,29382102,252252299,4964630,2309570,254561869,251950102
29382102_2309685,CM021104.1,5,29382102,252252299,4964630,2309685,254561984,251950217
29382102_2309825,CM021104.1,5,29382102,252252299,4964630,2309825,254562124,251950357
29382102_2348339,CM021104.1,5,29382102,252252299,4964630,2348339,254600638,251988871
29382102_2348449,CM021104.1,5,29382102,252252299,4964630,2348449,254600748,251988981
29382102_2348467,CM021104.1,5,29382102,252252299,4964630,2348467,254600766,251988999
29382102_2418365,CM021104.1,5,29382102,252252299,4964630,2418365,254670664,252058897
29379061_2523629,CM021104.1,5,29379061,252253316,4183276,2523629,254776945,252165178
29379061_2526231,CM021104.1,5,29379061,252253316,4183276,2526231,254779547,252167780
29379061_2526247,CM021104.1,5,29379061,252253316,4183276,2526247,254779563,252167796
29379061_2526250,CM021104.1,5,29379061,252253316,4183276,2526250,254779566,252167799
29379061_2526270,CM021104.1,5,29379061,252253316,4183276,2526270,254779586,252167819
29382102_2620037,CM021104.1,5,29382102,252252299,4964630,2620037,254872336,252260569
29382102_2632629,CM021104.1,5,29382102,252252299,4964630,2632629,254884928,252273161
29382102_2632630,CM021104.1,5,29382102,252252299,4964630,2632630,254884929,252273162
29382102_2632636,CM021104.1,5,29382102,252252299,4964630,2632636,254884935,252273168
29382102_2633005,CM021104.1,5,29382102,252252299,4964630,2633005,254885304,252273537
29377343_2871206,CM021104.1,5,29377343,252252166,5353630,2871206,255123372,252511605
29379061_3171229,CM021104.1,5,29379061,252253316,4183276,3171229,255424545,252812778
29379061_3171351,CM021104.1,5,29379061,252253316,4183276,3171351,255424667,252812900
29381003_3229562,CM021104.1,5,29381003,252251440,5548828,3229562,255481002,252869235
29381003_3229572,CM021104.1,5,29381003,252251440,5548828,3229572,255481012,252869245
29377343_3563776,CM021104.1,5,29377343,252252166,5353630,3563776,255815942,253204175
29381003_3698499,CM021104.1,5,29381003,252251440,5548828,3698499,255949939,253338172
29381003_3699007,CM021104.1,5,29381003,252251440,5548828,3699007,255950447,253338680
29381003_3699029,CM021104.1,5,29381003,252251440,5548828,3699029,255950469,253338702
29381003_3704775,CM021104.1,5,29381003,252251440,5548828,3704775,255956215,253344448
29377520_3798751,CM021104.1,5,29377520,252251971,6051951,3798751,256050722,253438955
29378070_3838145,CM021104.1,5,29378070,252252433,5969442,3838145,256090578,253478811
29378070_3838382,CM021104.1,5,29378070,252252433,5969442,3838382,256090815,253479048
29381893_4033953,CM021104.1,5,29381893,252252910,4678128,4033953,256286863,253675096
29379226_4112793,CM021104.1,5,29379226,252241376,4437285,4112793,256354169,253742402
29379226_4127506,CM021104.1,5,29379226,252241376,4437285,4127506,256368882,253757115
29381003_4128096,CM021104.1,5,29381003,252251440,5548828,4128096,256379536,253767769
29381003_4128382,CM021104.1,5,29381003,252251440,5548828,4128382,256379822,253768055
29379226_4184827,CM021104.1,5,29379226,252241376,4437285,4184827,256426203,253814436
29379226_4206692,CM021104.1,5,29379226,252241376,4437285,4206692,256448068,253836301
29379226_4206770,CM021104.1,5,29379226,252241376,4437285,4206770,256448146,253836379
29381893_4198007,CM021104.1,5,29381893,252252910,4678128,4198007,256450917,253839150
29381893_4198113,CM021104.1,5,29381893,252252910,4678128,4198113,256451023,253839256
29381893_4198729,CM021104.1,5,29381893,252252910,4678128,4198729,256451639,253839872
29381893_4198764,CM021104.1,5,29381893,252252910,4678128,4198764,256451674,253839907
29381893_4198773,CM021104.1,5,29381893,252252910,4678128,4198773,256451683,253839916
29381893_4198781,CM021104.1,5,29381893,252252910,4678128,4198781,256451691,253839924
29379226_4213302,CM021104.1,5,29379226,252241376,4437285,4213302,256454678,253842911
29379226_4213313,CM021104.1,5,29379226,252241376,4437285,4213313,256454689,253842922
29379226_4213378,CM021104.1,5,29379226,252241376,4437285,4213378,256454754,253842987
29379226_4220399,CM021104.1,5,29379226,252241376,4437285,4220399,256461775,253850008
29379226_4220452,CM021104.1,5,29379226,252241376,4437285,4220452,256461828,253850061
29379226_4226933,CM021104.1,5,29379226,252241376,4437285,4226933,256468309,253856542
29379226_4226981,CM021104.1,5,29379226,252241376,4437285,4226981,256468357,253856590
29379226_4227881,CM021104.1,5,29379226,252241376,4437285,4227881,256469257,253857490
29382102_4245254,CM021104.1,5,29382102,252252299,4964630,4245254,256497553,253885786
29382102_4318389,CM021104.1,5,29382102,252252299,4964630,4318389,256570688,253958921
29377343_4325434,CM021104.1,5,29377343,252252166,5353630,4325434,256577600,253965833
29381003_4360480,CM021104.1,5,29381003,252251440,5548828,4360480,256611920,254000153
29381003_4360652,CM021104.1,5,29381003,252251440,5548828,4360652,256612092,254000325
29382102_4426440,CM021104.1,5,29382102,252252299,4964630,4426440,256678739,254066972
29382102_4426462,CM021104.1,5,29382102,252252299,4964630,4426462,256678761,254066994
29382102_4427027,CM021104.1,5,29382102,252252299,4964630,4427027,256679326,254067559
29381003_4526013,CM021104.1,5,29381003,252251440,5548828,4526013,256777453,254165686
29381003_4526111,CM021104.1,5,29381003,252251440,5548828,4526111,256777551,254165784
29378070_4545377,CM021104.1,5,29378070,252252433,5969442,4545377,256797810,254186043
29378070_4546698,CM021104.1,5,29378070,252252433,5969442,4546698,256799131,254187364
29378070_4546742,CM021104.1,5,29378070,252252433,5969442,4546742,256799175,254187408
29378070_4550681,CM021104.1,5,29378070,252252433,5969442,4550681,256803114,254191347
29378070_4570683,CM021104.1,5,29378070,252252433,5969442,4570683,256823116,254211349
29378070_4570701,CM021104.1,5,29378070,252252433,5969442,4570701,256823134,254211367
29378070_4573616,CM021104.1,5,29378070,252252433,5969442,4573616,256826049,254214282
29377343_4860136,CM021104.1,5,29377343,252252166,5353630,4860136,257112302,254500535
29382102_4863999,CM021104.1,5,29382102,252252299,4964630,4863999,257116298,254504531
29382102_4864001,CM021104.1,5,29382102,252252299,4964630,4864001,257116300,254504533
29382102_4864002,CM021104.1,5,29382102,252252299,4964630,4864002,257116301,254504534
29382102_4864034,CM021104.1,5,29382102,252252299,4964630,4864034,257116333,254504566
29382102_4864078,CM021104.1,5,29382102,252252299,4964630,4864078,257116377,254504610
29382102_4864124,CM021104.1,5,29382102,252252299,4964630,4864124,257116423,254504656
29382102_4864141,CM021104.1,5,29382102,252252299,4964630,4864141,257116440,254504673
29382102_4864426,CM021104.1,5,29382102,252252299,4964630,4864426,257116725,254504958
29377343_4865324,CM021104.1,5,29377343,252252166,5353630,4865324,257117490,254505723
29381003_4940569,CM021104.1,5,29381003,252251440,5548828,4940569,257192009,254580242
29378070_5190368,CM021104.1,5,29378070,252252433,5969442,5190368,257442801,254831034
29378070_5190383,CM021104.1,5,29378070,252252433,5969442,5190383,257442816,254831049
29378070_5190410,CM021104.1,5,29378070,252252433,5969442,5190410,257442843,254831076
29378070_5436819,CM021104.1,5,29378070,252252433,5969442,5436819,257689252,255077485
29378070_5436866,CM021104.1,5,29378070,252252433,5969442,5436866,257689299,255077532
29378070_5437994,CM021104.1,5,29378070,252252433,5969442,5437994,257690427,255078660
29378070_5455988,CM021104.1,5,29378070,252252433,5969442,5455988,257708421,255096654
28166317_1056,CM021104.1,5,28166317,283416082,2200,1056,283417138,280805371
29350076_69338,CM021104.1,5,29350076,314076071,134578,69338,314145409,311533642
29350076_69344,CM021104.1,5,29350076,314076071,134578,69344,314145415,311533648
29350076_69375,CM021104.1,5,29350076,314076071,134578,69375,314145446,311533679
29350076_69379,CM021104.1,5,29350076,314076071,134578,69379,314145450,311533683
29350076_69409,CM021104.1,5,29350076,314076071,134578,69409,314145480,311533713
29382494_78347,CM021104.1,5,29382494,314076730,141558,78347,314155077,311543310
29350076_112937,CM021104.1,5,29350076,314076071,134578,112937,314189008,311577241
29350076_112944,CM021104.1,5,29350076,314076071,134578,112944,314189015,311577248
29350076_112974,CM021104.1,5,29350076,314076071,134578,112974,314189045,311577278
29350076_112987,CM021104.1,5,29350076,314076071,134578,112987,314189058,311577291
29350076_112991,CM021104.1,5,29350076,314076071,134578,112991,314189062,311577295
29350076_113069,CM021104.1,5,29350076,314076071,134578,113069,314189140,311577373
29350076_113119,CM021104.1,5,29350076,314076071,134578,113119,314189190,311577423
29350076_113195,CM021104.1,5,29350076,314076071,134578,113195,314189266,311577499
29377960_135464,CM021104.1,5,29377960,314075156,1526779,135464,314210620,311598853
29380899_183111,CM021104.1,5,29380899,314074830,1005077,183111,314257941,311646174
29380899_183130,CM021104.1,5,29380899,314074830,1005077,183130,314257960,311646193
29380899_183228,CM021104.1,5,29380899,314074830,1005077,183228,314258058,311646291
29379418_466589,CM021104.1,5,29379418,314075138,1641934,466589,314541727,311929960
29379418_466663,CM021104.1,5,29379418,314075138,1641934,466663,314541801,311930034
29379418_466673,CM021104.1,5,29379418,314075138,1641934,466673,314541811,311930044
29379418_466708,CM021104.1,5,29379418,314075138,1641934,466708,314541846,311930079
29379418_466781,CM021104.1,5,29379418,314075138,1641934,466781,314541919,311930152
29379418_466803,CM021104.1,5,29379418,314075138,1641934,466803,314541941,311930174
29379418_466978,CM021104.1,5,29379418,314075138,1641934,466978,314542116,311930349
29379418_466980,CM021104.1,5,29379418,314075138,1641934,466980,314542118,311930351
29379418_467088,CM021104.1,5,29379418,314075138,1641934,467088,314542226,311930459
29379418_467089,CM021104.1,5,29379418,314075138,1641934,467089,314542227,311930460
29381422_556101,CM021104.1,5,29381422,314076405,1027964,556101,314632506,312020739
29381422_586908,CM021104.1,5,29381422,314076405,1027964,586908,314663313,312051546
29381422_586976,CM021104.1,5,29381422,314076405,1027964,586976,314663381,312051614
29381422_689505,CM021104.1,5,29381422,314076405,1027964,689505,314765910,312154143
29377157_758275,CM021104.1,5,29377157,314075880,771788,758275,314834155,312222388
29377098_934408,CM021104.1,5,29377098,314076189,1448565,934408,315010597,312398830
29377098_934438,CM021104.1,5,29377098,314076189,1448565,934438,315010627,312398860
29377098_934439,CM021104.1,5,29377098,314076189,1448565,934439,315010628,312398861
29377098_934457,CM021104.1,5,29377098,314076189,1448565,934457,315010646,312398879
29377098_934492,CM021104.1,5,29377098,314076189,1448565,934492,315010681,312398914
29377098_934527,CM021104.1,5,29377098,314076189,1448565,934527,315010716,312398949
29379199_969630,CM021104.1,5,29379199,314075363,1147721,969630,315044993,312433226
29379199_969643,CM021104.1,5,29379199,314075363,1147721,969643,315045006,312433239
29379418_1260994,CM021104.1,5,29379418,314075138,1641934,1260994,315336132,312724365
29379418_1261040,CM021104.1,5,29379418,314075138,1641934,1261040,315336178,312724411
29379418_1261046,CM021104.1,5,29379418,314075138,1641934,1261046,315336184,312724417
29379418_1261049,CM021104.1,5,29379418,314075138,1641934,1261049,315336187,312724420
29379418_1261644,CM021104.1,5,29379418,314075138,1641934,1261644,315336782,312725015
29379418_1261662,CM021104.1,5,29379418,314075138,1641934,1261662,315336800,312725033
29377244_1935565,CM021104.1,5,29377244,314076242,2177568,1935565,316011807,313400040
29377244_1935569,CM021104.1,5,29377244,314076242,2177568,1935569,316011811,313400044
29378203_91964,CM021104.1,5,29378203,324599256,313650,91964,324691220,322079453
29378203_91987,CM021104.1,5,29378203,324599256,313650,91987,324691243,322079476
29378203_97927,CM021104.1,5,29378203,324599256,313650,97927,324697183,322085416
29378203_97985,CM021104.1,5,29378203,324599256,313650,97985,324697241,322085474
29378203_98036,CM021104.1,5,29378203,324599256,313650,98036,324697292,322085525
29378203_98181,CM021104.1,5,29378203,324599256,313650,98181,324697437,322085670
29378203_99504,CM021104.1,5,29378203,324599256,313650,99504,324698760,322086993
29378203_99525,CM021104.1,5,29378203,324599256,313650,99525,324698781,322087014
29378203_99548,CM021104.1,5,29378203,324599256,313650,99548,324698804,322087037
29378203_106203,CM021104.1,5,29378203,324599256,313650,106203,324705459,322093692
29378203_106230,CM021104.1,5,29378203,324599256,313650,106230,324705486,322093719
29378203_106253,CM021104.1,5,29378203,324599256,313650,106253,324705509,322093742
293713381_657571,CM021104.1,5,293713381,328410980,671596,657571,329068551,326456784
29380906_72773,CM021104.1,5,29380906,361218581,173842,72773,361291354,358679587
29380906_72803,CM021104.1,5,29380906,361218581,173842,72803,361291384,358679617
29377905_105557,CM021104.1,5,29377905,361303071,783919,105557,361408628,358796861
29377905_105664,CM021104.1,5,29377905,361303071,783919,105664,361408735,358796968
29380105_126061,CM021104.1,5,29380105,361307842,1589877,126061,361433903,358822136
29377905_134425,CM021104.1,5,29377905,361303071,783919,134425,361437496,358825729
29380812_166923,CM021104.1,5,29380812,361303069,6936188,166923,361469992,358858225
29379826_202882,CM021104.1,5,29379826,361303071,1419036,202882,361505953,358894186
29380812_242401,CM021104.1,5,29380812,361303069,6936188,242401,361545470,358933703
29380812_253641,CM021104.1,5,29380812,361303069,6936188,253641,361556710,358944943
29380812_253709,CM021104.1,5,29380812,361303069,6936188,253709,361556778,358945011
29382255_267872,CM021104.1,5,29382255,361306802,2412246,267872,361574674,358962907
29380105_270198,CM021104.1,5,29380105,361307842,1589877,270198,361578040,358966273
29380105_270231,CM021104.1,5,29380105,361307842,1589877,270231,361578073,358966306
29380046_300192,CM021104.1,5,29380046,361303065,2875191,300192,361603257,358991490
29380421_387969,CM021104.1,5,29380421,361218580,396212,387969,361606549,358994782
29380421_387990,CM021104.1,5,29380421,361218580,396212,387990,361606570,358994803
29380105_337185,CM021104.1,5,29380105,361307842,1589877,337185,361645027,359033260
29380105_337237,CM021104.1,5,29380105,361307842,1589877,337237,361645079,359033312
29377905_372232,CM021104.1,5,29377905,361303071,783919,372232,361675303,359063536
29377905_372328,CM021104.1,5,29377905,361303071,783919,372328,361675399,359063632
29380105_378909,CM021104.1,5,29380105,361307842,1589877,378909,361686751,359074984
29380105_379021,CM021104.1,5,29380105,361307842,1589877,379021,361686863,359075096
29379826_428116,CM021104.1,5,29379826,361303071,1419036,428116,361731187,359119420
29380105_478395,CM021104.1,5,29380105,361307842,1589877,478395,361786237,359174470
29380105_478491,CM021104.1,5,29380105,361307842,1589877,478491,361786333,359174566
29378375_620073,CM021104.1,5,29378375,361218584,787655,620073,361838657,359226890
29380105_577248,CM021104.1,5,29380105,361307842,1589877,577248,361885090,359273323
29380105_577279,CM021104.1,5,29380105,361307842,1589877,577279,361885121,359273354
29378674_611828,CM021104.1,5,29378674,361303067,929401,611828,361914895,359303128
29378969_832784,CM021104.1,5,29378969,361305181,1365687,832784,362137965,359526198
29379826_905893,CM021104.1,5,29379826,361303071,1419036,905893,362208964,359597197
29379826_905927,CM021104.1,5,29379826,361303071,1419036,905927,362208998,359597231
29378969_925349,CM021104.1,5,29378969,361305181,1365687,925349,362230530,359618763
29378969_925350,CM021104.1,5,29378969,361305181,1365687,925350,362230531,359618764
29378969_925424,CM021104.1,5,29378969,361305181,1365687,925424,362230605,359618838
29378969_928324,CM021104.1,5,29378969,361305181,1365687,928324,362233505,359621738
29378969_928346,CM021104.1,5,29378969,361305181,1365687,928346,362233527,359621760
29378969_928442,CM021104.1,5,29378969,361305181,1365687,928442,362233623,359621856
29378969_928530,CM021104.1,5,29378969,361305181,1365687,928530,362233711,359621944
29378969_928542,CM021104.1,5,29378969,361305181,1365687,928542,362233723,359621956
29378969_928660,CM021104.1,5,29378969,361305181,1365687,928660,362233841,359622074
29378969_928698,CM021104.1,5,29378969,361305181,1365687,928698,362233879,359622112
29381370_974297,CM021104.1,5,29381370,361303071,2636924,974297,362277368,359665601
29381370_974387,CM021104.1,5,29381370,361303071,2636924,974387,362277458,359665691
29381370_980340,CM021104.1,5,29381370,361303071,2636924,980340,362283411,359671644
29381370_980347,CM021104.1,5,29381370,361303071,2636924,980347,362283418,359671651
29381370_980362,CM021104.1,5,29381370,361303071,2636924,980362,362283433,359671666
29378969_1113913,CM021104.1,5,29378969,361305181,1365687,1113913,362419094,359807327
29378969_1113919,CM021104.1,5,29378969,361305181,1365687,1113919,362419100,359807333
29378969_1127671,CM021104.1,5,29378969,361305181,1365687,1127671,362432852,359821085
29378969_1127682,CM021104.1,5,29378969,361305181,1365687,1127682,362432863,359821096
29378969_1127683,CM021104.1,5,29378969,361305181,1365687,1127683,362432864,359821097
29377598_13015,CM021104.1,5,29377598,363050220,337766,13015,363063235,360451468
29361372_16711,CM021104.1,5,29361372,363049056,524760,16711,363065767,360454000
29357552_44220,CM021104.1,5,29357552,363051711,115313,44220,363095931,360484164
29382255_2072706,CM021104.1,5,29382255,361306802,2412246,2072706,363379508,360767741
29382255_2072748,CM021104.1,5,29382255,361306802,2412246,2072748,363379550,360767783
29382255_2075318,CM021104.1,5,29382255,361306802,2412246,2075318,363382120,360770353
29361372_486987,CM021104.1,5,29361372,363049056,524760,486987,363536043,360924276
29378936_568566,CM021104.1,5,29378936,363049056,753149,568566,363617622,361005855
29378936_568609,CM021104.1,5,29378936,363049056,753149,568609,363617665,361005898
29378936_568629,CM021104.1,5,29378936,363049056,753149,568629,363617685,361005918
29378936_568671,CM021104.1,5,29378936,363049056,753149,568671,363617727,361005960
29378936_568687,CM021104.1,5,29378936,363049056,753149,568687,363617743,361005976
29378936_568705,CM021104.1,5,29378936,363049056,753149,568705,363617761,361005994
29378936_568743,CM021104.1,5,29378936,363049056,753149,568743,363617799,361006032
29381370_2419459,CM021104.1,5,29381370,361303071,2636924,2419459,363722530,361110763
29380046_2848644,CM021104.1,5,29380046,361303065,2875191,2848644,364151709,361539942
29380046_2848735,CM021104.1,5,29380046,361303065,2875191,2848735,364151800,361540033
29380812_6928684,CM021104.1,5,29380812,361303069,6936188,6928684,368231753,365619986
29364065_63291,CM021104.1,5,29364065,385990030,238558,63291,386053321,383441554
29364065_63324,CM021104.1,5,29364065,385990030,238558,63324,386053354,383441587
29364065_168584,CM021104.1,5,29364065,385990030,238558,168584,386158614,383546847
29378343_204460,CM021104.1,5,29378343,387993673,878509,204460,388198133,385586366
29378343_204509,CM021104.1,5,29378343,387993673,878509,204509,388198182,385586415
29378343_204511,CM021104.1,5,29378343,387993673,878509,204511,388198184,385586417
29378343_209347,CM021104.1,5,29378343,387993673,878509,209347,388203020,385591253
29381088_327218,CM021104.1,5,29381088,387993666,978873,327218,388320884,385709117
29381088_327335,CM021104.1,5,29381088,387993666,978873,327335,388321001,385709234
29381088_328725,CM021104.1,5,29381088,387993666,978873,328725,388322391,385710624
29381088_328824,CM021104.1,5,29381088,387993666,978873,328824,388322490,385710723
29380458_379653,CM021104.1,5,29380458,387993673,740030,379653,388373326,385761559
29380458_379666,CM021104.1,5,29380458,387993673,740030,379666,388373339,385761572
29380458_379692,CM021104.1,5,29380458,387993673,740030,379692,388373365,385761598
29379349_423340,CM021104.1,5,29379349,387993671,938436,423340,388417011,385805244
29379349_423470,CM021104.1,5,29379349,387993671,938436,423470,388417141,385805374
29379349_423506,CM021104.1,5,29379349,387993671,938436,423506,388417177,385805410
29379349_423507,CM021104.1,5,29379349,387993671,938436,423507,388417178,385805411
29379349_423512,CM021104.1,5,29379349,387993671,938436,423512,388417183,385805416
29379349_423528,CM021104.1,5,29379349,387993671,938436,423528,388417199,385805432
29379349_423537,CM021104.1,5,29379349,387993671,938436,423537,388417208,385805441
29379349_423564,CM021104.1,5,29379349,387993671,938436,423564,388417235,385805468
29382232_443361,CM021104.1,5,29382232,387993662,869031,443361,388437023,385825256
29382232_443375,CM021104.1,5,29382232,387993662,869031,443375,388437037,385825270
29382232_443437,CM021104.1,5,29382232,387993662,869031,443437,388437099,385825332
29378343_535164,CM021104.1,5,29378343,387993673,878509,535164,388528837,385917070
29378343_535243,CM021104.1,5,29378343,387993673,878509,535243,388528916,385917149
29378343_567385,CM021104.1,5,29378343,387993673,878509,567385,388561058,385949291
29379349_601387,CM021104.1,5,29379349,387993671,938436,601387,388595058,385983291
29379349_601393,CM021104.1,5,29379349,387993671,938436,601393,388595064,385983297
29379349_601434,CM021104.1,5,29379349,387993671,938436,601434,388595105,385983338
29379349_601465,CM021104.1,5,29379349,387993671,938436,601465,388595136,385983369
29379349_601472,CM021104.1,5,29379349,387993671,938436,601472,388595143,385983376
29379349_601521,CM021104.1,5,29379349,387993671,938436,601521,388595192,385983425
29379349_601564,CM021104.1,5,29379349,387993671,938436,601564,388595235,385983468
29379349_601596,CM021104.1,5,29379349,387993671,938436,601596,388595267,385983500
29379349_601604,CM021104.1,5,29379349,387993671,938436,601604,388595275,385983508
29381057_683167,CM021104.1,5,29381057,387993668,1589926,683167,388676835,386065068
29381088_923833,CM021104.1,5,29381088,387993666,978873,923833,388917499,386305732
29381088_923941,CM021104.1,5,29381088,387993666,978873,923941,388917607,386305840
29381088_928865,CM021104.1,5,29381088,387993666,978873,928865,388922531,386310764
29381088_928868,CM021104.1,5,29381088,387993666,978873,928868,388922534,386310767
29381088_929391,CM021104.1,5,29381088,387993666,978873,929391,388923057,386311290
29381088_929441,CM021104.1,5,29381088,387993666,978873,929441,388923107,386311340
29381088_929601,CM021104.1,5,29381088,387993666,978873,929601,388923267,386311500
29381088_929710,CM021104.1,5,29381088,387993666,978873,929710,388923376,386311609
29381088_971798,CM021104.1,5,29381088,387993666,978873,971798,388965464,386353697
29381088_971829,CM021104.1,5,29381088,387993666,978873,971829,388965495,386353728
29377909_1985546,CM021104.1,5,29377909,387993673,2649269,1985546,389979219,387367452
29377909_1985547,CM021104.1,5,29377909,387993673,2649269,1985547,389979220,387367453
29377909_1985550,CM021104.1,5,29377909,387993673,2649269,1985550,389979223,387367456
29377909_1985560,CM021104.1,5,29377909,387993673,2649269,1985560,389979233,387367466
29377909_1985588,CM021104.1,5,29377909,387993673,2649269,1985588,389979261,387367494
29377909_1985628,CM021104.1,5,29377909,387993673,2649269,1985628,389979301,387367534
29377909_1985662,CM021104.1,5,29377909,387993673,2649269,1985662,389979335,387367568
29377909_1985673,CM021104.1,5,29377909,387993673,2649269,1985673,389979346,387367579
29377909_1985682,CM021104.1,5,29377909,387993673,2649269,1985682,389979355,387367588
29377909_1985690,CM021104.1,5,29377909,387993673,2649269,1985690,389979363,387367596
29377909_1985704,CM021104.1,5,29377909,387993673,2649269,1985704,389979377,387367610
29377909_1985728,CM021104.1,5,29377909,387993673,2649269,1985728,389979401,387367634
29377909_2276998,CM021104.1,5,29377909,387993673,2649269,2276998,390270671,387658904
29377909_2277028,CM021104.1,5,29377909,387993673,2649269,2277028,390270701,387658934
29377909_2370690,CM021104.1,5,29377909,387993673,2649269,2370690,390364363,387752596
29377909_2370775,CM021104.1,5,29377909,387993673,2649269,2370775,390364448,387752681
29380897_128480,CM021104.1,5,29380897,405598189,1254565,128480,405726669,403114902
29381475_161438,CM021104.1,5,29381475,405598191,1146538,161438,405759629,403147862
29381475_161590,CM021104.1,5,29381475,405598191,1146538,161590,405759781,403148014
29381475_161640,CM021104.1,5,29381475,405598191,1146538,161640,405759831,403148064
29381475_162012,CM021104.1,5,29381475,405598191,1146538,162012,405760203,403148436
29381475_162115,CM021104.1,5,29381475,405598191,1146538,162115,405760306,403148539
29382164_201697,CM021104.1,5,29382164,405599567,1907967,201697,405801264,403189497
29382164_201730,CM021104.1,5,29382164,405599567,1907967,201730,405801297,403189530
29382164_201742,CM021104.1,5,29382164,405599567,1907967,201742,405801309,403189542
29381475_274655,CM021104.1,5,29381475,405598191,1146538,274655,405872846,403261079
29381475_304664,CM021104.1,5,29381475,405598191,1146538,304664,405902855,403291088
29381475_691748,CM021104.1,5,29381475,405598191,1146538,691748,406289939,403678172
29381475_691749,CM021104.1,5,29381475,405598191,1146538,691749,406289940,403678173
29381475_691785,CM021104.1,5,29381475,405598191,1146538,691785,406289976,403678209
29381475_720835,CM021104.1,5,29381475,405598191,1146538,720835,406319026,403707259
29380399_1168976,CM021104.1,5,29380399,405598194,2743955,1168976,406767170,404155403
29380399_1169065,CM021104.1,5,29380399,405598194,2743955,1169065,406767259,404155492
29380399_1169066,CM021104.1,5,29380399,405598194,2743955,1169066,406767260,404155493
29380399_1169077,CM021104.1,5,29380399,405598194,2743955,1169077,406767271,404155504
29380399_1169080,CM021104.1,5,29380399,405598194,2743955,1169080,406767274,404155507
29380399_1169085,CM021104.1,5,29380399,405598194,2743955,1169085,406767279,404155512
29380399_1169170,CM021104.1,5,29380399,405598194,2743955,1169170,406767364,404155597
29380399_1169175,CM021104.1,5,29380399,405598194,2743955,1169175,406767369,404155602
29380399_2712976,CM021104.1,5,29380399,405598194,2743955,2712976,408311170,405699403
29380399_2717060,CM021104.1,5,29380399,405598194,2743955,2717060,408315254,405703487
29382453_484516,CM021104.1,5,29382453,408278667,725408,484516,408763183,406151416
29382453_484545,CM021104.1,5,29382453,408278667,725408,484545,408763212,406151445
29378005_45935,CM021104.1,5,29378005,411651389,549317,45935,411697324,409085557
29378005_79941,CM021104.1,5,29378005,411651389,549317,79941,411731330,409119563
29378005_80014,CM021104.1,5,29378005,411651389,549317,80014,411731403,409119636
29378005_80046,CM021104.1,5,29378005,411651389,549317,80046,411731435,409119668
29378005_193644,CM021104.1,5,29378005,411651389,549317,193644,411845033,409233266
29378005_193711,CM021104.1,5,29378005,411651389,549317,193711,411845100,409233333
29378005_193774,CM021104.1,5,29378005,411651389,549317,193774,411845163,409233396
29378005_193809,CM021104.1,5,29378005,411651389,549317,193809,411845198,409233431
29378005_194030,CM021104.1,5,29378005,411651389,549317,194030,411845419,409233652
29378005_194078,CM021104.1,5,29378005,411651389,549317,194078,411845467,409233700
29359804_250642,CM021104.1,5,29359804,425922721,830103,250642,426173363,423561596
29359804_344417,CM021104.1,5,29359804,425922721,830103,344417,426267138,423655371
29359804_344456,CM021104.1,5,29359804,425922721,830103,344456,426267177,423655410
29359804_467857,CM021104.1,5,29359804,425922721,830103,467857,426390578,423778811
29359804_467880,CM021104.1,5,29359804,425922721,830103,467880,426390601,423778834
29359804_467882,CM021104.1,5,29359804,425922721,830103,467882,426390603,423778836
29359804_467891,CM021104.1,5,29359804,425922721,830103,467891,426390612,423778845
29343993_17286,CM021104.1,5,29343993,437432362,65335,17286,437449648,434837881
29343993_17314,CM021104.1,5,29343993,437432362,65335,17314,437449676,434837909
29343993_17343,CM021104.1,5,29343993,437432362,65335,17343,437449705,434837938
29343993_17352,CM021104.1,5,29343993,437432362,65335,17352,437449714,434837947
29343993_17382,CM021104.1,5,29343993,437432362,65335,17382,437449744,434837977
29343993_17384,CM021104.1,5,29343993,437432362,65335,17384,437449746,434837979
29343993_17415,CM021104.1,5,29343993,437432362,65335,17415,437449777,434838010
29343993_17427,CM021104.1,5,29343993,437432362,65335,17427,437449789,434838022
29343993_17442,CM021104.1,5,29343993,437432362,65335,17442,437449804,434838037
29343993_17458,CM021104.1,5,29343993,437432362,65335,17458,437449820,434838053
29343993_17499,CM021104.1,5,29343993,437432362,65335,17499,437449861,434838094
29377546_21081,CM021104.1,5,29377546,437434077,2952863,21081,437455158,434843391
29377785_58241,CM021104.1,5,29377785,437436161,610667,58241,437494402,434882635
29378279_229116,CM021104.1,5,29378279,437433814,10305456,229116,437662930,435051163
29379976_254654,CM021104.1,5,29379976,437432363,1550686,254654,437687017,435075250
29379976_254687,CM021104.1,5,29379976,437432363,1550686,254687,437687050,435075283
29379976_254725,CM021104.1,5,29379976,437432363,1550686,254725,437687088,435075321
29377193_256816,CM021104.1,5,29377193,437434800,2018206,256816,437691616,435079849
29377193_256842,CM021104.1,5,29377193,437434800,2018206,256842,437691642,435079875
29377193_256845,CM021104.1,5,29377193,437434800,2018206,256845,437691645,435079878
29377193_256853,CM021104.1,5,29377193,437434800,2018206,256853,437691653,435079886
29377193_256914,CM021104.1,5,29377193,437434800,2018206,256914,437691714,435079947
29377193_256916,CM021104.1,5,29377193,437434800,2018206,256916,437691716,435079949
29377193_256918,CM021104.1,5,29377193,437434800,2018206,256918,437691718,435079951
29377193_256928,CM021104.1,5,29377193,437434800,2018206,256928,437691728,435079961
29377193_256933,CM021104.1,5,29377193,437434800,2018206,256933,437691733,435079966
29377193_256955,CM021104.1,5,29377193,437434800,2018206,256955,437691755,435079988
29379976_297518,CM021104.1,5,29379976,437432363,1550686,297518,437729881,435118114
29379976_297593,CM021104.1,5,29379976,437432363,1550686,297593,437729956,435118189
29379976_297600,CM021104.1,5,29379976,437432363,1550686,297600,437729963,435118196
29379976_297706,CM021104.1,5,29379976,437432363,1550686,297706,437730069,435118302
29382165_313656,CM021104.1,5,29382165,437435502,2545914,313656,437749158,435137391
29382165_313752,CM021104.1,5,29382165,437435502,2545914,313752,437749254,435137487
29377785_356546,CM021104.1,5,29377785,437436161,610667,356546,437792707,435180940
29377785_356656,CM021104.1,5,29377785,437436161,610667,356656,437792817,435181050
29377785_356662,CM021104.1,5,29377785,437436161,610667,356662,437792823,435181056
29378964_429565,CM021104.1,5,29378964,437432595,5441346,429565,437862160,435250393
29378680_448314,CM021104.1,5,29378680,437434309,1712944,448314,437882623,435270856
29379976_450343,CM021104.1,5,29379976,437432363,1550686,450343,437882706,435270939
29379976_450358,CM021104.1,5,29379976,437432363,1550686,450358,437882721,435270954
29379976_450362,CM021104.1,5,29379976,437432363,1550686,450362,437882725,435270958
29378680_448421,CM021104.1,5,29378680,437434309,1712944,448421,437882730,435270963
29379976_450368,CM021104.1,5,29379976,437432363,1550686,450368,437882731,435270964
29379976_450380,CM021104.1,5,29379976,437432363,1550686,450380,437882743,435270976
29379976_450382,CM021104.1,5,29379976,437432363,1550686,450382,437882745,435270978
29379976_450384,CM021104.1,5,29379976,437432363,1550686,450384,437882747,435270980
29379976_450387,CM021104.1,5,29379976,437432363,1550686,450387,437882750,435270983
29379976_450403,CM021104.1,5,29379976,437432363,1550686,450403,437882766,435270999
29379976_450411,CM021104.1,5,29379976,437432363,1550686,450411,437882774,435271007
29379976_450424,CM021104.1,5,29379976,437432363,1550686,450424,437882787,435271020
29379976_450425,CM021104.1,5,29379976,437432363,1550686,450425,437882788,435271021
29379976_450426,CM021104.1,5,29379976,437432363,1550686,450426,437882789,435271022
29379976_450430,CM021104.1,5,29379976,437432363,1550686,450430,437882793,435271026
29378680_449090,CM021104.1,5,29378680,437434309,1712944,449090,437883399,435271632
29378680_449157,CM021104.1,5,29378680,437434309,1712944,449157,437883466,435271699
29378680_449187,CM021104.1,5,29378680,437434309,1712944,449187,437883496,435271729
29378680_449189,CM021104.1,5,29378680,437434309,1712944,449189,437883498,435271731
29378680_450845,CM021104.1,5,29378680,437434309,1712944,450845,437885154,435273387
29378680_452410,CM021104.1,5,29378680,437434309,1712944,452410,437886719,435274952
29380883_535668,CM021104.1,5,29380883,437434339,3035779,535668,437970007,435358240
29380883_563455,CM021104.1,5,29380883,437434339,3035779,563455,437997794,435386027
29380883_563921,CM021104.1,5,29380883,437434339,3035779,563921,437998260,435386493
29380883_563989,CM021104.1,5,29380883,437434339,3035779,563989,437998328,435386561
29379290_686588,CM021104.1,5,29379290,437434925,2173508,686588,438121513,435509746
29379290_686599,CM021104.1,5,29379290,437434925,2173508,686599,438121524,435509757
29379290_686660,CM021104.1,5,29379290,437434925,2173508,686660,438121585,435509818
29379290_686680,CM021104.1,5,29379290,437434925,2173508,686680,438121605,435509838
29379290_686707,CM021104.1,5,29379290,437434925,2173508,686707,438121632,435509865
29379290_686743,CM021104.1,5,29379290,437434925,2173508,686743,438121668,435509901
29379976_703148,CM021104.1,5,29379976,437432363,1550686,703148,438135511,435523744
29379976_703149,CM021104.1,5,29379976,437432363,1550686,703149,438135512,435523745
29380554_716849,CM021104.1,5,29380554,437434795,1978742,716849,438151644,435539877
29380554_716850,CM021104.1,5,29380554,437434795,1978742,716850,438151645,435539878
29380554_716912,CM021104.1,5,29380554,437434795,1978742,716912,438151707,435539940
29380883_768945,CM021104.1,5,29380883,437434339,3035779,768945,438203284,435591517
29380883_769160,CM021104.1,5,29380883,437434339,3035779,769160,438203499,435591732
29378680_779078,CM021104.1,5,29378680,437434309,1712944,779078,438213387,435601620
29378680_779079,CM021104.1,5,29378680,437434309,1712944,779079,438213388,435601621
29378680_785391,CM021104.1,5,29378680,437434309,1712944,785391,438219700,435607933
29382165_828127,CM021104.1,5,29382165,437435502,2545914,828127,438263629,435651862
29380636_875109,CM021104.1,5,29380636,437435294,1187426,875109,438310403,435698636
29380636_875184,CM021104.1,5,29380636,437435294,1187426,875184,438310478,435698711
29378279_911393,CM021104.1,5,29378279,437433814,10305456,911393,438345207,435733440
29378279_914068,CM021104.1,5,29378279,437433814,10305456,914068,438347882,435736115
29378279_914434,CM021104.1,5,29378279,437433814,10305456,914434,438348248,435736481
29382165_950609,CM021104.1,5,29382165,437435502,2545914,950609,438386111,435774344
29377193_960690,CM021104.1,5,29377193,437434800,2018206,960690,438395490,435783723
29377193_963651,CM021104.1,5,29377193,437434800,2018206,963651,438398451,435786684
29377193_963737,CM021104.1,5,29377193,437434800,2018206,963737,438398537,435786770
29378279_1145793,CM021104.1,5,29378279,437433814,10305456,1145793,438579607,435967840
29378279_1145810,CM021104.1,5,29378279,437433814,10305456,1145810,438579624,435967857
29382165_1155058,CM021104.1,5,29382165,437435502,2545914,1155058,438590560,435978793
29382165_1155074,CM021104.1,5,29382165,437435502,2545914,1155074,438590576,435978809
29382165_1155103,CM021104.1,5,29382165,437435502,2545914,1155103,438590605,435978838
29382165_1155146,CM021104.1,5,29382165,437435502,2545914,1155146,438590648,435978881
29382165_1155150,CM021104.1,5,29382165,437435502,2545914,1155150,438590652,435978885
29380554_1192083,CM021104.1,5,29380554,437434795,1978742,1192083,438626878,436015111
29379976_1311065,CM021104.1,5,29379976,437432363,1550686,1311065,438743428,436131661
29379976_1311109,CM021104.1,5,29379976,437432363,1550686,1311109,438743472,436131705
29379976_1311142,CM021104.1,5,29379976,437432363,1550686,1311142,438743505,436131738
29379976_1322335,CM021104.1,5,29379976,437432363,1550686,1322335,438754698,436142931
29379976_1322390,CM021104.1,5,29379976,437432363,1550686,1322390,438754753,436142986
29379976_1322457,CM021104.1,5,29379976,437432363,1550686,1322457,438754820,436143053
29380554_1331821,CM021104.1,5,29380554,437434795,1978742,1331821,438766616,436154849
29377193_1369875,CM021104.1,5,29377193,437434800,2018206,1369875,438804675,436192908
29380554_1400031,CM021104.1,5,29380554,437434795,1978742,1400031,438834826,436223059
29380554_1464098,CM021104.1,5,29380554,437434795,1978742,1464098,438898893,436287126
29380554_1466994,CM021104.1,5,29380554,437434795,1978742,1466994,438901789,436290022
29380554_1467041,CM021104.1,5,29380554,437434795,1978742,1467041,438901836,436290069
29378279_1594101,CM021104.1,5,29378279,437433814,10305456,1594101,439027915,436416148
29377434_1594405,CM021104.1,5,29377434,437437265,2128807,1594405,439031670,436419903
29377193_1611182,CM021104.1,5,29377193,437434800,2018206,1611182,439045982,436434215
29377193_1611235,CM021104.1,5,29377193,437434800,2018206,1611235,439046035,436434268
29377193_1646779,CM021104.1,5,29377193,437434800,2018206,1646779,439081579,436469812
29378279_1648899,CM021104.1,5,29378279,437433814,10305456,1648899,439082713,436470946
29378279_1648901,CM021104.1,5,29378279,437433814,10305456,1648901,439082715,436470948
29378279_1649253,CM021104.1,5,29378279,437433814,10305456,1649253,439083067,436471300
29378279_1649300,CM021104.1,5,29378279,437433814,10305456,1649300,439083114,436471347
29377193_1657664,CM021104.1,5,29377193,437434800,2018206,1657664,439092464,436480697
29377193_1657666,CM021104.1,5,29377193,437434800,2018206,1657666,439092466,436480699
29377193_1657776,CM021104.1,5,29377193,437434800,2018206,1657776,439092576,436480809
29378279_1703022,CM021104.1,5,29378279,437433814,10305456,1703022,439136836,436525069
29378279_1703028,CM021104.1,5,29378279,437433814,10305456,1703028,439136842,436525075
29378279_1703029,CM021104.1,5,29378279,437433814,10305456,1703029,439136843,436525076
29378279_1703088,CM021104.1,5,29378279,437433814,10305456,1703088,439136902,436525135
29377193_1796185,CM021104.1,5,29377193,437434800,2018206,1796185,439230985,436619218
29377193_1796194,CM021104.1,5,29377193,437434800,2018206,1796194,439230994,436619227
29377193_1796200,CM021104.1,5,29377193,437434800,2018206,1796200,439231000,436619233
29377193_1796262,CM021104.1,5,29377193,437434800,2018206,1796262,439231062,436619295
29377193_1796275,CM021104.1,5,29377193,437434800,2018206,1796275,439231075,436619308
29377193_1796293,CM021104.1,5,29377193,437434800,2018206,1796293,439231093,436619326
29380883_1834799,CM021104.1,5,29380883,437434339,3035779,1834799,439269138,436657371
29380883_1834854,CM021104.1,5,29380883,437434339,3035779,1834854,439269193,436657426
29380883_1834860,CM021104.1,5,29380883,437434339,3035779,1834860,439269199,436657432
29380883_1834878,CM021104.1,5,29380883,437434339,3035779,1834878,439269217,436657450
29380883_2111240,CM021104.1,5,29380883,437434339,3035779,2111240,439545579,436933812
29380883_2111419,CM021104.1,5,29380883,437434339,3035779,2111419,439545758,436933991
29378279_2833420,CM021104.1,5,29378279,437433814,10305456,2833420,440267234,437655467
29378279_2881874,CM021104.1,5,29378279,437433814,10305456,2881874,440315688,437703921
29378279_2882065,CM021104.1,5,29378279,437433814,10305456,2882065,440315879,437704112
29378279_2882098,CM021104.1,5,29378279,437433814,10305456,2882098,440315912,437704145
29378279_2882102,CM021104.1,5,29378279,437433814,10305456,2882102,440315916,437704149
29379897_2961119,CM021104.1,5,29379897,437432363,5932314,2961119,440393482,437781715
29379897_2961337,CM021104.1,5,29379897,437432363,5932314,2961337,440393700,437781933
29379897_2981471,CM021104.1,5,29379897,437432363,5932314,2981471,440413834,437802067
29377315_3017883,CM021104.1,5,29377315,437435308,3026327,3017883,440453191,437841424
29377315_3017991,CM021104.1,5,29377315,437435308,3026327,3017991,440453299,437841532
29377315_3017995,CM021104.1,5,29377315,437435308,3026327,3017995,440453303,437841536
29377315_3018069,CM021104.1,5,29377315,437435308,3026327,3018069,440453377,437841610
29377315_3018071,CM021104.1,5,29377315,437435308,3026327,3018071,440453379,437841612
29377315_3018073,CM021104.1,5,29377315,437435308,3026327,3018073,440453381,437841614
29377315_3018081,CM021104.1,5,29377315,437435308,3026327,3018081,440453389,437841622
29377315_3018149,CM021104.1,5,29377315,437435308,3026327,3018149,440453457,437841690
29378964_3141532,CM021104.1,5,29378964,437432595,5441346,3141532,440574127,437962360
29378964_3143289,CM021104.1,5,29378964,437432595,5441346,3143289,440575884,437964117
29378964_3143290,CM021104.1,5,29378964,437432595,5441346,3143290,440575885,437964118
29378964_3143302,CM021104.1,5,29378964,437432595,5441346,3143302,440575897,437964130
29378964_3143310,CM021104.1,5,29378964,437432595,5441346,3143310,440575905,437964138
29378964_3195210,CM021104.1,5,29378964,437432595,5441346,3195210,440627805,438016038
29378964_3195264,CM021104.1,5,29378964,437432595,5441346,3195264,440627859,438016092
29378964_3350687,CM021104.1,5,29378964,437432595,5441346,3350687,440783282,438171515
29377214_3576983,CM021104.1,5,29377214,437432363,6112775,3576983,441009346,438397579
29377214_3577041,CM021104.1,5,29377214,437432363,6112775,3577041,441009404,438397637
29378964_3937716,CM021104.1,5,29378964,437432595,5441346,3937716,441370311,438758544
29379897_4139847,CM021104.1,5,29379897,437432363,5932314,4139847,441572210,438960443
29377214_4526594,CM021104.1,5,29377214,437432363,6112775,4526594,441958957,439347190
29377214_4526715,CM021104.1,5,29377214,437432363,6112775,4526715,441959078,439347311
29377214_4526731,CM021104.1,5,29377214,437432363,6112775,4526731,441959094,439347327
29377214_4527221,CM021104.1,5,29377214,437432363,6112775,4527221,441959584,439347817
29377214_4557295,CM021104.1,5,29377214,437432363,6112775,4557295,441989658,439377891
29377214_4557301,CM021104.1,5,29377214,437432363,6112775,4557301,441989664,439377897
29377214_4832353,CM021104.1,5,29377214,437432363,6112775,4832353,442264716,439652949
29377214_4944644,CM021104.1,5,29377214,437432363,6112775,4944644,442377007,439765240
29377214_4954599,CM021104.1,5,29377214,437432363,6112775,4954599,442386962,439775195
29377214_4954647,CM021104.1,5,29377214,437432363,6112775,4954647,442387010,439775243
29377214_4955280,CM021104.1,5,29377214,437432363,6112775,4955280,442387643,439775876
29378964_5017873,CM021104.1,5,29378964,437432595,5441346,5017873,442450468,439838701
29378964_5240661,CM021104.1,5,29378964,437432595,5441346,5240661,442673256,440061489
29378279_6496915,CM021104.1,5,29378279,437433814,10305456,6496915,443930729,441318962
29378279_6497030,CM021104.1,5,29378279,437433814,10305456,6497030,443930844,441319077
29378279_6532135,CM021104.1,5,29378279,437433814,10305456,6532135,443965949,441354182
29378279_6660099,CM021104.1,5,29378279,437433814,10305456,6660099,444093913,441482146
29378279_7472671,CM021104.1,5,29378279,437433814,10305456,7472671,444906485,442294718
29378279_7472882,CM021104.1,5,29378279,437433814,10305456,7472882,444906696,442294929
29378279_7476366,CM021104.1,5,29378279,437433814,10305456,7476366,444910180,442298413
29378279_9835864,CM021104.1,5,29378279,437433814,10305456,9835864,447269678,444657911
29378279_9837069,CM021104.1,5,29378279,437433814,10305456,9837069,447270883,444659116
29378279_9837666,CM021104.1,5,29378279,437433814,10305456,9837666,447271480,444659713
29378191_43141,CM021104.1,5,29378191,470308819,345565,43141,470351960,467740193
29380980_53419,CM021104.1,5,29380980,470309047,3920276,53419,470362466,467750699
29380980_53456,CM021104.1,5,29380980,470309047,3920276,53456,470362503,467750736
29379972_66325,CM021104.1,5,29379972,470310273,204875,66325,470376598,467764831
29379972_68326,CM021104.1,5,29379972,470310273,204875,68326,470378599,467766832
29378905_183485,CM021104.1,5,29378905,470308814,1413532,183485,470492299,467880532
29380295_234442,CM021104.1,5,29380295,470309385,2466463,234442,470543827,467932060
29378912_358354,CM021104.1,5,29378912,470308820,411219,358354,470667174,468055407
29378912_358387,CM021104.1,5,29378912,470308820,411219,358387,470667207,468055440
29362940_369637,CM021104.1,5,29362940,470310866,391229,369637,470680503,468068736
29382351_444748,CM021104.1,5,29382351,470308846,4680915,444748,470753594,468141827
29382351_444781,CM021104.1,5,29382351,470308846,4680915,444781,470753627,468141860
29382351_473750,CM021104.1,5,29382351,470308846,4680915,473750,470782596,468170829
29382351_474399,CM021104.1,5,29382351,470308846,4680915,474399,470783245,468171478
29382351_474570,CM021104.1,5,29382351,470308846,4680915,474570,470783416,468171649
29382351_561530,CM021104.1,5,29382351,470308846,4680915,561530,470870376,468258609
29382351_561690,CM021104.1,5,29382351,470308846,4680915,561690,470870536,468258769
29378905_567679,CM021104.1,5,29378905,470308814,1413532,567679,470876493,468264726
29378905_567680,CM021104.1,5,29378905,470308814,1413532,567680,470876494,468264727
29378905_567743,CM021104.1,5,29378905,470308814,1413532,567743,470876557,468264790
29378905_567754,CM021104.1,5,29378905,470308814,1413532,567754,470876568,468264801
29378905_567787,CM021104.1,5,29378905,470308814,1413532,567787,470876601,468264834
29378905_567789,CM021104.1,5,29378905,470308814,1413532,567789,470876603,468264836
29378905_567793,CM021104.1,5,29378905,470308814,1413532,567793,470876607,468264840
29378905_567824,CM021104.1,5,29378905,470308814,1413532,567824,470876638,468264871
29378905_567827,CM021104.1,5,29378905,470308814,1413532,567827,470876641,468264874
29382351_575545,CM021104.1,5,29382351,470308846,4680915,575545,470884391,468272624
29380980_696772,CM021104.1,5,29380980,470309047,3920276,696772,471005819,468394052
29380980_696778,CM021104.1,5,29380980,470309047,3920276,696778,471005825,468394058
29380980_696790,CM021104.1,5,29380980,470309047,3920276,696790,471005837,468394070
29380980_709790,CM021104.1,5,29380980,470309047,3920276,709790,471018837,468407070
29377618_885405,CM021104.1,5,29377618,470308821,1271368,885405,471194226,468582459
29377618_885408,CM021104.1,5,29377618,470308821,1271368,885408,471194229,468582462
29377618_885416,CM021104.1,5,29377618,470308821,1271368,885416,471194237,468582470
29377618_885417,CM021104.1,5,29377618,470308821,1271368,885417,471194238,468582471
29377618_885451,CM021104.1,5,29377618,470308821,1271368,885451,471194272,468582505
29377618_885458,CM021104.1,5,29377618,470308821,1271368,885458,471194279,468582512
29377618_885476,CM021104.1,5,29377618,470308821,1271368,885476,471194297,468582530
29377618_885483,CM021104.1,5,29377618,470308821,1271368,885483,471194304,468582537
29377618_885493,CM021104.1,5,29377618,470308821,1271368,885493,471194314,468582547
29377618_885495,CM021104.1,5,29377618,470308821,1271368,885495,471194316,468582549
29377618_885497,CM021104.1,5,29377618,470308821,1271368,885497,471194318,468582551
29377618_955888,CM021104.1,5,29377618,470308821,1271368,955888,471264709,468652942
29380980_1133148,CM021104.1,5,29380980,470309047,3920276,1133148,471442195,468830428
29380980_1172484,CM021104.1,5,29380980,470309047,3920276,1172484,471481531,468869764
29380295_1174253,CM021104.1,5,29380295,470309385,2466463,1174253,471483638,468871871
29380295_1180820,CM021104.1,5,29380295,470309385,2466463,1180820,471490205,468878438
29380295_1180829,CM021104.1,5,29380295,470309385,2466463,1180829,471490214,468878447
29380980_1543891,CM021104.1,5,29380980,470309047,3920276,1543891,471852938,469241171
29378099_1579305,CM021104.1,5,29378099,470308824,2051700,1579305,471888129,469276362
29378099_1579322,CM021104.1,5,29378099,470308824,2051700,1579322,471888146,469276379
29378099_1579370,CM021104.1,5,29378099,470308824,2051700,1579370,471888194,469276427
29378099_1579472,CM021104.1,5,29378099,470308824,2051700,1579472,471888296,469276529
29378099_1579486,CM021104.1,5,29378099,470308824,2051700,1579486,471888310,469276543
29378099_1579491,CM021104.1,5,29378099,470308824,2051700,1579491,471888315,469276548
29378099_1579507,CM021104.1,5,29378099,470308824,2051700,1579507,471888331,469276564
29378099_1579512,CM021104.1,5,29378099,470308824,2051700,1579512,471888336,469276569
29378099_1579514,CM021104.1,5,29378099,470308824,2051700,1579514,471888338,469276571
29378099_1579541,CM021104.1,5,29378099,470308824,2051700,1579541,471888365,469276598
29378099_1579543,CM021104.1,5,29378099,470308824,2051700,1579543,471888367,469276600
29378099_1579547,CM021104.1,5,29378099,470308824,2051700,1579547,471888371,469276604
29378099_1579551,CM021104.1,5,29378099,470308824,2051700,1579551,471888375,469276608
29378099_1579556,CM021104.1,5,29378099,470308824,2051700,1579556,471888380,469276613
29378099_1579564,CM021104.1,5,29378099,470308824,2051700,1579564,471888388,469276621
29381197_1941658,CM021104.1,5,29381197,470308824,3660677,1941658,472250482,469638715
29381197_1941664,CM021104.1,5,29381197,470308824,3660677,1941664,472250488,469638721
29381197_1941744,CM021104.1,5,29381197,470308824,3660677,1941744,472250568,469638801
29381197_1941857,CM021104.1,5,29381197,470308824,3660677,1941857,472250681,469638914
29380980_2291578,CM021104.1,5,29380980,470309047,3920276,2291578,472600625,469988858
29380980_2291620,CM021104.1,5,29380980,470309047,3920276,2291620,472600667,469988900
29380980_2291636,CM021104.1,5,29380980,470309047,3920276,2291636,472600683,469988916
29380980_2291648,CM021104.1,5,29380980,470309047,3920276,2291648,472600695,469988928
29380980_2291658,CM021104.1,5,29380980,470309047,3920276,2291658,472600705,469988938
29380980_2291754,CM021104.1,5,29380980,470309047,3920276,2291754,472600801,469989034
29380980_2504217,CM021104.1,5,29380980,470309047,3920276,2504217,472813264,470201497
29380980_2504264,CM021104.1,5,29380980,470309047,3920276,2504264,472813311,470201544
29380980_2504276,CM021104.1,5,29380980,470309047,3920276,2504276,472813323,470201556
29380980_2504323,CM021104.1,5,29380980,470309047,3920276,2504323,472813370,470201603
29380980_2504333,CM021104.1,5,29380980,470309047,3920276,2504333,472813380,470201613
29380980_2505652,CM021104.1,5,29380980,470309047,3920276,2505652,472814699,470202932
29380980_2505680,CM021104.1,5,29380980,470309047,3920276,2505680,472814727,470202960
29380980_2505717,CM021104.1,5,29380980,470309047,3920276,2505717,472814764,470202997
29380980_2505732,CM021104.1,5,29380980,470309047,3920276,2505732,472814779,470203012
29380980_2592719,CM021104.1,5,29380980,470309047,3920276,2592719,472901766,470289999
29380980_2592723,CM021104.1,5,29380980,470309047,3920276,2592723,472901770,470290003
29380980_2592777,CM021104.1,5,29380980,470309047,3920276,2592777,472901824,470290057
29380980_2592812,CM021104.1,5,29380980,470309047,3920276,2592812,472901859,470290092
29382351_2887124,CM021104.1,5,29382351,470308846,4680915,2887124,473195970,470584203
29382351_2941081,CM021104.1,5,29382351,470308846,4680915,2941081,473249927,470638160
29381488_3192714,CM021104.1,5,29381488,470308822,3621988,3192714,473501536,470889769
29381488_3192753,CM021104.1,5,29381488,470308822,3621988,3192753,473501575,470889808
29382351_3363088,CM021104.1,5,29382351,470308846,4680915,3363088,473671934,471060167
29381488_3500682,CM021104.1,5,29381488,470308822,3621988,3500682,473809504,471197737
29381488_3500700,CM021104.1,5,29381488,470308822,3621988,3500700,473809522,471197755
29381488_3500714,CM021104.1,5,29381488,470308822,3621988,3500714,473809536,471197769
29381488_3500754,CM021104.1,5,29381488,470308822,3621988,3500754,473809576,471197809
29381488_3501004,CM021104.1,5,29381488,470308822,3621988,3501004,473809826,471198059
29381488_3502918,CM021104.1,5,29381488,470308822,3621988,3502918,473811740,471199973
29382351_3567177,CM021104.1,5,29382351,470308846,4680915,3567177,473876023,471264256
29382351_3567222,CM021104.1,5,29382351,470308846,4680915,3567222,473876068,471264301
29382351_3570176,CM021104.1,5,29382351,470308846,4680915,3570176,473879022,471267255
29382351_3570189,CM021104.1,5,29382351,470308846,4680915,3570189,473879035,471267268
29338901_430,CM021104.1,5,29338901,475268169,659443,430,475268599,472656832
29338901_440,CM021104.1,5,29338901,475268169,659443,440,475268609,472656842
29338901_481,CM021104.1,5,29338901,475268169,659443,481,475268650,472656883
29338901_514,CM021104.1,5,29338901,475268169,659443,514,475268683,472656916
29379175_16250,CM021104.1,5,29379175,475268686,866355,16250,475284936,472673169
29379175_16474,CM021104.1,5,29379175,475268686,866355,16474,475285160,472673393
29379175_16502,CM021104.1,5,29379175,475268686,866355,16502,475285188,472673421
29349404_20246,CM021104.1,5,29349404,475267924,93730,20246,475288170,472676403
29349404_22692,CM021104.1,5,29349404,475267924,93730,22692,475290616,472678849
29381060_135847,CM021104.1,5,29381060,475267919,140342,135847,475403766,472791999
29379175_263342,CM021104.1,5,29379175,475268686,866355,263342,475532028,472920261
29379175_263347,CM021104.1,5,29379175,475268686,866355,263347,475532033,472920266
29379175_263349,CM021104.1,5,29379175,475268686,866355,263349,475532035,472920268
29379175_263495,CM021104.1,5,29379175,475268686,866355,263495,475532181,472920414
29379175_446480,CM021104.1,5,29379175,475268686,866355,446480,475715166,473103399
29379175_446863,CM021104.1,5,29379175,475268686,866355,446863,475715549,473103782
29379175_453676,CM021104.1,5,29379175,475268686,866355,453676,475722362,473110595
29379175_806002,CM021104.1,5,29379175,475268686,866355,806002,476074688,473462921
29379175_816157,CM021104.1,5,29379175,475268686,866355,816157,476084843,473473076
29379175_816180,CM021104.1,5,29379175,475268686,866355,816180,476084866,473473099
29379175_821124,CM021104.1,5,29379175,475268686,866355,821124,476089810,473478043
29379175_827593,CM021104.1,5,29379175,475268686,866355,827593,476096279,473484512
29379175_835822,CM021104.1,5,29379175,475268686,866355,835822,476104508,473492741
29379175_845253,CM021104.1,5,29379175,475268686,866355,845253,476113939,473502172
29377294_9049,CM021104.1,5,29377294,491126248,2282445,9049,491135297,488523530
29377294_9080,CM021104.1,5,29377294,491126248,2282445,9080,491135328,488523561
29378269_35407,CM021104.1,5,29378269,491126244,1982778,35407,491161651,488549884
29378269_36557,CM021104.1,5,29378269,491126244,1982778,36557,491162801,488551034
29382056_37638,CM021104.1,5,29382056,491126248,1872139,37638,491163886,488552119
29382056_37676,CM021104.1,5,29382056,491126248,1872139,37676,491163924,488552157
29382056_37694,CM021104.1,5,29382056,491126248,1872139,37694,491163942,488552175
29380718_77774,CM021104.1,5,29380718,491126246,1771532,77774,491204020,488592253
29382056_96875,CM021104.1,5,29382056,491126248,1872139,96875,491223123,488611356
29378840_115774,CM021104.1,5,29378840,491126240,1533483,115774,491242014,488630247
29378840_115888,CM021104.1,5,29378840,491126240,1533483,115888,491242128,488630361
29378331_115965,CM021104.1,5,29378331,491126247,3113707,115965,491242212,488630445
29375603_121148,CM021104.1,5,29375603,491126245,251554,121148,491247393,488635626
29378837_110830,CM021104.1,5,29378837,491145787,423411,110830,491256617,488644850
29378837_110832,CM021104.1,5,29378837,491145787,423411,110832,491256619,488644852
29378837_110865,CM021104.1,5,29378837,491145787,423411,110865,491256652,488644885
29378837_110877,CM021104.1,5,29378837,491145787,423411,110877,491256664,488644897
29378837_110882,CM021104.1,5,29378837,491145787,423411,110882,491256669,488644902
29378837_110896,CM021104.1,5,29378837,491145787,423411,110896,491256683,488644916
29378837_110902,CM021104.1,5,29378837,491145787,423411,110902,491256689,488644922
29378837_110941,CM021104.1,5,29378837,491145787,423411,110941,491256728,488644961
29378837_110957,CM021104.1,5,29378837,491145787,423411,110957,491256744,488644977
29378837_110958,CM021104.1,5,29378837,491145787,423411,110958,491256745,488644978
29378837_110977,CM021104.1,5,29378837,491145787,423411,110977,491256764,488644997
29379100_116234,CM021104.1,5,29379100,491142512,3012358,116234,491258746,488646979
29379100_116547,CM021104.1,5,29379100,491142512,3012358,116547,491259059,488647292
29382233_142717,CM021104.1,5,29382233,491126248,2929548,142717,491268965,488657198
29382233_142760,CM021104.1,5,29382233,491126248,2929548,142760,491269008,488657241
29382233_142822,CM021104.1,5,29382233,491126248,2929548,142822,491269070,488657303
29382233_142896,CM021104.1,5,29382233,491126248,2929548,142896,491269144,488657377
29378435_148766,CM021104.1,5,29378435,491142954,4352809,148766,491291720,488679953
29378435_148775,CM021104.1,5,29378435,491142954,4352809,148775,491291729,488679962
29378435_148833,CM021104.1,5,29378435,491142954,4352809,148833,491291787,488680020
29378435_148857,CM021104.1,5,29378435,491142954,4352809,148857,491291811,488680044
29378435_148914,CM021104.1,5,29378435,491142954,4352809,148914,491291868,488680101
29382341_157860,CM021104.1,5,29382341,491142986,1642310,157860,491300846,488689079
29377704_164754,CM021104.1,5,29377704,491142585,932658,164754,491307339,488695572
29378729_168425,CM021104.1,5,29378729,491143024,2493009,168425,491311449,488699682
29378729_168687,CM021104.1,5,29378729,491143024,2493009,168687,491311711,488699944
29379100_178725,CM021104.1,5,29379100,491142512,3012358,178725,491321237,488709470
29379100_178816,CM021104.1,5,29379100,491142512,3012358,178816,491321328,488709561
29379100_178836,CM021104.1,5,29379100,491142512,3012358,178836,491321348,488709581
29379100_178837,CM021104.1,5,29379100,491142512,3012358,178837,491321349,488709582
29379100_178850,CM021104.1,5,29379100,491142512,3012358,178850,491321362,488709595
29379100_178911,CM021104.1,5,29379100,491142512,3012358,178911,491321423,488709656
29378269_236428,CM021104.1,5,29378269,491126244,1982778,236428,491362672,488750905
29378269_236454,CM021104.1,5,29378269,491126244,1982778,236454,491362698,488750931
29378269_236464,CM021104.1,5,29378269,491126244,1982778,236464,491362708,488750941
29378269_236479,CM021104.1,5,29378269,491126244,1982778,236479,491362723,488750956
29378269_236510,CM021104.1,5,29378269,491126244,1982778,236510,491362754,488750987
29378269_236517,CM021104.1,5,29378269,491126244,1982778,236517,491362761,488750994
29378269_236831,CM021104.1,5,29378269,491126244,1982778,236831,491363075,488751308
29378269_236860,CM021104.1,5,29378269,491126244,1982778,236860,491363104,488751337
29382233_285422,CM021104.1,5,29382233,491126248,2929548,285422,491411670,488799903
29382233_285466,CM021104.1,5,29382233,491126248,2929548,285466,491411714,488799947
29382233_285548,CM021104.1,5,29382233,491126248,2929548,285548,491411796,488800029
29380718_285621,CM021104.1,5,29380718,491126246,1771532,285621,491411867,488800100
29380718_285679,CM021104.1,5,29380718,491126246,1771532,285679,491411925,488800158
29382233_285723,CM021104.1,5,29382233,491126248,2929548,285723,491411971,488800204
29380718_285753,CM021104.1,5,29380718,491126246,1771532,285753,491411999,488800232
29382233_285844,CM021104.1,5,29382233,491126248,2929548,285844,491412092,488800325
29378269_312341,CM021104.1,5,29378269,491126244,1982778,312341,491438585,488826818
29378269_312422,CM021104.1,5,29378269,491126244,1982778,312422,491438666,488826899
29378269_312425,CM021104.1,5,29378269,491126244,1982778,312425,491438669,488826902
29378269_312428,CM021104.1,5,29378269,491126244,1982778,312428,491438672,488826905
29378269_312457,CM021104.1,5,29378269,491126244,1982778,312457,491438701,488826934
29378269_312476,CM021104.1,5,29378269,491126244,1982778,312476,491438720,488826953
29378269_312491,CM021104.1,5,29378269,491126244,1982778,312491,491438735,488826968
29378269_312525,CM021104.1,5,29378269,491126244,1982778,312525,491438769,488827002
29379710_328846,CM021104.1,5,29379710,491126248,1965979,328846,491455094,488843327
29379710_329304,CM021104.1,5,29379710,491126248,1965979,329304,491455552,488843785
29379710_329323,CM021104.1,5,29379710,491126248,1965979,329323,491455571,488843804
29379710_329360,CM021104.1,5,29379710,491126248,1965979,329360,491455608,488843841
29379710_329415,CM021104.1,5,29379710,491126248,1965979,329415,491455663,488843896
29379410_325769,CM021104.1,5,29379410,491139832,4282425,325769,491465601,488853834
29381171_346159,CM021104.1,5,29381171,491126248,1041179,346159,491472407,488860640
29378729_338977,CM021104.1,5,29378729,491143024,2493009,338977,491482001,488870234
29379410_376144,CM021104.1,5,29379410,491139832,4282425,376144,491515976,488904209
29379410_377223,CM021104.1,5,29379410,491139832,4282425,377223,491517055,488905288
29379410_377287,CM021104.1,5,29379410,491139832,4282425,377287,491517119,488905352
29372212_399861,CM021104.1,5,29372212,491126248,768255,399861,491526109,488914342
29372212_399891,CM021104.1,5,29372212,491126248,768255,399891,491526139,488914372
29378906_403547,CM021104.1,5,29378906,491142527,860096,403547,491546074,488934307
29372212_425068,CM021104.1,5,29372212,491126248,768255,425068,491551316,488939549
29372212_425165,CM021104.1,5,29372212,491126248,768255,425165,491551413,488939646
29372212_425176,CM021104.1,5,29372212,491126248,768255,425176,491551424,488939657
29372212_428897,CM021104.1,5,29372212,491126248,768255,428897,491555145,488943378
29372212_429171,CM021104.1,5,29372212,491126248,768255,429171,491555419,488943652
29372212_429190,CM021104.1,5,29372212,491126248,768255,429190,491555438,488943671
29380634_451586,CM021104.1,5,29380634,491126248,717433,451586,491577834,488966067
29377613_439290,CM021104.1,5,29377613,491142712,1153396,439290,491582002,488970235
29378906_444087,CM021104.1,5,29378906,491142527,860096,444087,491586614,488974847
29378269_460841,CM021104.1,5,29378269,491126244,1982778,460841,491587085,488975318
29382341_464585,CM021104.1,5,29382341,491142986,1642310,464585,491607571,488995804
29382341_464631,CM021104.1,5,29382341,491142986,1642310,464631,491607617,488995850
29379080_474467,CM021104.1,5,29379080,491137652,1653834,474467,491612119,489000352
29379080_474648,CM021104.1,5,29379080,491137652,1653834,474648,491612300,489000533
29382341_475473,CM021104.1,5,29382341,491142986,1642310,475473,491618459,489006692
29382341_475538,CM021104.1,5,29382341,491142986,1642310,475538,491618524,489006757
29382341_491276,CM021104.1,5,29382341,491142986,1642310,491276,491634262,489022495
29381171_555055,CM021104.1,5,29381171,491126248,1041179,555055,491681303,489069536
29381171_555065,CM021104.1,5,29381171,491126248,1041179,555065,491681313,489069546
29381171_555095,CM021104.1,5,29381171,491126248,1041179,555095,491681343,489069576
29381171_555102,CM021104.1,5,29381171,491126248,1041179,555102,491681350,489069583
29381171_555108,CM021104.1,5,29381171,491126248,1041179,555108,491681356,489069589
29381171_555127,CM021104.1,5,29381171,491126248,1041179,555127,491681375,489069608
29381171_555129,CM021104.1,5,29381171,491126248,1041179,555129,491681377,489069610
29381171_555146,CM021104.1,5,29381171,491126248,1041179,555146,491681394,489069627
29381171_555150,CM021104.1,5,29381171,491126248,1041179,555150,491681398,489069631
29381171_555174,CM021104.1,5,29381171,491126248,1041179,555174,491681422,489069655
29381171_555175,CM021104.1,5,29381171,491126248,1041179,555175,491681423,489069656
29381171_555206,CM021104.1,5,29381171,491126248,1041179,555206,491681454,489069687
29381171_555216,CM021104.1,5,29381171,491126248,1041179,555216,491681464,489069697
29382341_553689,CM021104.1,5,29382341,491142986,1642310,553689,491696675,489084908
29382341_553711,CM021104.1,5,29382341,491142986,1642310,553711,491696697,489084930
29382341_553737,CM021104.1,5,29382341,491142986,1642310,553737,491696723,489084956
29382341_553739,CM021104.1,5,29382341,491142986,1642310,553739,491696725,489084958
29382341_553740,CM021104.1,5,29382341,491142986,1642310,553740,491696726,489084959
29382341_553743,CM021104.1,5,29382341,491142986,1642310,553743,491696729,489084962
29382341_553744,CM021104.1,5,29382341,491142986,1642310,553744,491696730,489084963
29382341_553830,CM021104.1,5,29382341,491142986,1642310,553830,491696816,489085049
29382341_553884,CM021104.1,5,29382341,491142986,1642310,553884,491696870,489085103
29382341_553982,CM021104.1,5,29382341,491142986,1642310,553982,491696968,489085201
29382341_554007,CM021104.1,5,29382341,491142986,1642310,554007,491696993,489085226
29382341_554022,CM021104.1,5,29382341,491142986,1642310,554022,491697008,489085241
29382341_554051,CM021104.1,5,29382341,491142986,1642310,554051,491697037,489085270
29382341_554064,CM021104.1,5,29382341,491142986,1642310,554064,491697050,489085283
29372212_575723,CM021104.1,5,29372212,491126248,768255,575723,491701971,489090204
29380891_585847,CM021104.1,5,29380891,491126248,2894873,585847,491712095,489100328
29379080_586010,CM021104.1,5,29379080,491137652,1653834,586010,491723662,489111895
29378331_623859,CM021104.1,5,29378331,491126247,3113707,623859,491750106,489138339
29378331_623946,CM021104.1,5,29378331,491126247,3113707,623946,491750193,489138426
29380036_628608,CM021104.1,5,29380036,491126245,1927963,628608,491754853,489143086
29379410_677177,CM021104.1,5,29379410,491139832,4282425,677177,491817009,489205242
29382176_759150,CM021104.1,5,29382176,491126248,2370752,759150,491885398,489273631
29379710_777208,CM021104.1,5,29379710,491126248,1965979,777208,491903456,489291689
29379710_777228,CM021104.1,5,29379710,491126248,1965979,777228,491903476,489291709
29379710_777758,CM021104.1,5,29379710,491126248,1965979,777758,491904006,489292239
29382196_802922,CM021104.1,5,29382196,491142383,3031664,802922,491945305,489333538
29382196_802941,CM021104.1,5,29382196,491142383,3031664,802941,491945324,489333557
29382196_802950,CM021104.1,5,29382196,491142383,3031664,802950,491945333,489333566
29382196_802955,CM021104.1,5,29382196,491142383,3031664,802955,491945338,489333571
29382196_802956,CM021104.1,5,29382196,491142383,3031664,802956,491945339,489333572
29382196_802974,CM021104.1,5,29382196,491142383,3031664,802974,491945357,489333590
29382196_802978,CM021104.1,5,29382196,491142383,3031664,802978,491945361,489333594
29382196_803315,CM021104.1,5,29382196,491142383,3031664,803315,491945698,489333931
29382196_803331,CM021104.1,5,29382196,491142383,3031664,803331,491945714,489333947
29382196_803406,CM021104.1,5,29382196,491142383,3031664,803406,491945789,489334022
29378906_804181,CM021104.1,5,29378906,491142527,860096,804181,491946708,489334941
29379487_847977,CM021104.1,5,29379487,491126248,2435604,847977,491974225,489362458
29381171_853411,CM021104.1,5,29381171,491126248,1041179,853411,491979659,489367892
29381171_853418,CM021104.1,5,29381171,491126248,1041179,853418,491979666,489367899
29379641_856693,CM021104.1,5,29379641,491126246,2813666,856693,491982939,489371172
29379641_856791,CM021104.1,5,29379641,491126246,2813666,856791,491983037,489371270
29382196_840746,CM021104.1,5,29382196,491142383,3031664,840746,491983129,489371362
29382196_840811,CM021104.1,5,29382196,491142383,3031664,840811,491983194,489371427
29381171_874620,CM021104.1,5,29381171,491126248,1041179,874620,492000868,489389101
29381171_874724,CM021104.1,5,29381171,491126248,1041179,874724,492000972,489389205
29378331_879407,CM021104.1,5,29378331,491126247,3113707,879407,492005654,489393887
29382233_931165,CM021104.1,5,29382233,491126248,2929548,931165,492057413,489445646
29377613_948910,CM021104.1,5,29377613,491142712,1153396,948910,492091622,489479855
29380891_968199,CM021104.1,5,29380891,491126248,2894873,968199,492094447,489482680
29380891_983844,CM021104.1,5,29380891,491126248,2894873,983844,492110092,489498325
29382341_992239,CM021104.1,5,29382341,491142986,1642310,992239,492135225,489523458
29380718_1030783,CM021104.1,5,29380718,491126246,1771532,1030783,492157029,489545262
29380718_1031553,CM021104.1,5,29380718,491126246,1771532,1031553,492157799,489546032
29380718_1031580,CM021104.1,5,29380718,491126246,1771532,1031580,492157826,489546059
29380718_1031583,CM021104.1,5,29380718,491126246,1771532,1031583,492157829,489546062
29382341_1035019,CM021104.1,5,29382341,491142986,1642310,1035019,492178005,489566238
29377882_1049469,CM021104.1,5,29377882,491142339,2952408,1049469,492191808,489580041
29377613_1063390,CM021104.1,5,29377613,491142712,1153396,1063390,492206102,489594335
29382176_1121288,CM021104.1,5,29382176,491126248,2370752,1121288,492247536,489635769
29382176_1121300,CM021104.1,5,29382176,491126248,2370752,1121300,492247548,489635781
29378269_1122016,CM021104.1,5,29378269,491126244,1982778,1122016,492248260,489636493
29378269_1123081,CM021104.1,5,29378269,491126244,1982778,1123081,492249325,489637558
29378269_1136483,CM021104.1,5,29378269,491126244,1982778,1136483,492262727,489650960
29378269_1136557,CM021104.1,5,29378269,491126244,1982778,1136557,492262801,489651034
29378269_1136856,CM021104.1,5,29378269,491126244,1982778,1136856,492263100,489651333
29378269_1137262,CM021104.1,5,29378269,491126244,1982778,1137262,492263506,489651739
29378122_1167023,CM021104.1,5,29378122,491126248,2413727,1167023,492293271,489681504
29380718_1208105,CM021104.1,5,29380718,491126246,1771532,1208105,492334351,489722584
29380718_1208111,CM021104.1,5,29380718,491126246,1771532,1208111,492334357,489722590
29380718_1209478,CM021104.1,5,29380718,491126246,1771532,1209478,492335724,489723957
29378840_1215632,CM021104.1,5,29378840,491126240,1533483,1215632,492341872,489730105
29378840_1215639,CM021104.1,5,29378840,491126240,1533483,1215639,492341879,489730112
29380036_1264976,CM021104.1,5,29380036,491126245,1927963,1264976,492391221,489779454
29380036_1264977,CM021104.1,5,29380036,491126245,1927963,1264977,492391222,489779455
29382196_1320541,CM021104.1,5,29382196,491142383,3031664,1320541,492462924,489851157
29382196_1321214,CM021104.1,5,29382196,491142383,3031664,1321214,492463597,489851830
29382233_1385583,CM021104.1,5,29382233,491126248,2929548,1385583,492511831,489900064
29382233_1385659,CM021104.1,5,29382233,491126248,2929548,1385659,492511907,489900140
29379641_1386970,CM021104.1,5,29379641,491126246,2813666,1386970,492513216,489901449
29378729_1389748,CM021104.1,5,29378729,491143024,2493009,1389748,492532772,489921005
29378729_1390225,CM021104.1,5,29378729,491143024,2493009,1390225,492533249,489921482
29378729_1390273,CM021104.1,5,29378729,491143024,2493009,1390273,492533297,489921530
29378729_1390588,CM021104.1,5,29378729,491143024,2493009,1390588,492533612,489921845
29378729_1395364,CM021104.1,5,29378729,491143024,2493009,1395364,492538388,489926621
29378729_1395445,CM021104.1,5,29378729,491143024,2493009,1395445,492538469,489926702
29378729_1395478,CM021104.1,5,29378729,491143024,2493009,1395478,492538502,489926735
29379641_1431421,CM021104.1,5,29379641,491126246,2813666,1431421,492557667,489945900
29379641_1438085,CM021104.1,5,29379641,491126246,2813666,1438085,492564331,489952564
29378840_1466097,CM021104.1,5,29378840,491126240,1533483,1466097,492592337,489980570
29378840_1466132,CM021104.1,5,29378840,491126240,1533483,1466132,492592372,489980605
29378840_1466147,CM021104.1,5,29378840,491126240,1533483,1466147,492592387,489980620
29378840_1466197,CM021104.1,5,29378840,491126240,1533483,1466197,492592437,489980670
29378840_1466593,CM021104.1,5,29378840,491126240,1533483,1466593,492592833,489981066
29380036_1490396,CM021104.1,5,29380036,491126245,1927963,1490396,492616641,490004874
29380036_1490402,CM021104.1,5,29380036,491126245,1927963,1490402,492616647,490004880
29378840_1500204,CM021104.1,5,29378840,491126240,1533483,1500204,492626444,490014677
29378840_1500226,CM021104.1,5,29378840,491126240,1533483,1500226,492626466,490014699
29378840_1500308,CM021104.1,5,29378840,491126240,1533483,1500308,492626548,490014781
29378840_1500346,CM021104.1,5,29378840,491126240,1533483,1500346,492626586,490014819
29380036_1557167,CM021104.1,5,29380036,491126245,1927963,1557167,492683412,490071645
29380036_1557183,CM021104.1,5,29380036,491126245,1927963,1557183,492683428,490071661
29380036_1557220,CM021104.1,5,29380036,491126245,1927963,1557220,492683465,490071698
29380036_1557229,CM021104.1,5,29380036,491126245,1927963,1557229,492683474,490071707
29380036_1557257,CM021104.1,5,29380036,491126245,1927963,1557257,492683502,490071735
29380036_1557276,CM021104.1,5,29380036,491126245,1927963,1557276,492683521,490071754
29380036_1557338,CM021104.1,5,29380036,491126245,1927963,1557338,492683583,490071816
29380036_1557383,CM021104.1,5,29380036,491126245,1927963,1557383,492683628,490071861
29380036_1557384,CM021104.1,5,29380036,491126245,1927963,1557384,492683629,490071862
29380036_1557398,CM021104.1,5,29380036,491126245,1927963,1557398,492683643,490071876
29378122_1596078,CM021104.1,5,29378122,491126248,2413727,1596078,492722326,490110559
29380036_1625252,CM021104.1,5,29380036,491126245,1927963,1625252,492751497,490139730
29380036_1625361,CM021104.1,5,29380036,491126245,1927963,1625361,492751606,490139839
29380718_1641918,CM021104.1,5,29380718,491126246,1771532,1641918,492768164,490156397
29378269_1702328,CM021104.1,5,29378269,491126244,1982778,1702328,492828572,490216805
29378269_1702346,CM021104.1,5,29378269,491126244,1982778,1702346,492828590,490216823
29378269_1702434,CM021104.1,5,29378269,491126244,1982778,1702434,492828678,490216911
29382056_1751168,CM021104.1,5,29382056,491126248,1872139,1751168,492877416,490265649
29382056_1751993,CM021104.1,5,29382056,491126248,1872139,1751993,492878241,490266474
29382233_1773407,CM021104.1,5,29382233,491126248,2929548,1773407,492899655,490287888
29382233_1773412,CM021104.1,5,29382233,491126248,2929548,1773412,492899660,490287893
29382233_1773418,CM021104.1,5,29382233,491126248,2929548,1773418,492899666,490287899
29382233_1773435,CM021104.1,5,29382233,491126248,2929548,1773435,492899683,490287916
29382233_1794436,CM021104.1,5,29382233,491126248,2929548,1794436,492920684,490308917
29378269_1796211,CM021104.1,5,29378269,491126244,1982778,1796211,492922455,490310688
29379100_1934195,CM021104.1,5,29379100,491142512,3012358,1934195,493076707,490464940
29379487_1955838,CM021104.1,5,29379487,491126248,2435604,1955838,493082086,490470319
29379487_1957115,CM021104.1,5,29379487,491126248,2435604,1957115,493083363,490471596
29382176_2096453,CM021104.1,5,29382176,491126248,2370752,2096453,493222701,490610934
29382176_2097029,CM021104.1,5,29382176,491126248,2370752,2097029,493223277,490611510
29378729_2297718,CM021104.1,5,29378729,491143024,2493009,2297718,493440742,490828975
29378729_2298206,CM021104.1,5,29378729,491143024,2493009,2298206,493441230,490829463
29382233_2362436,CM021104.1,5,29382233,491126248,2929548,2362436,493488684,490876917
29382233_2362448,CM021104.1,5,29382233,491126248,2929548,2362448,493488696,490876929
29382233_2362465,CM021104.1,5,29382233,491126248,2929548,2362465,493488713,490876946
29382233_2362518,CM021104.1,5,29382233,491126248,2929548,2362518,493488766,490876999
29382233_2362533,CM021104.1,5,29382233,491126248,2929548,2362533,493488781,490877014
29382233_2435518,CM021104.1,5,29382233,491126248,2929548,2435518,493561766,490949999
29382233_2435659,CM021104.1,5,29382233,491126248,2929548,2435659,493561907,490950140
29382233_2435769,CM021104.1,5,29382233,491126248,2929548,2435769,493562017,490950250
29382233_2435783,CM021104.1,5,29382233,491126248,2929548,2435783,493562031,490950264
29379627_2635970,CM021104.1,5,29379627,491126248,6027700,2635970,493762218,491150451
29379627_2660463,CM021104.1,5,29379627,491126248,6027700,2660463,493786711,491174944
29378331_2809646,CM021104.1,5,29378331,491126247,3113707,2809646,493935893,491324126
29378331_2809810,CM021104.1,5,29378331,491126247,3113707,2809810,493936057,491324290
29382196_2801494,CM021104.1,5,29382196,491142383,3031664,2801494,493943877,491332110
29382196_2801638,CM021104.1,5,29382196,491142383,3031664,2801638,493944021,491332254
29382196_2801794,CM021104.1,5,29382196,491142383,3031664,2801794,493944177,491332410
29379100_2917121,CM021104.1,5,29379100,491142512,3012358,2917121,494059633,491447866
29379100_2917174,CM021104.1,5,29379100,491142512,3012358,2917174,494059686,491447919
29379100_2961442,CM021104.1,5,29379100,491142512,3012358,2961442,494103954,491492187
29379627_3255866,CM021104.1,5,29379627,491126248,6027700,3255866,494382114,491770347
29379627_3256031,CM021104.1,5,29379627,491126248,6027700,3256031,494382279,491770512
29379627_3256035,CM021104.1,5,29379627,491126248,6027700,3256035,494382283,491770516
29379627_3256050,CM021104.1,5,29379627,491126248,6027700,3256050,494382298,491770531
29379627_3256091,CM021104.1,5,29379627,491126248,6027700,3256091,494382339,491770572
29377127_3669180,CM021104.1,5,29377127,491126245,6614952,3669180,494795425,492183658
29377127_3669211,CM021104.1,5,29377127,491126245,6614952,3669211,494795456,492183689
29377127_3670119,CM021104.1,5,29377127,491126245,6614952,3670119,494796364,492184597
29377127_3674548,CM021104.1,5,29377127,491126245,6614952,3674548,494800793,492189026
29377127_3674733,CM021104.1,5,29377127,491126245,6614952,3674733,494800978,492189211
29377127_3674739,CM021104.1,5,29377127,491126245,6614952,3674739,494800984,492189217
29377127_4169484,CM021104.1,5,29377127,491126245,6614952,4169484,495295729,492683962
29377127_4677642,CM021104.1,5,29377127,491126245,6614952,4677642,495803887,493192120
29377127_5074362,CM021104.1,5,29377127,491126245,6614952,5074362,496200607,493588840
29377127_5074421,CM021104.1,5,29377127,491126245,6614952,5074421,496200666,493588899
29378950_31678,CM021104.1,5,29378950,512202394,759092,31678,512234072,509622305
29378950_31681,CM021104.1,5,29378950,512202394,759092,31681,512234075,509622308
29355999_37918,CM021104.1,5,29355999,512207713,206989,37918,512245631,509633864
29355999_37970,CM021104.1,5,29355999,512207713,206989,37970,512245683,509633916
29378950_48713,CM021104.1,5,29378950,512202394,759092,48713,512251107,509639340
29378950_48784,CM021104.1,5,29378950,512202394,759092,48784,512251178,509639411
29378950_48810,CM021104.1,5,29378950,512202394,759092,48810,512251204,509639437
29378950_48827,CM021104.1,5,29378950,512202394,759092,48827,512251221,509639454
29378844_63549,CM021104.1,5,29378844,512204845,3538696,63549,512268394,509656627
29378844_63561,CM021104.1,5,29378844,512204845,3538696,63561,512268406,509656639
29378844_63570,CM021104.1,5,29378844,512204845,3538696,63570,512268415,509656648
29382305_88217,CM021104.1,5,29382305,512203656,1061181,88217,512291873,509680106
29379358_87018,CM021104.1,5,29379358,512207301,87576,87018,512294319,509682552
29379358_87028,CM021104.1,5,29379358,512207301,87576,87028,512294329,509682562
29379358_87108,CM021104.1,5,29379358,512207301,87576,87108,512294409,509682642
29379759_151158,CM021104.1,5,29379759,512205486,739546,151158,512356644,509744877
29379759_151826,CM021104.1,5,29379759,512205486,739546,151826,512357312,509745545
29380809_162955,CM021104.1,5,29380809,512202391,1850025,162955,512365346,509753579
29380809_203004,CM021104.1,5,29380809,512202391,1850025,203004,512405395,509793628
29380809_237503,CM021104.1,5,29380809,512202391,1850025,237503,512439894,509828127
29346307_247338,CM021104.1,5,29346307,512205064,462203,247338,512452402,509840635
29379759_278527,CM021104.1,5,29379759,512205486,739546,278527,512484013,509872246
29379759_278973,CM021104.1,5,29379759,512205486,739546,278973,512484459,509872692
29380809_443195,CM021104.1,5,29380809,512202391,1850025,443195,512645586,510033819
29377813_696744,CM021104.1,5,29377813,512205208,856239,696744,512901952,510290185
29377813_700630,CM021104.1,5,29377813,512205208,856239,700630,512905838,510294071
29377813_700842,CM021104.1,5,29377813,512205208,856239,700842,512906050,510294283
29380809_732779,CM021104.1,5,29380809,512202391,1850025,732779,512935170,510323403
29380809_732780,CM021104.1,5,29380809,512202391,1850025,732780,512935171,510323404
29380809_732788,CM021104.1,5,29380809,512202391,1850025,732788,512935179,510323412
29380809_732799,CM021104.1,5,29380809,512202391,1850025,732799,512935190,510323423
29380809_732802,CM021104.1,5,29380809,512202391,1850025,732802,512935193,510323426
29380809_732814,CM021104.1,5,29380809,512202391,1850025,732814,512935205,510323438
29380809_732833,CM021104.1,5,29380809,512202391,1850025,732833,512935224,510323457
29380809_732976,CM021104.1,5,29380809,512202391,1850025,732976,512935367,510323600
29380809_733072,CM021104.1,5,29380809,512202391,1850025,733072,512935463,510323696
29380809_733108,CM021104.1,5,29380809,512202391,1850025,733108,512935499,510323732
29380809_733126,CM021104.1,5,29380809,512202391,1850025,733126,512935517,510323750
29380809_735836,CM021104.1,5,29380809,512202391,1850025,735836,512938227,510326460
29380809_735918,CM021104.1,5,29380809,512202391,1850025,735918,512938309,510326542
29380809_736282,CM021104.1,5,29380809,512202391,1850025,736282,512938673,510326906
29377813_768501,CM021104.1,5,29377813,512205208,856239,768501,512973709,510361942
29382305_1046581,CM021104.1,5,29382305,512203656,1061181,1046581,513250237,510638470
29382305_1046684,CM021104.1,5,29382305,512203656,1061181,1046684,513250340,510638573
29382305_1046689,CM021104.1,5,29382305,512203656,1061181,1046689,513250345,510638578
29382305_1046786,CM021104.1,5,29382305,512203656,1061181,1046786,513250442,510638675
29378844_2192132,CM021104.1,5,29378844,512204845,3538696,2192132,514396977,511785210
29378844_2192140,CM021104.1,5,29378844,512204845,3538696,2192140,514396985,511785218
29378844_2302670,CM021104.1,5,29378844,512204845,3538696,2302670,514507515,511895748
29378844_2302746,CM021104.1,5,29378844,512204845,3538696,2302746,514507591,511895824
29378844_2767199,CM021104.1,5,29378844,512204845,3538696,2767199,514972044,512360277
29378844_2767208,CM021104.1,5,29378844,512204845,3538696,2767208,514972053,512360286
29378844_2767227,CM021104.1,5,29378844,512204845,3538696,2767227,514972072,512360305
29378844_2767233,CM021104.1,5,29378844,512204845,3538696,2767233,514972078,512360311
29378844_2767247,CM021104.1,5,29378844,512204845,3538696,2767247,514972092,512360325
29378844_2767262,CM021104.1,5,29378844,512204845,3538696,2767262,514972107,512360340
29378844_2767275,CM021104.1,5,29378844,512204845,3538696,2767275,514972120,512360353
29378844_3326564,CM021104.1,5,29378844,512204845,3538696,3326564,515531409,512919642
29378844_3326579,CM021104.1,5,29378844,512204845,3538696,3326579,515531424,512919657
29378844_3328040,CM021104.1,5,29378844,512204845,3538696,3328040,515532885,512921118
29378844_3329576,CM021104.1,5,29378844,512204845,3538696,3329576,515534421,512922654
29378844_3329598,CM021104.1,5,29378844,512204845,3538696,3329598,515534443,512922676
29378844_3329656,CM021104.1,5,29378844,512204845,3538696,3329656,515534501,512922734
29378844_3343631,CM021104.1,5,29378844,512204845,3538696,3343631,515548476,512936709
29378844_3345316,CM021104.1,5,29378844,512204845,3538696,3345316,515550161,512938394
29378844_3345365,CM021104.1,5,29378844,512204845,3538696,3345365,515550210,512938443
29378844_3345413,CM021104.1,5,29378844,512204845,3538696,3345413,515550258,512938491
29378844_3345457,CM021104.1,5,29378844,512204845,3538696,3345457,515550302,512938535
29382218_84047,CM021104.1,5,29382218,535917211,145823,84047,536001258,533389491
29382218_84093,CM021104.1,5,29382218,535917211,145823,84093,536001304,533389537
29382218_103995,CM021104.1,5,29382218,535917211,145823,103995,536021206,533409439
29382218_112250,CM021104.1,5,29382218,535917211,145823,112250,536029461,533417694
29382218_112273,CM021104.1,5,29382218,535917211,145823,112273,536029484,533417717
29382218_136762,CM021104.1,5,29382218,535917211,145823,136762,536053973,533442206
29378112_539583,CM021104.1,5,29378112,535917211,698785,539583,536456794,533845027
29378112_539584,CM021104.1,5,29378112,535917211,698785,539584,536456795,533845028
29378112_614273,CM021104.1,5,29378112,535917211,698785,614273,536531484,533919717
29378112_614337,CM021104.1,5,29378112,535917211,698785,614337,536531548,533919781
29378112_614583,CM021104.1,5,29378112,535917211,698785,614583,536531794,533920027
29378112_614584,CM021104.1,5,29378112,535917211,698785,614584,536531795,533920028
29378112_614622,CM021104.1,5,29378112,535917211,698785,614622,536531833,533920066
29378112_614633,CM021104.1,5,29378112,535917211,698785,614633,536531844,533920077
29378112_614639,CM021104.1,5,29378112,535917211,698785,614639,536531850,533920083
29378112_614646,CM021104.1,5,29378112,535917211,698785,614646,536531857,533920090
29378112_614672,CM021104.1,5,29378112,535917211,698785,614672,536531883,533920116
29378112_623296,CM021104.1,5,29378112,535917211,698785,623296,536540507,533928740
29378112_623407,CM021104.1,5,29378112,535917211,698785,623407,536540618,533928851
29381538_13750,CM021104.1,5,29381538,547639561,1053629,13750,547653311,545041544
29378781_195381,CM021104.1,5,29378781,547624455,845350,195381,547819836,545208069
29378781_195389,CM021104.1,5,29378781,547624455,845350,195389,547819844,545208077
29378781_195902,CM021104.1,5,29378781,547624455,845350,195902,547820357,545208590
29377466_222119,CM021104.1,5,29377466,547637324,1887620,222119,547859443,545247676
29377466_222136,CM021104.1,5,29377466,547637324,1887620,222136,547859460,545247693
29377466_222142,CM021104.1,5,29377466,547637324,1887620,222142,547859466,545247699
29377466_222279,CM021104.1,5,29377466,547637324,1887620,222279,547859603,545247836
29377466_222289,CM021104.1,5,29377466,547637324,1887620,222289,547859613,545247846
29377466_222316,CM021104.1,5,29377466,547637324,1887620,222316,547859640,545247873
29377466_222321,CM021104.1,5,29377466,547637324,1887620,222321,547859645,545247878
29377466_222322,CM021104.1,5,29377466,547637324,1887620,222322,547859646,545247879
29377466_222336,CM021104.1,5,29377466,547637324,1887620,222336,547859660,545247893
29377466_222341,CM021104.1,5,29377466,547637324,1887620,222341,547859665,545247898
29380695_402418,CM021104.1,5,29380695,547639485,936506,402418,548041903,545430136
29378742_425261,CM021104.1,5,29378742,547638943,2118561,425261,548064204,545452437
29378781_521837,CM021104.1,5,29378781,547624455,845350,521837,548146292,545534525
29378781_521902,CM021104.1,5,29378781,547624455,845350,521902,548146357,545534590
29379416_873831,CM021104.1,5,29379416,547624456,2329995,873831,548498287,545886520
29379416_873901,CM021104.1,5,29379416,547624456,2329995,873901,548498357,545886590
29379416_873919,CM021104.1,5,29379416,547624456,2329995,873919,548498375,545886608
29379416_873926,CM021104.1,5,29379416,547624456,2329995,873926,548498382,545886615
29379416_912513,CM021104.1,5,29379416,547624456,2329995,912513,548536969,545925202
29379416_912528,CM021104.1,5,29379416,547624456,2329995,912528,548536984,545925217
29379416_933402,CM021104.1,5,29379416,547624456,2329995,933402,548557858,545946091
29379416_933489,CM021104.1,5,29379416,547624456,2329995,933489,548557945,545946178
29382037_1176497,CM021104.1,5,29382037,547638223,2417016,1176497,548814720,546202953
29382037_1176512,CM021104.1,5,29382037,547638223,2417016,1176512,548814735,546202968
29382037_1176539,CM021104.1,5,29382037,547638223,2417016,1176539,548814762,546202995
29381771_1675742,CM021104.1,5,29381771,547624454,1937226,1675742,549300196,546688429
29381771_1675743,CM021104.1,5,29381771,547624454,1937226,1675743,549300197,546688430
29379416_1951593,CM021104.1,5,29379416,547624456,2329995,1951593,549576049,546964282
29380223_2224432,CM021104.1,5,29380223,547637056,3706006,2224432,549861488,547249721
29382037_2228552,CM021104.1,5,29382037,547638223,2417016,2228552,549866775,547255008
29379416_2299964,CM021104.1,5,29379416,547624456,2329995,2299964,549924420,547312653
29382037_2340160,CM021104.1,5,29382037,547638223,2417016,2340160,549978383,547366616
29382037_2341711,CM021104.1,5,29382037,547638223,2417016,2341711,549979934,547368167
29382016_2381795,CM021104.1,5,29382016,547629347,3978459,2381795,550011142,547399375
29382016_3102053,CM021104.1,5,29382016,547629347,3978459,3102053,550731400,548119633
29382016_3102134,CM021104.1,5,29382016,547629347,3978459,3102134,550731481,548119714
28381674_2564,CM021104.1,5,28381674,550847785,5841,2564,550850349,548238582
28381674_2590,CM021104.1,5,28381674,550847785,5841,2590,550850375,548238608
28381674_2599,CM021104.1,5,28381674,550847785,5841,2599,550850384,548238617
28381674_2601,CM021104.1,5,28381674,550847785,5841,2601,550850386,548238619
29382016_3908790,CM021104.1,5,29382016,547629347,3978459,3908790,551538137,548926370
29382016_3908800,CM021104.1,5,29382016,547629347,3978459,3908800,551538147,548926380
29382016_3969290,CM021104.1,5,29382016,547629347,3978459,3969290,551598637,548986870
29382016_3969548,CM021104.1,5,29382016,547629347,3978459,3969548,551598895,548987128
29382016_3969599,CM021104.1,5,29382016,547629347,3978459,3969599,551598946,548987179
29338074_15036,CM021104.1,5,29338074,571492187,36534,15036,571507223,568895456
29380950_434038,CM021104.1,5,29380950,571492187,646756,434038,571926225,569314458
29381874_757391,CM021104.1,5,29381874,574659951,1162294,757391,575417342,572805575
29381874_757409,CM021104.1,5,29381874,574659951,1162294,757409,575417360,572805593
29381874_757425,CM021104.1,5,29381874,574659951,1162294,757425,575417376,572805609
29381874_757445,CM021104.1,5,29381874,574659951,1162294,757445,575417396,572805629
29381874_757452,CM021104.1,5,29381874,574659951,1162294,757452,575417403,572805636
29381874_757454,CM021104.1,5,29381874,574659951,1162294,757454,575417405,572805638
29381874_757471,CM021104.1,5,29381874,574659951,1162294,757471,575417422,572805655
29381573_72636,CM021104.1,5,29381573,635578806,286164,72636,635651442,633039675
29381863_79764,CM021104.1,5,29381863,635578737,977371,79764,635658501,633046734
29381863_79988,CM021104.1,5,29381863,635578737,977371,79988,635658725,633046958
29381863_80011,CM021104.1,5,29381863,635578737,977371,80011,635658748,633046981
29381863_94039,CM021104.1,5,29381863,635578737,977371,94039,635672776,633061009
29381863_94104,CM021104.1,5,29381863,635578737,977371,94104,635672841,633061074
29381863_94138,CM021104.1,5,29381863,635578737,977371,94138,635672875,633061108
29379636_112651,CM021104.1,5,29379636,635578737,1374906,112651,635691388,633079621
29379636_112671,CM021104.1,5,29379636,635578737,1374906,112671,635691408,633079641
29379636_112672,CM021104.1,5,29379636,635578737,1374906,112672,635691409,633079642
29381863_237628,CM021104.1,5,29381863,635578737,977371,237628,635816365,633204598
29381863_237703,CM021104.1,5,29381863,635578737,977371,237703,635816440,633204673
29381863_237771,CM021104.1,5,29381863,635578737,977371,237771,635816508,633204741
29372994_9172,CM021104.1,5,29372994,638556185,37699,9172,638565357,635953590
29380823_888186,CM021104.1,5,29380823,645850066,4916045,888186,646738252,644126485
29380823_3007512,CM021104.1,5,29380823,645850066,4916045,3007512,648857578,646245811
29380823_3314681,CM021104.1,5,29380823,645850066,4916045,3314681,649164747,646552980
29380823_3775273,CM021104.1,5,29380823,645850066,4916045,3775273,649625339,647013572
29380823_3775452,CM021104.1,5,29380823,645850066,4916045,3775452,649625518,647013751
29380823_3775482,CM021104.1,5,29380823,645850066,4916045,3775482,649625548,647013781
29380823_4883419,CM021104.1,5,29380823,645850066,4916045,4883419,650733485,648121718
29380823_4883440,CM021104.1,5,29380823,645850066,4916045,4883440,650733506,648121739
29380823_4883452,CM021104.1,5,29380823,645850066,4916045,4883452,650733518,648121751
29101419_4780,CM021104.1,5,29101419,662626786,5398,4780,662631566,660019799
29379280_34405,CM021104.1,5,29379280,684499700,2483442,34405,684534105,681922338
29379280_34491,CM021104.1,5,29379280,684499700,2483442,34491,684534191,681922424
29379280_36292,CM021104.1,5,29379280,684499700,2483442,36292,684535992,681924225
29379280_36293,CM021104.1,5,29379280,684499700,2483442,36293,684535993,681924226
29380396_1307062,CM021104.1,5,29380396,684499705,3531113,1307062,685806767,683195000
29380396_1307956,CM021104.1,5,29380396,684499705,3531113,1307956,685807661,683195894
29380396_2125239,CM021104.1,5,29380396,684499705,3531113,2125239,686624944,684013177
28137071_1470,CM021104.1,5,28137071,690387814,2974,1470,690389284,687777517
29345763_330512,CM021105.1,6,29345763,7960486,594452,330512,8290998,7889392
29345763_330572,CM021105.1,6,29345763,7960486,594452,330572,8291058,7889452
29345763_355901,CM021105.1,6,29345763,7960486,594452,355901,8316387,7914781
29345763_422505,CM021105.1,6,29345763,7960486,594452,422505,8382991,7981385
29345763_422629,CM021105.1,6,29345763,7960486,594452,422629,8383115,7981509
29345763_422693,CM021105.1,6,29345763,7960486,594452,422693,8383179,7981573
29380476_645427,CM021105.1,6,29380476,7947869,5467385,645427,8593296,8191690
29380476_645457,CM021105.1,6,29380476,7947869,5467385,645457,8593326,8191720
29380476_646839,CM021105.1,6,29380476,7947869,5467385,646839,8594708,8193102
29380476_659083,CM021105.1,6,29380476,7947869,5467385,659083,8606952,8205346
29380476_1498611,CM021105.1,6,29380476,7947869,5467385,1498611,9446480,9044874
29380476_2831844,CM021105.1,6,29380476,7947869,5467385,2831844,10779713,10378107
29380476_2869223,CM021105.1,6,29380476,7947869,5467385,2869223,10817092,10415486
29380476_2871247,CM021105.1,6,29380476,7947869,5467385,2871247,10819116,10417510
29380476_2915119,CM021105.1,6,29380476,7947869,5467385,2915119,10862988,10461382
29380476_2987177,CM021105.1,6,29380476,7947869,5467385,2987177,10935046,10533440
29380476_2987251,CM021105.1,6,29380476,7947869,5467385,2987251,10935120,10533514
29380476_2987268,CM021105.1,6,29380476,7947869,5467385,2987268,10935137,10533531
29380476_2987313,CM021105.1,6,29380476,7947869,5467385,2987313,10935182,10533576
29380476_2987390,CM021105.1,6,29380476,7947869,5467385,2987390,10935259,10533653
29380476_3267016,CM021105.1,6,29380476,7947869,5467385,3267016,11214885,10813279
29380476_3267062,CM021105.1,6,29380476,7947869,5467385,3267062,11214931,10813325
29380476_3925645,CM021105.1,6,29380476,7947869,5467385,3925645,11873514,11471908
29380476_3925700,CM021105.1,6,29380476,7947869,5467385,3925700,11873569,11471963
29341928_503,CM021105.1,6,29341928,29708651,18720,503,29709154,29307548
29341928_532,CM021105.1,6,29341928,29708651,18720,532,29709183,29307577
29341928_547,CM021105.1,6,29341928,29708651,18720,547,29709198,29307592
29341928_555,CM021105.1,6,29341928,29708651,18720,555,29709206,29307600
29341928_576,CM021105.1,6,29341928,29708651,18720,576,29709227,29307621
29377163_35335,CM021105.1,6,29377163,30500225,3661619,35335,30535560,30133954
29377083_75478,CM021105.1,6,29377083,30497286,368209,75478,30572764,30171158
29379507_97290,CM021105.1,6,29379507,30500150,2004569,97290,30597440,30195834
29379507_97377,CM021105.1,6,29379507,30500150,2004569,97377,30597527,30195921
29379507_97418,CM021105.1,6,29379507,30500150,2004569,97418,30597568,30195962
29379507_97421,CM021105.1,6,29379507,30500150,2004569,97421,30597571,30195965
29379507_97434,CM021105.1,6,29379507,30500150,2004569,97434,30597584,30195978
29379507_97435,CM021105.1,6,29379507,30500150,2004569,97435,30597585,30195979
29380534_142463,CM021105.1,6,29380534,30497289,2623248,142463,30639752,30238146
29380534_142478,CM021105.1,6,29380534,30497289,2623248,142478,30639767,30238161
29380534_142485,CM021105.1,6,29380534,30497289,2623248,142485,30639774,30238168
29380534_142505,CM021105.1,6,29380534,30497289,2623248,142505,30639794,30238188
29381616_148036,CM021105.1,6,29381616,30505628,557328,148036,30653664,30252058
29381616_148147,CM021105.1,6,29381616,30505628,557328,148147,30653775,30252169
29380572_173632,CM021105.1,6,29380572,30502503,787761,173632,30676135,30274529
29380572_173705,CM021105.1,6,29380572,30502503,787761,173705,30676208,30274602
29380572_173859,CM021105.1,6,29380572,30502503,787761,173859,30676362,30274756
29382310_193260,CM021105.1,6,29382310,30499978,2030819,193260,30693238,30291632
29382310_193450,CM021105.1,6,29382310,30499978,2030819,193450,30693428,30291822
29381616_234273,CM021105.1,6,29381616,30505628,557328,234273,30739901,30338295
29381616_234282,CM021105.1,6,29381616,30505628,557328,234282,30739910,30338304
29380534_243658,CM021105.1,6,29380534,30497289,2623248,243658,30740947,30339341
29380534_243742,CM021105.1,6,29380534,30497289,2623248,243742,30741031,30339425
29380534_244124,CM021105.1,6,29380534,30497289,2623248,244124,30741413,30339807
29379053_262386,CM021105.1,6,29379053,30497284,294420,262386,30759670,30358064
29378596_281324,CM021105.1,6,29378596,30500582,1209214,281324,30781906,30380300
29378596_281334,CM021105.1,6,29378596,30500582,1209214,281334,30781916,30380310
29377573_293460,CM021105.1,6,29377573,30497289,7027737,293460,30790749,30389143
29377045_303388,CM021105.1,6,29377045,30501476,616024,303388,30804864,30403258
29377163_326672,CM021105.1,6,29377163,30500225,3661619,326672,30826897,30425291
29377163_326673,CM021105.1,6,29377163,30500225,3661619,326673,30826898,30425292
29377163_326687,CM021105.1,6,29377163,30500225,3661619,326687,30826912,30425306
29380572_362487,CM021105.1,6,29380572,30502503,787761,362487,30864990,30463384
29380572_362529,CM021105.1,6,29380572,30502503,787761,362529,30865032,30463426
29380572_362557,CM021105.1,6,29380572,30502503,787761,362557,30865060,30463454
29380572_362569,CM021105.1,6,29380572,30502503,787761,362569,30865072,30463466
29380572_362591,CM021105.1,6,29380572,30502503,787761,362591,30865094,30463488
29380572_362599,CM021105.1,6,29380572,30502503,787761,362599,30865102,30463496
29377721_381332,CM021105.1,6,29377721,30497289,13524941,381332,30878621,30477015
29377573_393063,CM021105.1,6,29377573,30497289,7027737,393063,30890352,30488746
29377573_393121,CM021105.1,6,29377573,30497289,7027737,393121,30890410,30488804
29380572_420860,CM021105.1,6,29380572,30502503,787761,420860,30923363,30521757
29380572_422020,CM021105.1,6,29380572,30502503,787761,422020,30924523,30522917
29380572_422089,CM021105.1,6,29380572,30502503,787761,422089,30924592,30522986
29380572_422376,CM021105.1,6,29380572,30502503,787761,422376,30924879,30523273
29380572_422419,CM021105.1,6,29380572,30502503,787761,422419,30924922,30523316
29379405_527984,CM021105.1,6,29379405,30499396,3530741,527984,31027380,30625774
29379405_528027,CM021105.1,6,29379405,30499396,3530741,528027,31027423,30625817
29379405_528039,CM021105.1,6,29379405,30499396,3530741,528039,31027435,30625829
29380572_537586,CM021105.1,6,29380572,30502503,787761,537586,31040089,30638483
29380572_537621,CM021105.1,6,29380572,30502503,787761,537621,31040124,30638518
29380572_537692,CM021105.1,6,29380572,30502503,787761,537692,31040195,30638589
29380572_537876,CM021105.1,6,29380572,30502503,787761,537876,31040379,30638773
29380572_538221,CM021105.1,6,29380572,30502503,787761,538221,31040724,30639118
29380572_540132,CM021105.1,6,29380572,30502503,787761,540132,31042635,30641029
29382310_584757,CM021105.1,6,29382310,30499978,2030819,584757,31084735,30683129
29382310_585147,CM021105.1,6,29382310,30499978,2030819,585147,31085125,30683519
29379405_598673,CM021105.1,6,29379405,30499396,3530741,598673,31098069,30696463
29379405_620530,CM021105.1,6,29379405,30499396,3530741,620530,31119926,30718320
29380364_617214,CM021105.1,6,29380364,30503404,2240249,617214,31120618,30719012
29380364_617307,CM021105.1,6,29380364,30503404,2240249,617307,31120711,30719105
29379405_630425,CM021105.1,6,29379405,30499396,3530741,630425,31129821,30728215
29379405_630463,CM021105.1,6,29379405,30499396,3530741,630463,31129859,30728253
29379405_630482,CM021105.1,6,29379405,30499396,3530741,630482,31129878,30728272
29379405_630524,CM021105.1,6,29379405,30499396,3530741,630524,31129920,30728314
29380364_649662,CM021105.1,6,29380364,30503404,2240249,649662,31153066,30751460
29380364_649735,CM021105.1,6,29380364,30503404,2240249,649735,31153139,30751533
29380364_649792,CM021105.1,6,29380364,30503404,2240249,649792,31153196,30751590
29378596_692575,CM021105.1,6,29378596,30500582,1209214,692575,31193157,30791551
29378596_692629,CM021105.1,6,29378596,30500582,1209214,692629,31193211,30791605
29378596_692649,CM021105.1,6,29378596,30500582,1209214,692649,31193231,30791625
29378596_692660,CM021105.1,6,29378596,30500582,1209214,692660,31193242,30791636
29378596_692666,CM021105.1,6,29378596,30500582,1209214,692666,31193248,30791642
29378596_692671,CM021105.1,6,29378596,30500582,1209214,692671,31193253,30791647
29378596_692736,CM021105.1,6,29378596,30500582,1209214,692736,31193318,30791712
29378596_692792,CM021105.1,6,29378596,30500582,1209214,692792,31193374,30791768
29378596_692821,CM021105.1,6,29378596,30500582,1209214,692821,31193403,30791797
29378596_692822,CM021105.1,6,29378596,30500582,1209214,692822,31193404,30791798
29377721_709530,CM021105.1,6,29377721,30497289,13524941,709530,31206819,30805213
29380364_788607,CM021105.1,6,29380364,30503404,2240249,788607,31292011,30890405
29380364_788624,CM021105.1,6,29380364,30503404,2240249,788624,31292028,30890422
29380364_788628,CM021105.1,6,29380364,30503404,2240249,788628,31292032,30890426
29380364_788640,CM021105.1,6,29380364,30503404,2240249,788640,31292044,30890438
29380364_788652,CM021105.1,6,29380364,30503404,2240249,788652,31292056,30890450
29380364_788698,CM021105.1,6,29380364,30503404,2240249,788698,31292102,30890496
29380364_788706,CM021105.1,6,29380364,30503404,2240249,788706,31292110,30890504
29377573_801241,CM021105.1,6,29377573,30497289,7027737,801241,31298530,30896924
29380364_930750,CM021105.1,6,29380364,30503404,2240249,930750,31434154,31032548
29380364_930876,CM021105.1,6,29380364,30503404,2240249,930876,31434280,31032674
29382310_980563,CM021105.1,6,29382310,30499978,2030819,980563,31480541,31078935
29382310_980626,CM021105.1,6,29382310,30499978,2030819,980626,31480604,31078998
29377326_1035203,CM021105.1,6,29377326,30500034,1155824,1035203,31535237,31133631
29377326_1087188,CM021105.1,6,29377326,30500034,1155824,1087188,31587222,31185616
29380364_1104857,CM021105.1,6,29380364,30503404,2240249,1104857,31608261,31206655
29378001_1172020,CM021105.1,6,29378001,30497285,1315796,1172020,31669305,31267699
29378001_1172058,CM021105.1,6,29378001,30497285,1315796,1172058,31669343,31267737
29378001_1172094,CM021105.1,6,29378001,30497285,1315796,1172094,31669379,31267773
29378001_1172210,CM021105.1,6,29378001,30497285,1315796,1172210,31669495,31267889
29382310_1202167,CM021105.1,6,29382310,30499978,2030819,1202167,31702145,31300539
29382310_1202245,CM021105.1,6,29382310,30499978,2030819,1202245,31702223,31300617
29380364_1222275,CM021105.1,6,29380364,30503404,2240249,1222275,31725679,31324073
29380364_1222301,CM021105.1,6,29380364,30503404,2240249,1222301,31725705,31324099
29380364_1222347,CM021105.1,6,29380364,30503404,2240249,1222347,31725751,31324145
29377573_1288732,CM021105.1,6,29377573,30497289,7027737,1288732,31786021,31384415
29379405_1322235,CM021105.1,6,29379405,30499396,3530741,1322235,31821631,31420025
29379405_1322237,CM021105.1,6,29379405,30499396,3530741,1322237,31821633,31420027
29379405_1322317,CM021105.1,6,29379405,30499396,3530741,1322317,31821713,31420107
29379405_1322330,CM021105.1,6,29379405,30499396,3530741,1322330,31821726,31420120
29379405_1322404,CM021105.1,6,29379405,30499396,3530741,1322404,31821800,31420194
29379405_1322408,CM021105.1,6,29379405,30499396,3530741,1322408,31821804,31420198
29379405_1322426,CM021105.1,6,29379405,30499396,3530741,1322426,31821822,31420216
29379405_1322698,CM021105.1,6,29379405,30499396,3530741,1322698,31822094,31420488
29379405_1322705,CM021105.1,6,29379405,30499396,3530741,1322705,31822101,31420495
29379405_1322706,CM021105.1,6,29379405,30499396,3530741,1322706,31822102,31420496
29382310_1325401,CM021105.1,6,29382310,30499978,2030819,1325401,31825379,31423773
29382310_1325433,CM021105.1,6,29382310,30499978,2030819,1325433,31825411,31423805
29379405_1333575,CM021105.1,6,29379405,30499396,3530741,1333575,31832971,31431365
29381325_1361031,CM021105.1,6,29381325,30501848,1688808,1361031,31862879,31461273
29381325_1361059,CM021105.1,6,29381325,30501848,1688808,1361059,31862907,31461301
29381325_1361084,CM021105.1,6,29381325,30501848,1688808,1361084,31862932,31461326
29381325_1362541,CM021105.1,6,29381325,30501848,1688808,1362541,31864389,31462783
29381325_1362545,CM021105.1,6,29381325,30501848,1688808,1362545,31864393,31462787
29381325_1362570,CM021105.1,6,29381325,30501848,1688808,1362570,31864418,31462812
29381325_1362584,CM021105.1,6,29381325,30501848,1688808,1362584,31864432,31462826
29381325_1362640,CM021105.1,6,29381325,30501848,1688808,1362640,31864488,31462882
29381325_1362661,CM021105.1,6,29381325,30501848,1688808,1362661,31864509,31462903
29380364_1435379,CM021105.1,6,29380364,30503404,2240249,1435379,31938783,31537177
29377721_1488602,CM021105.1,6,29377721,30497289,13524941,1488602,31985891,31584285
29377721_1488666,CM021105.1,6,29377721,30497289,13524941,1488666,31985955,31584349
29380364_1536251,CM021105.1,6,29380364,30503404,2240249,1536251,32039655,31638049
29380364_1536375,CM021105.1,6,29380364,30503404,2240249,1536375,32039779,31638173
29380364_1536399,CM021105.1,6,29380364,30503404,2240249,1536399,32039803,31638197
29380364_1536423,CM021105.1,6,29380364,30503404,2240249,1536423,32039827,31638221
29379743_1632251,CM021105.1,6,29379743,30497289,3409138,1632251,32129540,31727934
29380364_1752873,CM021105.1,6,29380364,30503404,2240249,1752873,32256277,31854671
29380364_1752929,CM021105.1,6,29380364,30503404,2240249,1752929,32256333,31854727
29380364_1784739,CM021105.1,6,29380364,30503404,2240249,1784739,32288143,31886537
29380364_1785428,CM021105.1,6,29380364,30503404,2240249,1785428,32288832,31887226
29380364_1785455,CM021105.1,6,29380364,30503404,2240249,1785455,32288859,31887253
29380364_1856384,CM021105.1,6,29380364,30503404,2240249,1856384,32359788,31958182
29380364_1856730,CM021105.1,6,29380364,30503404,2240249,1856730,32360134,31958528
29380364_1856734,CM021105.1,6,29380364,30503404,2240249,1856734,32360138,31958532
29380364_1891962,CM021105.1,6,29380364,30503404,2240249,1891962,32395366,31993760
29379743_1911082,CM021105.1,6,29379743,30497289,3409138,1911082,32408371,32006765
29379743_1957548,CM021105.1,6,29379743,30497289,3409138,1957548,32454837,32053231
29379743_1957552,CM021105.1,6,29379743,30497289,3409138,1957552,32454841,32053235
29379743_1957597,CM021105.1,6,29379743,30497289,3409138,1957597,32454886,32053280
29380534_2073722,CM021105.1,6,29380534,30497289,2623248,2073722,32571011,32169405
29380534_2073875,CM021105.1,6,29380534,30497289,2623248,2073875,32571164,32169558
29380534_2073913,CM021105.1,6,29380534,30497289,2623248,2073913,32571202,32169596
29380534_2073939,CM021105.1,6,29380534,30497289,2623248,2073939,32571228,32169622
29380909_2149604,CM021105.1,6,29380909,30500479,2307041,2149604,32650083,32248477
29380909_2149695,CM021105.1,6,29380909,30500479,2307041,2149695,32650174,32248568
29380909_2149701,CM021105.1,6,29380909,30500479,2307041,2149701,32650180,32248574
29380909_2149772,CM021105.1,6,29380909,30500479,2307041,2149772,32650251,32248645
29380944_2380130,CM021105.1,6,29380944,30500278,4538743,2380130,32880408,32478802
29380944_2380151,CM021105.1,6,29380944,30500278,4538743,2380151,32880429,32478823
29377721_2970524,CM021105.1,6,29377721,30497289,13524941,2970524,33467813,33066207
29377721_2970531,CM021105.1,6,29377721,30497289,13524941,2970531,33467820,33066214
29377721_2970555,CM021105.1,6,29377721,30497289,13524941,2970555,33467844,33066238
29377721_2970577,CM021105.1,6,29377721,30497289,13524941,2970577,33467866,33066260
29377721_3123306,CM021105.1,6,29377721,30497289,13524941,3123306,33620595,33218989
29380944_3401335,CM021105.1,6,29380944,30500278,4538743,3401335,33901613,33500007
29377721_3582553,CM021105.1,6,29377721,30497289,13524941,3582553,34079842,33678236
29377721_3582636,CM021105.1,6,29377721,30497289,13524941,3582636,34079925,33678319
29380944_4052316,CM021105.1,6,29380944,30500278,4538743,4052316,34552594,34150988
29380944_4052383,CM021105.1,6,29380944,30500278,4538743,4052383,34552661,34151055
29377721_4282292,CM021105.1,6,29377721,30497289,13524941,4282292,34779581,34377975
29377721_4419770,CM021105.1,6,29377721,30497289,13524941,4419770,34917059,34515453
29371119_88929,CM021105.1,6,29371119,34863633,98773,88929,34952562,34550956
29371119_88979,CM021105.1,6,29371119,34863633,98773,88979,34952612,34551006
29377721_4572375,CM021105.1,6,29377721,30497289,13524941,4572375,35069664,34668058
29377721_4575801,CM021105.1,6,29377721,30497289,13524941,4575801,35073090,34671484
29377721_4575843,CM021105.1,6,29377721,30497289,13524941,4575843,35073132,34671526
29377721_4575852,CM021105.1,6,29377721,30497289,13524941,4575852,35073141,34671535
29377721_4575936,CM021105.1,6,29377721,30497289,13524941,4575936,35073225,34671619
29377721_4996359,CM021105.1,6,29377721,30497289,13524941,4996359,35493648,35092042
29377721_5022148,CM021105.1,6,29377721,30497289,13524941,5022148,35519437,35117831
29377721_5792308,CM021105.1,6,29377721,30497289,13524941,5792308,36289597,35887991
29377721_5975559,CM021105.1,6,29377721,30497289,13524941,5975559,36472848,36071242
29377721_6005866,CM021105.1,6,29377721,30497289,13524941,6005866,36503155,36101549
29377721_6006691,CM021105.1,6,29377721,30497289,13524941,6006691,36503980,36102374
29377573_6289131,CM021105.1,6,29377573,30497289,7027737,6289131,36786420,36384814
29377721_8882976,CM021105.1,6,29377721,30497289,13524941,8882976,39380265,38978659
29377721_8883018,CM021105.1,6,29377721,30497289,13524941,8883018,39380307,38978701
29377721_8883019,CM021105.1,6,29377721,30497289,13524941,8883019,39380308,38978702
29377721_11445929,CM021105.1,6,29377721,30497289,13524941,11445929,41943218,41541612
28155185_4505,CM021105.1,6,28155185,49206243,9376,4505,49210748,48809142
28155185_4601,CM021105.1,6,28155185,49206243,9376,4601,49210844,48809238
28155185_4662,CM021105.1,6,28155185,49206243,9376,4662,49210905,48809299
28155185_4677,CM021105.1,6,28155185,49206243,9376,4677,49210920,48809314
28155185_4708,CM021105.1,6,28155185,49206243,9376,4708,49210951,48809345
29378870_662719,CM021105.1,6,29378870,49974493,735738,662719,50637212,50235606
29380008_919766,CM021105.1,6,29380008,51077305,1094828,919766,51997071,51595465
29380008_919804,CM021105.1,6,29380008,51077305,1094828,919804,51997109,51595503
29380008_976051,CM021105.1,6,29380008,51077305,1094828,976051,52053356,51651750
29380008_976063,CM021105.1,6,29380008,51077305,1094828,976063,52053368,51651762
29380008_999024,CM021105.1,6,29380008,51077305,1094828,999024,52076329,51674723
29380008_1006012,CM021105.1,6,29380008,51077305,1094828,1006012,52083317,51681711
29380008_1049869,CM021105.1,6,29380008,51077305,1094828,1049869,52127174,51725568
29377560_28310,CM021105.1,6,29377560,52192597,1076280,28310,52220907,51819301
29378009_147660,CM021105.1,6,29378009,52192600,3187661,147660,52340260,51938654
29382273_196733,CM021105.1,6,29382273,52192601,1748173,196733,52389334,51987728
29382273_196803,CM021105.1,6,29382273,52192601,1748173,196803,52389404,51987798
29382273_198554,CM021105.1,6,29382273,52192601,1748173,198554,52391155,51989549
29382273_200523,CM021105.1,6,29382273,52192601,1748173,200523,52393124,51991518
29379708_248464,CM021105.1,6,29379708,52192601,1547078,248464,52441065,52039459
29379708_248504,CM021105.1,6,29379708,52192601,1547078,248504,52441105,52039499
29381558_366184,CM021105.1,6,29381558,52192601,2496275,366184,52558785,52157179
29381558_366252,CM021105.1,6,29381558,52192601,2496275,366252,52558853,52157247
29381558_394168,CM021105.1,6,29381558,52192601,2496275,394168,52586769,52185163
29381558_394210,CM021105.1,6,29381558,52192601,2496275,394210,52586811,52185205
29381558_394322,CM021105.1,6,29381558,52192601,2496275,394322,52586923,52185317
29381558_394337,CM021105.1,6,29381558,52192601,2496275,394337,52586938,52185332
29379708_402867,CM021105.1,6,29379708,52192601,1547078,402867,52595468,52193862
29379708_403045,CM021105.1,6,29379708,52192601,1547078,403045,52595646,52194040
29379708_405775,CM021105.1,6,29379708,52192601,1547078,405775,52598376,52196770
29379708_405900,CM021105.1,6,29379708,52192601,1547078,405900,52598501,52196895
29379708_406332,CM021105.1,6,29379708,52192601,1547078,406332,52598933,52197327
29379708_408985,CM021105.1,6,29379708,52192601,1547078,408985,52601586,52199980
29377022_436639,CM021105.1,6,29377022,52192600,4180452,436639,52629239,52227633
29378299_568471,CM021105.1,6,29378299,52192601,4279824,568471,52761072,52359466
29378299_568604,CM021105.1,6,29378299,52192601,4279824,568604,52761205,52359599
29377181_571397,CM021105.1,6,29377181,52192894,1158908,571397,52764291,52362685
29377181_571414,CM021105.1,6,29377181,52192894,1158908,571414,52764308,52362702
29377181_571444,CM021105.1,6,29377181,52192894,1158908,571444,52764338,52362732
29377181_571470,CM021105.1,6,29377181,52192894,1158908,571470,52764364,52362758
29377181_571558,CM021105.1,6,29377181,52192894,1158908,571558,52764452,52362846
29377181_571560,CM021105.1,6,29377181,52192894,1158908,571560,52764454,52362848
29377181_595538,CM021105.1,6,29377181,52192894,1158908,595538,52788432,52386826
29378009_668943,CM021105.1,6,29378009,52192600,3187661,668943,52861543,52459937
29379708_673470,CM021105.1,6,29379708,52192601,1547078,673470,52866071,52464465
29379708_678313,CM021105.1,6,29379708,52192601,1547078,678313,52870914,52469308
29378009_696646,CM021105.1,6,29378009,52192600,3187661,696646,52889246,52487640
29378009_696660,CM021105.1,6,29378009,52192600,3187661,696660,52889260,52487654
29377181_751910,CM021105.1,6,29377181,52192894,1158908,751910,52944804,52543198
29379708_786697,CM021105.1,6,29379708,52192601,1547078,786697,52979298,52577692
29379708_835003,CM021105.1,6,29379708,52192601,1547078,835003,53027604,52625998
29377181_850752,CM021105.1,6,29377181,52192894,1158908,850752,53043646,52642040
29377560_902832,CM021105.1,6,29377560,52192597,1076280,902832,53095429,52693823
29377181_948385,CM021105.1,6,29377181,52192894,1158908,948385,53141279,52739673
29377560_993834,CM021105.1,6,29377560,52192597,1076280,993834,53186431,52784825
29377560_993851,CM021105.1,6,29377560,52192597,1076280,993851,53186448,52784842
29379708_1025499,CM021105.1,6,29379708,52192601,1547078,1025499,53218100,52816494
29377560_1051844,CM021105.1,6,29377560,52192597,1076280,1051844,53244441,52842835
29378009_1231452,CM021105.1,6,29378009,52192600,3187661,1231452,53424052,53022446
29378420_1282596,CM021105.1,6,29378420,52192598,1418681,1282596,53475194,53073588
29382273_1656154,CM021105.1,6,29382273,52192601,1748173,1656154,53848755,53447149
29378009_1656687,CM021105.1,6,29378009,52192600,3187661,1656687,53849287,53447681
29377022_1761852,CM021105.1,6,29377022,52192600,4180452,1761852,53954452,53552846
29377022_1761925,CM021105.1,6,29377022,52192600,4180452,1761925,53954525,53552919
29381854_2240332,CM021105.1,6,29381854,52192600,2921001,2240332,54432932,54031326
29381854_2240347,CM021105.1,6,29381854,52192600,2921001,2240347,54432947,54031341
29380801_2231691,CM021105.1,6,29380801,52201469,2599906,2231691,54433160,54031554
29380801_2231728,CM021105.1,6,29380801,52201469,2599906,2231728,54433197,54031591
29380801_2425839,CM021105.1,6,29380801,52201469,2599906,2425839,54627308,54225702
29380801_2425862,CM021105.1,6,29380801,52201469,2599906,2425862,54627331,54225725
29380801_2426028,CM021105.1,6,29380801,52201469,2599906,2426028,54627497,54225891
29380801_2497712,CM021105.1,6,29380801,52201469,2599906,2497712,54699181,54297575
29380801_2498199,CM021105.1,6,29380801,52201469,2599906,2498199,54699668,54298062
29377022_2523324,CM021105.1,6,29377022,52192600,4180452,2523324,54715924,54314318
29377677_2625789,CM021105.1,6,29377677,52192600,2971777,2625789,54818389,54416783
29377746_283449,CM021105.1,6,29377746,55157614,528976,283449,55441063,55039457
29377746_291997,CM021105.1,6,29377746,55157614,528976,291997,55449611,55048005
29378436_9315,CM021105.1,6,29378436,57862055,2167047,9315,57871370,57469764
29380700_99964,CM021105.1,6,29380700,57862054,1610374,99964,57962018,57560412
29380047_109787,CM021105.1,6,29380047,57879002,2752271,109787,57988789,57587183
29380047_109880,CM021105.1,6,29380047,57879002,2752271,109880,57988882,57587276
29380010_140856,CM021105.1,6,29380010,57862054,2407393,140856,58002910,57601304
29380010_140876,CM021105.1,6,29380010,57862054,2407393,140876,58002930,57601324
29380010_197738,CM021105.1,6,29380010,57862054,2407393,197738,58059792,57658186
29380047_227808,CM021105.1,6,29380047,57879002,2752271,227808,58106810,57705204
29379971_300561,CM021105.1,6,29379971,57879516,1157699,300561,58180077,57778471
29379971_300610,CM021105.1,6,29379971,57879516,1157699,300610,58180126,57778520
29381944_331396,CM021105.1,6,29381944,57863794,2321361,331396,58195190,57793584
29380010_358787,CM021105.1,6,29380010,57862054,2407393,358787,58220841,57819235
29380010_358855,CM021105.1,6,29380010,57862054,2407393,358855,58220909,57819303
29380010_361727,CM021105.1,6,29380010,57862054,2407393,361727,58223781,57822175
29380010_391138,CM021105.1,6,29380010,57862054,2407393,391138,58253192,57851586
29380010_391250,CM021105.1,6,29380010,57862054,2407393,391250,58253304,57851698
29381102_385714,CM021105.1,6,29381102,57874256,5115105,385714,58259970,57858364
29380047_383648,CM021105.1,6,29380047,57879002,2752271,383648,58262650,57861044
29380047_383701,CM021105.1,6,29380047,57879002,2752271,383701,58262703,57861097
29380047_384201,CM021105.1,6,29380047,57879002,2752271,384201,58263203,57861597
29380047_384202,CM021105.1,6,29380047,57879002,2752271,384202,58263204,57861598
29380047_413744,CM021105.1,6,29380047,57879002,2752271,413744,58292746,57891140
29380047_413747,CM021105.1,6,29380047,57879002,2752271,413747,58292749,57891143
29380047_413803,CM021105.1,6,29380047,57879002,2752271,413803,58292805,57891199
29380047_413804,CM021105.1,6,29380047,57879002,2752271,413804,58292806,57891200
29380047_413851,CM021105.1,6,29380047,57879002,2752271,413851,58292853,57891247
29380047_413860,CM021105.1,6,29380047,57879002,2752271,413860,58292862,57891256
29378685_481790,CM021105.1,6,29378685,57880203,2705814,481790,58361993,57960387
29381944_514949,CM021105.1,6,29381944,57863794,2321361,514949,58378743,57977137
29381944_514993,CM021105.1,6,29381944,57863794,2321361,514993,58378787,57977181
29381944_515145,CM021105.1,6,29381944,57863794,2321361,515145,58378939,57977333
29381944_515159,CM021105.1,6,29381944,57863794,2321361,515159,58378953,57977347
29381944_515223,CM021105.1,6,29381944,57863794,2321361,515223,58379017,57977411
29380440_504643,CM021105.1,6,29380440,57880216,664950,504643,58384859,57983253
29382260_535465,CM021105.1,6,29382260,57880672,782755,535465,58416137,58014531
29382260_571967,CM021105.1,6,29382260,57880672,782755,571967,58452639,58051033
29347841_736848,CM021105.1,6,29347841,57880337,813212,736848,58617185,58215579
29347841_736974,CM021105.1,6,29347841,57880337,813212,736974,58617311,58215705
29381727_875541,CM021105.1,6,29381727,57874104,1778336,875541,58749645,58348039
29381102_956188,CM021105.1,6,29381102,57874256,5115105,956188,58830444,58428838
29381102_956221,CM021105.1,6,29381102,57874256,5115105,956221,58830477,58428871
29381102_956224,CM021105.1,6,29381102,57874256,5115105,956224,58830480,58428874
29381102_956256,CM021105.1,6,29381102,57874256,5115105,956256,58830512,58428906
29381102_956307,CM021105.1,6,29381102,57874256,5115105,956307,58830563,58428957
29381102_957414,CM021105.1,6,29381102,57874256,5115105,957414,58831670,58430064
29381102_957422,CM021105.1,6,29381102,57874256,5115105,957422,58831678,58430072
29381102_957509,CM021105.1,6,29381102,57874256,5115105,957509,58831765,58430159
29381102_960373,CM021105.1,6,29381102,57874256,5115105,960373,58834629,58433023
29381102_960383,CM021105.1,6,29381102,57874256,5115105,960383,58834639,58433033
29381102_960417,CM021105.1,6,29381102,57874256,5115105,960417,58834673,58433067
29381102_1085944,CM021105.1,6,29381102,57874256,5115105,1085944,58960200,58558594
29381102_1086026,CM021105.1,6,29381102,57874256,5115105,1086026,58960282,58558676
29381102_1090240,CM021105.1,6,29381102,57874256,5115105,1090240,58964496,58562890
29381102_1090314,CM021105.1,6,29381102,57874256,5115105,1090314,58964570,58562964
29381102_1090360,CM021105.1,6,29381102,57874256,5115105,1090360,58964616,58563010
29381102_1090365,CM021105.1,6,29381102,57874256,5115105,1090365,58964621,58563015
29381102_1090390,CM021105.1,6,29381102,57874256,5115105,1090390,58964646,58563040
29381102_1090397,CM021105.1,6,29381102,57874256,5115105,1090397,58964653,58563047
29378436_1180754,CM021105.1,6,29378436,57862055,2167047,1180754,59042809,58641203
29378436_1180818,CM021105.1,6,29378436,57862055,2167047,1180818,59042873,58641267
29381102_1200072,CM021105.1,6,29381102,57874256,5115105,1200072,59074328,58672722
29380700_1259284,CM021105.1,6,29380700,57862054,1610374,1259284,59121338,58719732
29380700_1259306,CM021105.1,6,29380700,57862054,1610374,1259306,59121360,58719754
29379184_1271822,CM021105.1,6,29379184,57862049,2847739,1271822,59133871,58732265
29379184_1450315,CM021105.1,6,29379184,57862049,2847739,1450315,59312364,58910758
29379184_1451213,CM021105.1,6,29379184,57862049,2847739,1451213,59313262,58911656
29379184_1451251,CM021105.1,6,29379184,57862049,2847739,1451251,59313300,58911694
29379184_1453108,CM021105.1,6,29379184,57862049,2847739,1453108,59315157,58913551
29379184_1453266,CM021105.1,6,29379184,57862049,2847739,1453266,59315315,58913709
29379184_1453304,CM021105.1,6,29379184,57862049,2847739,1453304,59315353,58913747
29381944_1665193,CM021105.1,6,29381944,57863794,2321361,1665193,59528987,59127381
29381944_1665296,CM021105.1,6,29381944,57863794,2321361,1665296,59529090,59127484
29381944_1665304,CM021105.1,6,29381944,57863794,2321361,1665304,59529098,59127492
29381944_1665578,CM021105.1,6,29381944,57863794,2321361,1665578,59529372,59127766
29381944_1665585,CM021105.1,6,29381944,57863794,2321361,1665585,59529379,59127773
29378436_1728175,CM021105.1,6,29378436,57862055,2167047,1728175,59590230,59188624
29378436_1728234,CM021105.1,6,29378436,57862055,2167047,1728234,59590289,59188683
29378436_1728237,CM021105.1,6,29378436,57862055,2167047,1728237,59590292,59188686
29378436_1728239,CM021105.1,6,29378436,57862055,2167047,1728239,59590294,59188688
29378436_1728291,CM021105.1,6,29378436,57862055,2167047,1728291,59590346,59188740
29378436_1728353,CM021105.1,6,29378436,57862055,2167047,1728353,59590408,59188802
29378436_1728363,CM021105.1,6,29378436,57862055,2167047,1728363,59590418,59188812
29379184_1770666,CM021105.1,6,29379184,57862049,2847739,1770666,59632715,59231109
29379184_1771375,CM021105.1,6,29379184,57862049,2847739,1771375,59633424,59231818
29379184_1894554,CM021105.1,6,29379184,57862049,2847739,1894554,59756603,59354997
29379565_1888065,CM021105.1,6,29379565,57870843,2329544,1888065,59758908,59357302
29379565_1888087,CM021105.1,6,29379565,57870843,2329544,1888087,59758930,59357324
29381944_1905517,CM021105.1,6,29381944,57863794,2321361,1905517,59769311,59367705
29381944_1905522,CM021105.1,6,29381944,57863794,2321361,1905522,59769316,59367710
29379184_1909871,CM021105.1,6,29379184,57862049,2847739,1909871,59771920,59370314
29379184_1955141,CM021105.1,6,29379184,57862049,2847739,1955141,59817190,59415584
29379184_1955158,CM021105.1,6,29379184,57862049,2847739,1955158,59817207,59415601
29379184_2057749,CM021105.1,6,29379184,57862049,2847739,2057749,59919798,59518192
29379184_2057773,CM021105.1,6,29379184,57862049,2847739,2057773,59919822,59518216
29378436_2085818,CM021105.1,6,29378436,57862055,2167047,2085818,59947873,59546267
29378436_2085955,CM021105.1,6,29378436,57862055,2167047,2085955,59948010,59546404
29378436_2085995,CM021105.1,6,29378436,57862055,2167047,2085995,59948050,59546444
29378436_2086047,CM021105.1,6,29378436,57862055,2167047,2086047,59948102,59546496
29378685_2081496,CM021105.1,6,29378685,57880203,2705814,2081496,59961699,59560093
29379565_2328567,CM021105.1,6,29379565,57870843,2329544,2328567,60199410,59797804
29381102_2446296,CM021105.1,6,29381102,57874256,5115105,2446296,60320552,59918946
29381102_2446409,CM021105.1,6,29381102,57874256,5115105,2446409,60320665,59919059
29381102_2446410,CM021105.1,6,29381102,57874256,5115105,2446410,60320666,59919060
29381102_2517053,CM021105.1,6,29381102,57874256,5115105,2517053,60391309,59989703
29381102_2517112,CM021105.1,6,29381102,57874256,5115105,2517112,60391368,59989762
29381102_2517263,CM021105.1,6,29381102,57874256,5115105,2517263,60391519,59989913
29381102_2517307,CM021105.1,6,29381102,57874256,5115105,2517307,60391563,59989957
29381102_2517330,CM021105.1,6,29381102,57874256,5115105,2517330,60391586,59989980
29380047_2595546,CM021105.1,6,29380047,57879002,2752271,2595546,60474548,60072942
29378073_2605656,CM021105.1,6,29378073,57879476,3184962,2605656,60485132,60083526
29381102_2924379,CM021105.1,6,29381102,57874256,5115105,2924379,60798635,60397029
29381102_2924410,CM021105.1,6,29381102,57874256,5115105,2924410,60798666,60397060
29378938_163858,CM021105.1,6,29378938,60776923,1401692,163858,60940781,60539175
29378938_163863,CM021105.1,6,29378938,60776923,1401692,163863,60940786,60539180
29378938_163867,CM021105.1,6,29378938,60776923,1401692,163867,60940790,60539184
29378938_163868,CM021105.1,6,29378938,60776923,1401692,163868,60940791,60539185
29378938_163914,CM021105.1,6,29378938,60776923,1401692,163914,60940837,60539231
29378938_163915,CM021105.1,6,29378938,60776923,1401692,163915,60940838,60539232
29378938_163943,CM021105.1,6,29378938,60776923,1401692,163943,60940866,60539260
29378938_163956,CM021105.1,6,29378938,60776923,1401692,163956,60940879,60539273
29378938_163979,CM021105.1,6,29378938,60776923,1401692,163979,60940902,60539296
29379098_209429,CM021105.1,6,29379098,60776923,599170,209429,60986352,60584746
29377708_81565,CM021105.1,6,29377708,61568567,2510402,81565,61650132,61248526
29377708_81706,CM021105.1,6,29377708,61568567,2510402,81706,61650273,61248667
29377708_91535,CM021105.1,6,29377708,61568567,2510402,91535,61660102,61258496
29382399_102466,CM021105.1,6,29382399,61562946,915269,102466,61665412,61263806
29382399_102483,CM021105.1,6,29382399,61562946,915269,102483,61665429,61263823
29382399_102486,CM021105.1,6,29382399,61562946,915269,102486,61665432,61263826
29382399_102500,CM021105.1,6,29382399,61562946,915269,102500,61665446,61263840
29382399_102503,CM021105.1,6,29382399,61562946,915269,102503,61665449,61263843
29382399_102599,CM021105.1,6,29382399,61562946,915269,102599,61665545,61263939
29382399_102606,CM021105.1,6,29382399,61562946,915269,102606,61665552,61263946
29381418_192919,CM021105.1,6,29381418,61562945,708303,192919,61755864,61354258
29381418_192965,CM021105.1,6,29381418,61562945,708303,192965,61755910,61354304
29381418_193078,CM021105.1,6,29381418,61562945,708303,193078,61756023,61354417
29381418_193094,CM021105.1,6,29381418,61562945,708303,193094,61756039,61354433
29381418_193095,CM021105.1,6,29381418,61562945,708303,193095,61756040,61354434
29381418_219197,CM021105.1,6,29381418,61562945,708303,219197,61782142,61380536
29378769_266116,CM021105.1,6,29378769,61562945,3186620,266116,61829061,61427455
29381102_4045626,CM021105.1,6,29381102,57874256,5115105,4045626,61919882,61518276
29381102_4045641,CM021105.1,6,29381102,57874256,5115105,4045641,61919897,61518291
29378938_1156817,CM021105.1,6,29378938,60776923,1401692,1156817,61933740,61532134
29378938_1156907,CM021105.1,6,29378938,60776923,1401692,1156907,61933830,61532224
29378938_1162788,CM021105.1,6,29378938,60776923,1401692,1162788,61939711,61538105
29381418_541709,CM021105.1,6,29381418,61562945,708303,541709,62104654,61703048
29377821_796406,CM021105.1,6,29377821,61562945,3968772,796406,62359351,61957745
29377821_796431,CM021105.1,6,29377821,61562945,3968772,796431,62359376,61957770
29380658_920005,CM021105.1,6,29380658,61562945,1364696,920005,62482950,62081344
29380658_920027,CM021105.1,6,29380658,61562945,1364696,920027,62482972,62081366
29380658_920124,CM021105.1,6,29380658,61562945,1364696,920124,62483069,62081463
29380658_920132,CM021105.1,6,29380658,61562945,1364696,920132,62483077,62081471
29380658_920146,CM021105.1,6,29380658,61562945,1364696,920146,62483091,62081485
29378226_957616,CM021105.1,6,29378226,61562942,5986841,957616,62520558,62118952
29378226_958234,CM021105.1,6,29378226,61562942,5986841,958234,62521176,62119570
29378226_978916,CM021105.1,6,29378226,61562942,5986841,978916,62541858,62140252
29382139_1273981,CM021105.1,6,29382139,61562947,1644629,1273981,62836928,62435322
29378226_1359378,CM021105.1,6,29378226,61562942,5986841,1359378,62922320,62520714
29378226_1359449,CM021105.1,6,29378226,61562942,5986841,1359449,62922391,62520785
29378226_1391901,CM021105.1,6,29378226,61562942,5986841,1391901,62954843,62553237
29378226_1403044,CM021105.1,6,29378226,61562942,5986841,1403044,62965986,62564380
29377708_1471245,CM021105.1,6,29377708,61568567,2510402,1471245,63039812,62638206
29377708_1471654,CM021105.1,6,29377708,61568567,2510402,1471654,63040221,62638615
29377708_1471659,CM021105.1,6,29377708,61568567,2510402,1471659,63040226,62638620
29378226_1479211,CM021105.1,6,29378226,61562942,5986841,1479211,63042153,62640547
29378226_1479216,CM021105.1,6,29378226,61562942,5986841,1479216,63042158,62640552
29378226_1479254,CM021105.1,6,29378226,61562942,5986841,1479254,63042196,62640590
29378226_1479304,CM021105.1,6,29378226,61562942,5986841,1479304,63042246,62640640
29380742_1635809,CM021105.1,6,29380742,61565505,3343503,1635809,63201314,62799708
29380742_1635819,CM021105.1,6,29380742,61565505,3343503,1635819,63201324,62799718
29377821_1853640,CM021105.1,6,29377821,61562945,3968772,1853640,63416585,63014979
29380742_1857832,CM021105.1,6,29380742,61565505,3343503,1857832,63423337,63021731
29381599_2121479,CM021105.1,6,29381599,61562939,2555860,2121479,63684418,63282812
29377708_2155108,CM021105.1,6,29377708,61568567,2510402,2155108,63723675,63322069
29377708_2157886,CM021105.1,6,29377708,61568567,2510402,2157886,63726453,63324847
29377708_2157921,CM021105.1,6,29377708,61568567,2510402,2157921,63726488,63324882
29380742_2756653,CM021105.1,6,29380742,61565505,3343503,2756653,64322158,63920552
29380742_2756688,CM021105.1,6,29380742,61565505,3343503,2756688,64322193,63920587
29377821_2798182,CM021105.1,6,29377821,61562945,3968772,2798182,64361127,63959521
29377821_2798226,CM021105.1,6,29377821,61562945,3968772,2798226,64361171,63959565
29377821_2798228,CM021105.1,6,29377821,61562945,3968772,2798228,64361173,63959567
29377821_2798240,CM021105.1,6,29377821,61562945,3968772,2798240,64361185,63959579
29377821_2798920,CM021105.1,6,29377821,61562945,3968772,2798920,64361865,63960259
29377821_2798929,CM021105.1,6,29377821,61562945,3968772,2798929,64361874,63960268
29377821_2798934,CM021105.1,6,29377821,61562945,3968772,2798934,64361879,63960273
29377821_2798966,CM021105.1,6,29377821,61562945,3968772,2798966,64361911,63960305
29377821_2798977,CM021105.1,6,29377821,61562945,3968772,2798977,64361922,63960316
29377821_2799027,CM021105.1,6,29377821,61562945,3968772,2799027,64361972,63960366
29377821_2799047,CM021105.1,6,29377821,61562945,3968772,2799047,64361992,63960386
29378226_4494638,CM021105.1,6,29378226,61562942,5986841,4494638,66057580,65655974
29378226_4497324,CM021105.1,6,29378226,61562942,5986841,4497324,66060266,65658660
29378226_4497358,CM021105.1,6,29378226,61562942,5986841,4497358,66060300,65658694
29378226_4501826,CM021105.1,6,29378226,61562942,5986841,4501826,66064768,65663162
29378226_4961228,CM021105.1,6,29378226,61562942,5986841,4961228,66524170,66122564
29378226_5009185,CM021105.1,6,29378226,61562942,5986841,5009185,66572127,66170521
29378226_5012985,CM021105.1,6,29378226,61562942,5986841,5012985,66575927,66174321
29378226_5014785,CM021105.1,6,29378226,61562942,5986841,5014785,66577727,66176121
29378226_5014801,CM021105.1,6,29378226,61562942,5986841,5014801,66577743,66176137
29378226_5014834,CM021105.1,6,29378226,61562942,5986841,5014834,66577776,66176170
29378754_105513,CM021105.1,6,29378754,78139299,516281,105513,78244812,77843206
29378754_106065,CM021105.1,6,29378754,78139299,516281,106065,78245364,77843758
29346740_189355,CM021105.1,6,29346740,99963846,448769,189355,100153201,99751595
29346740_189363,CM021105.1,6,29346740,99963846,448769,189363,100153209,99751603
29366303_71781,CM021105.1,6,29366303,127138649,211152,71781,127210430,126808824
29366303_88429,CM021105.1,6,29366303,127138649,211152,88429,127227078,126825472
29365582_19761,CM021105.1,6,29365582,140185098,21311,19761,140204859,139803253
29365582_19819,CM021105.1,6,29365582,140185098,21311,19819,140204917,139803311
29380448_1403990,CM021105.1,6,29380448,160387244,1718604,1403990,161791234,161389628
29380448_1403997,CM021105.1,6,29380448,160387244,1718604,1403997,161791241,161389635
29237346_4293,CM021105.1,6,29237346,179164342,6598,4293,179168635,178767029
29380730_47338,CM021105.1,6,29380730,186094412,2905601,47338,186141750,185740144
29380730_47405,CM021105.1,6,29380730,186094412,2905601,47405,186141817,185740211
29380730_222657,CM021105.1,6,29380730,186094412,2905601,222657,186317069,185915463
29380730_222871,CM021105.1,6,29380730,186094412,2905601,222871,186317283,185915677
29380111_302644,CM021105.1,6,29380111,186095082,2249197,302644,186397726,185996120
29380111_302776,CM021105.1,6,29380111,186095082,2249197,302776,186397858,185996252
29380880_370025,CM021105.1,6,29380880,186097555,1944544,370025,186467580,186065974
29380880_370038,CM021105.1,6,29380880,186097555,1944544,370038,186467593,186065987
29380880_370059,CM021105.1,6,29380880,186097555,1944544,370059,186467614,186066008
29380880_370060,CM021105.1,6,29380880,186097555,1944544,370060,186467615,186066009
29380880_370101,CM021105.1,6,29380880,186097555,1944544,370101,186467656,186066050
29377431_382762,CM021105.1,6,29377431,186096295,710212,382762,186479057,186077451
29377431_382794,CM021105.1,6,29377431,186096295,710212,382794,186479089,186077483
29380880_408910,CM021105.1,6,29380880,186097555,1944544,408910,186506465,186104859
29380880_409409,CM021105.1,6,29380880,186097555,1944544,409409,186506964,186105358
29380111_439803,CM021105.1,6,29380111,186095082,2249197,439803,186534885,186133279
29380880_522261,CM021105.1,6,29380880,186097555,1944544,522261,186619816,186218210
29381802_606240,CM021105.1,6,29381802,186095701,720816,606240,186701941,186300335
29381802_608530,CM021105.1,6,29381802,186095701,720816,608530,186704231,186302625
29382012_698331,CM021105.1,6,29382012,186073454,4271835,698331,186771785,186370179
29382012_698348,CM021105.1,6,29382012,186073454,4271835,698348,186771802,186370196
29377558_808622,CM021105.1,6,29377558,186073454,2755137,808622,186882076,186480470
29377558_808626,CM021105.1,6,29377558,186073454,2755137,808626,186882080,186480474
29380880_897739,CM021105.1,6,29380880,186097555,1944544,897739,186995294,186593688
29380880_897778,CM021105.1,6,29380880,186097555,1944544,897778,186995333,186593727
29380880_943472,CM021105.1,6,29380880,186097555,1944544,943472,187041027,186639421
29380776_1097528,CM021105.1,6,29380776,186095227,2748584,1097528,187192755,186791149
29380776_1097700,CM021105.1,6,29380776,186095227,2748584,1097700,187192927,186791321
29380776_1097701,CM021105.1,6,29380776,186095227,2748584,1097701,187192928,186791322
29380229_1522350,CM021105.1,6,29380229,186095539,2652320,1522350,187617889,187216283
29378346_1680379,CM021105.1,6,29378346,186073451,2738417,1680379,187753830,187352224
29377370_1711433,CM021105.1,6,29377370,186095870,3461150,1711433,187807303,187405697
29377370_1786893,CM021105.1,6,29377370,186095870,3461150,1786893,187882763,187481157
29380880_1797435,CM021105.1,6,29380880,186097555,1944544,1797435,187894990,187493384
29380880_1833132,CM021105.1,6,29380880,186097555,1944544,1833132,187930687,187529081
29380229_2150040,CM021105.1,6,29380229,186095539,2652320,2150040,188245579,187843973
29380229_2150055,CM021105.1,6,29380229,186095539,2652320,2150055,188245594,187843988
29380229_2150065,CM021105.1,6,29380229,186095539,2652320,2150065,188245604,187843998
29377558_2259099,CM021105.1,6,29377558,186073454,2755137,2259099,188332553,187930947
29377558_2259322,CM021105.1,6,29377558,186073454,2755137,2259322,188332776,187931170
29377558_2259347,CM021105.1,6,29377558,186073454,2755137,2259347,188332801,187931195
29377558_2271597,CM021105.1,6,29377558,186073454,2755137,2271597,188345051,187943445
29377558_2271621,CM021105.1,6,29377558,186073454,2755137,2271621,188345075,187943469
29377558_2271633,CM021105.1,6,29377558,186073454,2755137,2271633,188345087,187943481
29377558_2271684,CM021105.1,6,29377558,186073454,2755137,2271684,188345138,187943532
29377558_2274927,CM021105.1,6,29377558,186073454,2755137,2274927,188348381,187946775
29377558_2274996,CM021105.1,6,29377558,186073454,2755137,2274996,188348450,187946844
29377558_2283826,CM021105.1,6,29377558,186073454,2755137,2283826,188357280,187955674
29377558_2400575,CM021105.1,6,29377558,186073454,2755137,2400575,188474029,188072423
29377558_2400676,CM021105.1,6,29377558,186073454,2755137,2400676,188474130,188072524
29377558_2400695,CM021105.1,6,29377558,186073454,2755137,2400695,188474149,188072543
29380730_2629292,CM021105.1,6,29380730,186094412,2905601,2629292,188723704,188322098
29380730_2629302,CM021105.1,6,29380730,186094412,2905601,2629302,188723714,188322108
29377370_2995297,CM021105.1,6,29377370,186095870,3461150,2995297,189091167,188689561
29377370_2995302,CM021105.1,6,29377370,186095870,3461150,2995302,189091172,188689566
29377050_3002930,CM021105.1,6,29377050,186095549,3100522,3002930,189098479,188696873
29377050_3002978,CM021105.1,6,29377050,186095549,3100522,3002978,189098527,188696921
29377050_3003041,CM021105.1,6,29377050,186095549,3100522,3003041,189098590,188696984
29377050_3003101,CM021105.1,6,29377050,186095549,3100522,3003101,189098650,188697044
29377050_3003116,CM021105.1,6,29377050,186095549,3100522,3003116,189098665,188697059
29377370_3045774,CM021105.1,6,29377370,186095870,3461150,3045774,189141644,188740038
29377370_3045775,CM021105.1,6,29377370,186095870,3461150,3045775,189141645,188740039
29377370_3045879,CM021105.1,6,29377370,186095870,3461150,3045879,189141749,188740143
29382012_3431169,CM021105.1,6,29382012,186073454,4271835,3431169,189504623,189103017
29382012_3618364,CM021105.1,6,29382012,186073454,4271835,3618364,189691818,189290212
29382012_3619235,CM021105.1,6,29382012,186073454,4271835,3619235,189692689,189291083
29382012_3622310,CM021105.1,6,29382012,186073454,4271835,3622310,189695764,189294158
29379437_13917,CM021105.1,6,29379437,196035093,777084,13917,196049010,195647404
29342906_156364,CM021105.1,6,29342906,196303856,194152,156364,196460220,196058614
29342906_156369,CM021105.1,6,29342906,196303856,194152,156369,196460225,196058619
29342906_156397,CM021105.1,6,29342906,196303856,194152,156397,196460253,196058647
29342906_156445,CM021105.1,6,29342906,196303856,194152,156445,196460301,196058695
29379437_755314,CM021105.1,6,29379437,196035093,777084,755314,196790407,196388801
29336259_27607,CM021105.1,6,29336259,202210534,67993,27607,202238141,201836535
29378083_20154,CM021105.1,6,29378083,206023114,455405,20154,206043268,205641662
29378083_37324,CM021105.1,6,29378083,206023114,455405,37324,206060438,205658832
29378083_57183,CM021105.1,6,29378083,206023114,455405,57183,206080297,205678691
29381359_65941,CM021105.1,6,29381359,206022475,246173,65941,206088416,205686810
29381359_65942,CM021105.1,6,29381359,206022475,246173,65942,206088417,205686811
29381359_65953,CM021105.1,6,29381359,206022475,246173,65953,206088428,205686822
29381359_65987,CM021105.1,6,29381359,206022475,246173,65987,206088462,205686856
29381359_66001,CM021105.1,6,29381359,206022475,246173,66001,206088476,205686870
29381359_66005,CM021105.1,6,29381359,206022475,246173,66005,206088480,205686874
29381359_66013,CM021105.1,6,29381359,206022475,246173,66013,206088488,205686882
29381359_66016,CM021105.1,6,29381359,206022475,246173,66016,206088491,205686885
29381359_66030,CM021105.1,6,29381359,206022475,246173,66030,206088505,205686899
29381359_66038,CM021105.1,6,29381359,206022475,246173,66038,206088513,205686907
29377494_80043,CM021105.1,6,29377494,206022477,2325303,80043,206102520,205700914
29377494_80080,CM021105.1,6,29377494,206022477,2325303,80080,206102557,205700951
29377494_80613,CM021105.1,6,29377494,206022477,2325303,80613,206103090,205701484
29382017_104650,CM021105.1,6,29382017,206024230,669852,104650,206128880,205727274
29382017_104706,CM021105.1,6,29382017,206024230,669852,104706,206128936,205727330
29382017_104765,CM021105.1,6,29382017,206024230,669852,104765,206128995,205727389
29377494_150966,CM021105.1,6,29377494,206022477,2325303,150966,206173443,205771837
29381907_153693,CM021105.1,6,29381907,206023230,326352,153693,206176923,205775317
29381907_153958,CM021105.1,6,29381907,206023230,326352,153958,206177188,205775582
29380720_183886,CM021105.1,6,29380720,206022477,773009,183886,206206363,205804757
29381907_219709,CM021105.1,6,29381907,206023230,326352,219709,206242939,205841333
29381907_219774,CM021105.1,6,29381907,206023230,326352,219774,206243004,205841398
29381907_219776,CM021105.1,6,29381907,206023230,326352,219776,206243006,205841400
29380096_258594,CM021105.1,6,29380096,206022477,471288,258594,206281071,205879465
29380096_258627,CM021105.1,6,29380096,206022477,471288,258627,206281104,205879498
29381907_292544,CM021105.1,6,29381907,206023230,326352,292544,206315774,205914168
29381907_292592,CM021105.1,6,29381907,206023230,326352,292592,206315822,205914216
29378517_434482,CM021105.1,6,29378517,206025898,781877,434482,206460380,206058774
29380720_457807,CM021105.1,6,29380720,206022477,773009,457807,206480284,206078678
29380720_457856,CM021105.1,6,29380720,206022477,773009,457856,206480333,206078727
29380720_457909,CM021105.1,6,29380720,206022477,773009,457909,206480386,206078780
29376837_473513,CM021105.1,6,29376837,206022475,483041,473513,206495988,206094382
29377494_535830,CM021105.1,6,29377494,206022477,2325303,535830,206558307,206156701
29377494_535876,CM021105.1,6,29377494,206022477,2325303,535876,206558353,206156747
29378517_626266,CM021105.1,6,29378517,206025898,781877,626266,206652164,206250558
29378517_626304,CM021105.1,6,29378517,206025898,781877,626304,206652202,206250596
29378517_626310,CM021105.1,6,29378517,206025898,781877,626310,206652208,206250602
29378517_626319,CM021105.1,6,29378517,206025898,781877,626319,206652217,206250611
29378517_626324,CM021105.1,6,29378517,206025898,781877,626324,206652222,206250616
29378517_699646,CM021105.1,6,29378517,206025898,781877,699646,206725544,206323938
29377921_718896,CM021105.1,6,29377921,206023680,943608,718896,206742576,206340970
29377921_718955,CM021105.1,6,29377921,206023680,943608,718955,206742635,206341029
29377921_718963,CM021105.1,6,29377921,206023680,943608,718963,206742643,206341037
29378517_724046,CM021105.1,6,29378517,206025898,781877,724046,206749944,206348338
29377921_873126,CM021105.1,6,29377921,206023680,943608,873126,206896806,206495200
29377921_873141,CM021105.1,6,29377921,206023680,943608,873141,206896821,206495215
29377921_873177,CM021105.1,6,29377921,206023680,943608,873177,206896857,206495251
29377921_873209,CM021105.1,6,29377921,206023680,943608,873209,206896889,206495283
29377921_873214,CM021105.1,6,29377921,206023680,943608,873214,206896894,206495288
29381390_878867,CM021105.1,6,29381390,206022477,2920167,878867,206901344,206499738
29377494_906802,CM021105.1,6,29377494,206022477,2325303,906802,206929279,206527673
29377494_906811,CM021105.1,6,29377494,206022477,2325303,906811,206929288,206527682
29377494_1000127,CM021105.1,6,29377494,206022477,2325303,1000127,207022604,206620998
29382235_1203741,CM021105.1,6,29382235,206023301,1740774,1203741,207227042,206825436
29377494_1361536,CM021105.1,6,29377494,206022477,2325303,1361536,207384013,206982407
29377494_1361658,CM021105.1,6,29377494,206022477,2325303,1361658,207384135,206982529
29377240_1410532,CM021105.1,6,29377240,206022477,2083880,1410532,207433009,207031403
29377240_1410645,CM021105.1,6,29377240,206022477,2083880,1410645,207433122,207031516
29377240_1410780,CM021105.1,6,29377240,206022477,2083880,1410780,207433257,207031651
29377240_1410832,CM021105.1,6,29377240,206022477,2083880,1410832,207433309,207031703
29377240_1410837,CM021105.1,6,29377240,206022477,2083880,1410837,207433314,207031708
29377240_1751797,CM021105.1,6,29377240,206022477,2083880,1751797,207774274,207372668
29377240_1751816,CM021105.1,6,29377240,206022477,2083880,1751816,207774293,207372687
29377240_1751837,CM021105.1,6,29377240,206022477,2083880,1751837,207774314,207372708
29377240_1751878,CM021105.1,6,29377240,206022477,2083880,1751878,207774355,207372749
29377240_1751879,CM021105.1,6,29377240,206022477,2083880,1751879,207774356,207372750
29382419_941563,CM021105.1,6,29382419,212363177,1014507,941563,213304740,212903134
29382419_941651,CM021105.1,6,29382419,212363177,1014507,941651,213304828,212903222
29382419_941705,CM021105.1,6,29382419,212363177,1014507,941705,213304882,212903276
29382419_951346,CM021105.1,6,29382419,212363177,1014507,951346,213314523,212912917
29382419_951379,CM021105.1,6,29382419,212363177,1014507,951379,213314556,212912950
29382419_951484,CM021105.1,6,29382419,212363177,1014507,951484,213314661,212913055
29382419_1001183,CM021105.1,6,29382419,212363177,1014507,1001183,213364360,212962754
29382419_1001225,CM021105.1,6,29382419,212363177,1014507,1001225,213364402,212962796
29382419_1001239,CM021105.1,6,29382419,212363177,1014507,1001239,213364416,212962810
29382419_1001539,CM021105.1,6,29382419,212363177,1014507,1001539,213364716,212963110
29343234_57939,CM021105.1,6,29343234,214163094,103715,57939,214221033,213819427
29343234_57985,CM021105.1,6,29343234,214163094,103715,57985,214221079,213819473
29343234_57993,CM021105.1,6,29343234,214163094,103715,57993,214221087,213819481
29343234_57999,CM021105.1,6,29343234,214163094,103715,57999,214221093,213819487
29369871_9179,CM021105.1,6,29369871,224485510,54513,9179,224494689,224093083
29369871_9302,CM021105.1,6,29369871,224485510,54513,9302,224494812,224093206
29369871_9309,CM021105.1,6,29369871,224485510,54513,9309,224494819,224093213
29369871_9353,CM021105.1,6,29369871,224485510,54513,9353,224494863,224093257
29369871_9377,CM021105.1,6,29369871,224485510,54513,9377,224494887,224093281
29381101_11270,CM021105.1,6,29381101,224485510,2994218,11270,224496780,224095174
29381101_11285,CM021105.1,6,29381101,224485510,2994218,11285,224496795,224095189
29381129_16423,CM021105.1,6,29381129,224485512,5396747,16423,224501935,224100329
29381129_16446,CM021105.1,6,29381129,224485512,5396747,16446,224501958,224100352
29381129_17993,CM021105.1,6,29381129,224485512,5396747,17993,224503505,224101899
29381129_18322,CM021105.1,6,29381129,224485512,5396747,18322,224503834,224102228
29381129_18331,CM021105.1,6,29381129,224485512,5396747,18331,224503843,224102237
29381129_18372,CM021105.1,6,29381129,224485512,5396747,18372,224503884,224102278
29381129_18428,CM021105.1,6,29381129,224485512,5396747,18428,224503940,224102334
29382124_23045,CM021105.1,6,29382124,224485510,1042354,23045,224508555,224106949
29382124_23105,CM021105.1,6,29382124,224485510,1042354,23105,224508615,224107009
29382124_24433,CM021105.1,6,29382124,224485510,1042354,24433,224509943,224108337
29378588_32769,CM021105.1,6,29378588,224485529,1010055,32769,224518298,224116692
29378588_32791,CM021105.1,6,29378588,224485529,1010055,32791,224518320,224116714
29378588_32808,CM021105.1,6,29378588,224485529,1010055,32808,224518337,224116731
29378588_32935,CM021105.1,6,29378588,224485529,1010055,32935,224518464,224116858
29378667_37614,CM021105.1,6,29378667,224485500,2355388,37614,224523114,224121508
29378667_37967,CM021105.1,6,29378667,224485500,2355388,37967,224523467,224121861
29381961_47767,CM021105.1,6,29381961,224488391,94948,47767,224536158,224134552
29381961_47918,CM021105.1,6,29381961,224488391,94948,47918,224536309,224134703
29381961_47924,CM021105.1,6,29381961,224488391,94948,47924,224536315,224134709
29381961_47925,CM021105.1,6,29381961,224488391,94948,47925,224536316,224134710
29381961_47950,CM021105.1,6,29381961,224488391,94948,47950,224536341,224134735
29381961_47965,CM021105.1,6,29381961,224488391,94948,47965,224536356,224134750
29377589_67261,CM021105.1,6,29377589,224485512,2673936,67261,224552773,224151167
29377589_67263,CM021105.1,6,29377589,224485512,2673936,67263,224552775,224151169
29377589_67264,CM021105.1,6,29377589,224485512,2673936,67264,224552776,224151170
29377589_67266,CM021105.1,6,29377589,224485512,2673936,67266,224552778,224151172
29380587_88509,CM021105.1,6,29380587,224486523,691005,88509,224575032,224173426
29380587_88559,CM021105.1,6,29380587,224486523,691005,88559,224575082,224173476
29380587_88612,CM021105.1,6,29380587,224486523,691005,88612,224575135,224173529
29380587_88616,CM021105.1,6,29380587,224486523,691005,88616,224575139,224173533
29381129_132016,CM021105.1,6,29381129,224485512,5396747,132016,224617528,224215922
29381129_132592,CM021105.1,6,29381129,224485512,5396747,132592,224618104,224216498
29381129_132628,CM021105.1,6,29381129,224485512,5396747,132628,224618140,224216534
29378832_193833,CM021105.1,6,29378832,224485508,3896181,193833,224679341,224277735
29380587_200307,CM021105.1,6,29380587,224486523,691005,200307,224686830,224285224
29380587_200315,CM021105.1,6,29380587,224486523,691005,200315,224686838,224285232
29380587_200388,CM021105.1,6,29380587,224486523,691005,200388,224686911,224285305
29381916_259761,CM021105.1,6,29381916,224485509,2374224,259761,224745270,224343664
29380433_288824,CM021105.1,6,29380433,224485510,2600919,288824,224774334,224372728
29381277_292951,CM021105.1,6,29381277,224485512,665325,292951,224778463,224376857
29379181_354908,CM021105.1,6,29379181,224485512,550040,354908,224840420,224438814
29380433_363491,CM021105.1,6,29380433,224485510,2600919,363491,224849001,224447395
29380433_364345,CM021105.1,6,29380433,224485510,2600919,364345,224849855,224448249
29380433_364392,CM021105.1,6,29380433,224485510,2600919,364392,224849902,224448296
29380433_364434,CM021105.1,6,29380433,224485510,2600919,364434,224849944,224448338
29381129_386729,CM021105.1,6,29381129,224485512,5396747,386729,224872241,224470635
29379068_434836,CM021105.1,6,29379068,224485512,1355417,434836,224920348,224518742
29378667_445454,CM021105.1,6,29378667,224485500,2355388,445454,224930954,224529348
29379068_461497,CM021105.1,6,29379068,224485512,1355417,461497,224947009,224545403
29379068_461860,CM021105.1,6,29379068,224485512,1355417,461860,224947372,224545766
29379068_461889,CM021105.1,6,29379068,224485512,1355417,461889,224947401,224545795
29379126_479209,CM021105.1,6,29379126,224485509,3439228,479209,224964718,224563112
29379126_479227,CM021105.1,6,29379126,224485509,3439228,479227,224964736,224563130
29379126_479278,CM021105.1,6,29379126,224485509,3439228,479278,224964787,224563181
29379126_479328,CM021105.1,6,29379126,224485509,3439228,479328,224964837,224563231
29376423_499776,CM021105.1,6,29376423,224485512,1240732,499776,224985288,224583682
29378826_503737,CM021105.1,6,29378826,224486225,3046896,503737,224989962,224588356
29380745_584382,CM021105.1,6,29380745,224485510,1346863,584382,225069892,224668286
29380745_584415,CM021105.1,6,29380745,224485510,1346863,584415,225069925,224668319
29380745_584703,CM021105.1,6,29380745,224485510,1346863,584703,225070213,224668607
29380745_584765,CM021105.1,6,29380745,224485510,1346863,584765,225070275,224668669
29379040_613596,CM021105.1,6,29379040,224485510,2979156,613596,225099106,224697500
29380568_622287,CM021105.1,6,29380568,224485510,2617210,622287,225107797,224706191
29380573_627672,CM021105.1,6,29380573,224486494,1357011,627672,225114166,224712560
29381129_629133,CM021105.1,6,29381129,224485512,5396747,629133,225114645,224713039
29381129_683083,CM021105.1,6,29381129,224485512,5396747,683083,225168595,224766989
29379040_686143,CM021105.1,6,29379040,224485510,2979156,686143,225171653,224770047
29379040_686145,CM021105.1,6,29379040,224485510,2979156,686145,225171655,224770049
29379040_686202,CM021105.1,6,29379040,224485510,2979156,686202,225171712,224770106
29379040_686207,CM021105.1,6,29379040,224485510,2979156,686207,225171717,224770111
29378832_690969,CM021105.1,6,29378832,224485508,3896181,690969,225176477,224774871
29378832_691173,CM021105.1,6,29378832,224485508,3896181,691173,225176681,224775075
29380151_693830,CM021105.1,6,29380151,224485512,1550964,693830,225179342,224777736
29380151_693843,CM021105.1,6,29380151,224485512,1550964,693843,225179355,224777749
29380151_693911,CM021105.1,6,29380151,224485512,1550964,693911,225179423,224777817
29382149_694574,CM021105.1,6,29382149,224485510,727241,694574,225180084,224778478
29382149_694631,CM021105.1,6,29382149,224485510,727241,694631,225180141,224778535
29382149_694640,CM021105.1,6,29382149,224485510,727241,694640,225180150,224778544
29382149_695030,CM021105.1,6,29382149,224485510,727241,695030,225180540,224778934
29382149_695069,CM021105.1,6,29382149,224485510,727241,695069,225180579,224778973
29378826_707863,CM021105.1,6,29378826,224486225,3046896,707863,225194088,224792482
29378826_707901,CM021105.1,6,29378826,224486225,3046896,707901,225194126,224792520
29378826_707974,CM021105.1,6,29378826,224486225,3046896,707974,225194199,224792593
29378826_708076,CM021105.1,6,29378826,224486225,3046896,708076,225194301,224792695
29378826_708108,CM021105.1,6,29378826,224486225,3046896,708108,225194333,224792727
29378826_708126,CM021105.1,6,29378826,224486225,3046896,708126,225194351,224792745
29378826_708142,CM021105.1,6,29378826,224486225,3046896,708142,225194367,224792761
29378509_747735,CM021105.1,6,29378509,224485920,5050152,747735,225233655,224832049
29378826_815860,CM021105.1,6,29378826,224486225,3046896,815860,225302085,224900479
29378826_815878,CM021105.1,6,29378826,224486225,3046896,815878,225302103,224900497
29378826_815902,CM021105.1,6,29378826,224486225,3046896,815902,225302127,224900521
29379723_847991,CM021105.1,6,29379723,224485512,1047036,847991,225333503,224931897
29380433_873035,CM021105.1,6,29380433,224485510,2600919,873035,225358545,224956939
29381101_878591,CM021105.1,6,29381101,224485510,2994218,878591,225364101,224962495
29380568_880035,CM021105.1,6,29380568,224485510,2617210,880035,225365545,224963939
29380568_880080,CM021105.1,6,29380568,224485510,2617210,880080,225365590,224963984
29380568_895631,CM021105.1,6,29380568,224485510,2617210,895631,225381141,224979535
29380745_896830,CM021105.1,6,29380745,224485510,1346863,896830,225382340,224980734
29380745_896840,CM021105.1,6,29380745,224485510,1346863,896840,225382350,224980744
29380745_896913,CM021105.1,6,29380745,224485510,1346863,896913,225382423,224980817
29380568_911534,CM021105.1,6,29380568,224485510,2617210,911534,225397044,224995438
29380568_911740,CM021105.1,6,29380568,224485510,2617210,911740,225397250,224995644
29378667_940961,CM021105.1,6,29378667,224485500,2355388,940961,225426461,225024855
29378667_941007,CM021105.1,6,29378667,224485500,2355388,941007,225426507,225024901
29379723_946230,CM021105.1,6,29379723,224485512,1047036,946230,225431742,225030136
29379723_946295,CM021105.1,6,29379723,224485512,1047036,946295,225431807,225030201
29379723_960868,CM021105.1,6,29379723,224485512,1047036,960868,225446380,225044774
29379723_960896,CM021105.1,6,29379723,224485512,1047036,960896,225446408,225044802
29379723_960948,CM021105.1,6,29379723,224485512,1047036,960948,225446460,225044854
29379723_961021,CM021105.1,6,29379723,224485512,1047036,961021,225446533,225044927
29379723_961074,CM021105.1,6,29379723,224485512,1047036,961074,225446586,225044980
29379723_961293,CM021105.1,6,29379723,224485512,1047036,961293,225446805,225045199
29379723_961294,CM021105.1,6,29379723,224485512,1047036,961294,225446806,225045200
29379723_961307,CM021105.1,6,29379723,224485512,1047036,961307,225446819,225045213
29381101_964701,CM021105.1,6,29381101,224485510,2994218,964701,225450211,225048605
29379723_987981,CM021105.1,6,29379723,224485512,1047036,987981,225473493,225071887
29379723_1001136,CM021105.1,6,29379723,224485512,1047036,1001136,225486648,225085042
29379723_1001144,CM021105.1,6,29379723,224485512,1047036,1001144,225486656,225085050
29379723_1001158,CM021105.1,6,29379723,224485512,1047036,1001158,225486670,225085064
29379723_1001172,CM021105.1,6,29379723,224485512,1047036,1001172,225486684,225085078
29379723_1001377,CM021105.1,6,29379723,224485512,1047036,1001377,225486889,225085283
29379723_1001453,CM021105.1,6,29379723,224485512,1047036,1001453,225486965,225085359
29379723_1001498,CM021105.1,6,29379723,224485512,1047036,1001498,225487010,225085404
29379723_1001543,CM021105.1,6,29379723,224485512,1047036,1001543,225487055,225085449
29378667_1002109,CM021105.1,6,29378667,224485500,2355388,1002109,225487609,225086003
29378667_1002114,CM021105.1,6,29378667,224485500,2355388,1002114,225487614,225086008
29378667_1002115,CM021105.1,6,29378667,224485500,2355388,1002115,225487615,225086009
29378667_1002119,CM021105.1,6,29378667,224485500,2355388,1002119,225487619,225086013
29378667_1002191,CM021105.1,6,29378667,224485500,2355388,1002191,225487691,225086085
29378667_1002197,CM021105.1,6,29378667,224485500,2355388,1002197,225487697,225086091
29378667_1002203,CM021105.1,6,29378667,224485500,2355388,1002203,225487703,225086097
29380568_1062325,CM021105.1,6,29380568,224485510,2617210,1062325,225547835,225146229
29380738_1081090,CM021105.1,6,29380738,224485512,7798988,1081090,225566602,225164996
29380738_1081094,CM021105.1,6,29380738,224485512,7798988,1081094,225566606,225165000
29380738_1081105,CM021105.1,6,29380738,224485512,7798988,1081105,225566617,225165011
29380738_1081177,CM021105.1,6,29380738,224485512,7798988,1081177,225566689,225165083
29382491_1098316,CM021105.1,6,29382491,224485847,3097296,1098316,225584163,225182557
29382491_1098331,CM021105.1,6,29382491,224485847,3097296,1098331,225584178,225182572
29382491_1098402,CM021105.1,6,29382491,224485847,3097296,1098402,225584249,225182643
29378826_1119284,CM021105.1,6,29378826,224486225,3046896,1119284,225605509,225203903
29380738_1128835,CM021105.1,6,29380738,224485512,7798988,1128835,225614347,225212741
29380738_1128888,CM021105.1,6,29380738,224485512,7798988,1128888,225614400,225212794
29377986_1147540,CM021105.1,6,29377986,224485510,2045049,1147540,225633050,225231444
29377986_1147541,CM021105.1,6,29377986,224485510,2045049,1147541,225633051,225231445
29377986_1147548,CM021105.1,6,29377986,224485510,2045049,1147548,225633058,225231452
29378826_1169695,CM021105.1,6,29378826,224486225,3046896,1169695,225655920,225254314
29378826_1169721,CM021105.1,6,29378826,224486225,3046896,1169721,225655946,225254340
29378826_1169726,CM021105.1,6,29378826,224486225,3046896,1169726,225655951,225254345
29378826_1169764,CM021105.1,6,29378826,224486225,3046896,1169764,225655989,225254383
29378688_1213170,CM021105.1,6,29378688,224485512,3207448,1213170,225698682,225297076
29379126_1214601,CM021105.1,6,29379126,224485509,3439228,1214601,225700110,225298504
29380738_1218946,CM021105.1,6,29380738,224485512,7798988,1218946,225704458,225302852
29380738_1222842,CM021105.1,6,29380738,224485512,7798988,1222842,225708354,225306748
29379126_1242568,CM021105.1,6,29379126,224485509,3439228,1242568,225728077,225326471
29379126_1242622,CM021105.1,6,29379126,224485509,3439228,1242622,225728131,225326525
29379068_1286506,CM021105.1,6,29379068,224485512,1355417,1286506,225772018,225370412
29379068_1286525,CM021105.1,6,29379068,224485512,1355417,1286525,225772037,225370431
29378832_1386849,CM021105.1,6,29378832,224485508,3896181,1386849,225872357,225470751
29378832_1386966,CM021105.1,6,29378832,224485508,3896181,1386966,225872474,225470868
29379279_1405248,CM021105.1,6,29379279,224485509,1736416,1405248,225890757,225489151
29378832_1414938,CM021105.1,6,29378832,224485508,3896181,1414938,225900446,225498840
29378832_1414980,CM021105.1,6,29378832,224485508,3896181,1414980,225900488,225498882
29378832_1415003,CM021105.1,6,29378832,224485508,3896181,1415003,225900511,225498905
29379279_1491418,CM021105.1,6,29379279,224485509,1736416,1491418,225976927,225575321
29379279_1491423,CM021105.1,6,29379279,224485509,1736416,1491423,225976932,225575326
29379279_1517705,CM021105.1,6,29379279,224485509,1736416,1517705,226003214,225601608
29379279_1517724,CM021105.1,6,29379279,224485509,1736416,1517724,226003233,225601627
29378826_1531976,CM021105.1,6,29378826,224486225,3046896,1531976,226018201,225616595
29378826_1532437,CM021105.1,6,29378826,224486225,3046896,1532437,226018662,225617056
29378826_1532438,CM021105.1,6,29378826,224486225,3046896,1532438,226018663,225617057
29378826_1534351,CM021105.1,6,29378826,224486225,3046896,1534351,226020576,225618970
29377986_1556913,CM021105.1,6,29377986,224485510,2045049,1556913,226042423,225640817
29377986_1556955,CM021105.1,6,29377986,224485510,2045049,1556955,226042465,225640859
29377986_1557013,CM021105.1,6,29377986,224485510,2045049,1557013,226042523,225640917
29377986_1557018,CM021105.1,6,29377986,224485510,2045049,1557018,226042528,225640922
29377986_1557019,CM021105.1,6,29377986,224485510,2045049,1557019,226042529,225640923
29377986_1557026,CM021105.1,6,29377986,224485510,2045049,1557026,226042536,225640930
29377986_1557055,CM021105.1,6,29377986,224485510,2045049,1557055,226042565,225640959
29377986_1557093,CM021105.1,6,29377986,224485510,2045049,1557093,226042603,225640997
29377986_1557100,CM021105.1,6,29377986,224485510,2045049,1557100,226042610,225641004
29377986_1557286,CM021105.1,6,29377986,224485510,2045049,1557286,226042796,225641190
29377986_1557295,CM021105.1,6,29377986,224485510,2045049,1557295,226042805,225641199
29377986_1568994,CM021105.1,6,29377986,224485510,2045049,1568994,226054504,225652898
29379279_1708832,CM021105.1,6,29379279,224485509,1736416,1708832,226194341,225792735
29379279_1708925,CM021105.1,6,29379279,224485509,1736416,1708925,226194434,225792828
29379279_1709077,CM021105.1,6,29379279,224485509,1736416,1709077,226194586,225792980
29379126_1749443,CM021105.1,6,29379126,224485509,3439228,1749443,226234952,225833346
29379040_1889901,CM021105.1,6,29379040,224485510,2979156,1889901,226375411,225973805
29379040_1889920,CM021105.1,6,29379040,224485510,2979156,1889920,226375430,225973824
29379126_1997420,CM021105.1,6,29379126,224485509,3439228,1997420,226482929,226081323
29379126_1997503,CM021105.1,6,29379126,224485509,3439228,1997503,226483012,226081406
29379126_1997536,CM021105.1,6,29379126,224485509,3439228,1997536,226483045,226081439
29379126_1997611,CM021105.1,6,29379126,224485509,3439228,1997611,226483120,226081514
29381294_1999194,CM021105.1,6,29381294,224485510,2491951,1999194,226484704,226083098
29381294_1999303,CM021105.1,6,29381294,224485510,2491951,1999303,226484813,226083207
29377529_96233,CM021105.1,6,29377529,226496956,5870998,96233,226593189,226191583
29377529_96261,CM021105.1,6,29377529,226496956,5870998,96261,226593217,226191611
29380568_2131524,CM021105.1,6,29380568,224485510,2617210,2131524,226617034,226215428
29379126_2165059,CM021105.1,6,29379126,224485509,3439228,2165059,226650568,226248962
29379126_2165073,CM021105.1,6,29379126,224485509,3439228,2165073,226650582,226248976
29380433_2272904,CM021105.1,6,29380433,224485510,2600919,2272904,226758414,226356808
29381101_2328661,CM021105.1,6,29381101,224485510,2994218,2328661,226814171,226412565
29381101_2328664,CM021105.1,6,29381101,224485510,2994218,2328664,226814174,226412568
29381101_2328821,CM021105.1,6,29381101,224485510,2994218,2328821,226814331,226412725
29381101_2328864,CM021105.1,6,29381101,224485510,2994218,2328864,226814374,226412768
29381129_2380557,CM021105.1,6,29381129,224485512,5396747,2380557,226866069,226464463
29380568_2382685,CM021105.1,6,29380568,224485510,2617210,2382685,226868195,226466589
29378826_2482958,CM021105.1,6,29378826,224486225,3046896,2482958,226969183,226567577
29382127_966698,CM021105.1,6,29382127,226222717,1556208,966698,227189415,226787809
29382127_966716,CM021105.1,6,29382127,226222717,1556208,966716,227189433,226787827
29382127_966717,CM021105.1,6,29382127,226222717,1556208,966717,227189434,226787828
29379040_2834439,CM021105.1,6,29379040,224485510,2979156,2834439,227319949,226918343
29379040_2834630,CM021105.1,6,29379040,224485510,2979156,2834630,227320140,226918534
29382250_3031864,CM021105.1,6,29382250,224485508,3550769,3031864,227517372,227115766
29382250_3031898,CM021105.1,6,29382250,224485508,3550769,3031898,227517406,227115800
29382250_3077496,CM021105.1,6,29382250,224485508,3550769,3077496,227563004,227161398
29382250_3078774,CM021105.1,6,29382250,224485508,3550769,3078774,227564282,227162676
29382250_3078860,CM021105.1,6,29382250,224485508,3550769,3078860,227564368,227162762
29382250_3078893,CM021105.1,6,29382250,224485508,3550769,3078893,227564401,227162795
29382250_3078899,CM021105.1,6,29382250,224485508,3550769,3078899,227564407,227162801
29382250_3078993,CM021105.1,6,29382250,224485508,3550769,3078993,227564501,227162895
29382250_3079054,CM021105.1,6,29382250,224485508,3550769,3079054,227564562,227162956
29382250_3079063,CM021105.1,6,29382250,224485508,3550769,3079063,227564571,227162965
29382250_3079092,CM021105.1,6,29382250,224485508,3550769,3079092,227564600,227162994
29382250_3079207,CM021105.1,6,29382250,224485508,3550769,3079207,227564715,227163109
29382250_3079241,CM021105.1,6,29382250,224485508,3550769,3079241,227564749,227163143
29382250_3079244,CM021105.1,6,29382250,224485508,3550769,3079244,227564752,227163146
29382250_3079275,CM021105.1,6,29382250,224485508,3550769,3079275,227564783,227163177
29382250_3079328,CM021105.1,6,29382250,224485508,3550769,3079328,227564836,227163230
29377529_1165889,CM021105.1,6,29377529,226496956,5870998,1165889,227662845,227261239
29377529_1165895,CM021105.1,6,29377529,226496956,5870998,1165895,227662851,227261245
29377529_1165964,CM021105.1,6,29377529,226496956,5870998,1165964,227662920,227261314
29377529_1167162,CM021105.1,6,29377529,226496956,5870998,1167162,227664118,227262512
29377529_1167194,CM021105.1,6,29377529,226496956,5870998,1167194,227664150,227262544
29377529_1167231,CM021105.1,6,29377529,226496956,5870998,1167231,227664187,227262581
29377529_1167255,CM021105.1,6,29377529,226496956,5870998,1167255,227664211,227262605
29377529_1167275,CM021105.1,6,29377529,226496956,5870998,1167275,227664231,227262625
29377529_1167340,CM021105.1,6,29377529,226496956,5870998,1167340,227664296,227262690
29377529_1167377,CM021105.1,6,29377529,226496956,5870998,1167377,227664333,227262727
29381129_3210361,CM021105.1,6,29381129,224485512,5396747,3210361,227695873,227294267
29381129_3210395,CM021105.1,6,29381129,224485512,5396747,3210395,227695907,227294301
29381129_3220418,CM021105.1,6,29381129,224485512,5396747,3220418,227705930,227304324
29377529_2004068,CM021105.1,6,29377529,226496956,5870998,2004068,228501024,228099418
29377529_2004147,CM021105.1,6,29377529,226496956,5870998,2004147,228501103,228099497
29377529_2004183,CM021105.1,6,29377529,226496956,5870998,2004183,228501139,228099533
29377529_2004239,CM021105.1,6,29377529,226496956,5870998,2004239,228501195,228099589
29377529_2064595,CM021105.1,6,29377529,226496956,5870998,2064595,228561551,228159945
29377529_2064638,CM021105.1,6,29377529,226496956,5870998,2064638,228561594,228159988
29377529_2164130,CM021105.1,6,29377529,226496956,5870998,2164130,228661086,228259480
29377529_2164191,CM021105.1,6,29377529,226496956,5870998,2164191,228661147,228259541
29377529_2164324,CM021105.1,6,29377529,226496956,5870998,2164324,228661280,228259674
29377529_2164344,CM021105.1,6,29377529,226496956,5870998,2164344,228661300,228259694
29377529_2164348,CM021105.1,6,29377529,226496956,5870998,2164348,228661304,228259698
29377529_2164423,CM021105.1,6,29377529,226496956,5870998,2164423,228661379,228259773
29381129_4215996,CM021105.1,6,29381129,224485512,5396747,4215996,228701508,228299902
29381129_4216158,CM021105.1,6,29381129,224485512,5396747,4216158,228701670,228300064
29377529_2713369,CM021105.1,6,29377529,226496956,5870998,2713369,229210325,228808719
29381129_4998483,CM021105.1,6,29381129,224485512,5396747,4998483,229483995,229082389
29381129_5061860,CM021105.1,6,29381129,224485512,5396747,5061860,229547372,229145766
29381129_5061875,CM021105.1,6,29381129,224485512,5396747,5061875,229547387,229145781
29381129_5061892,CM021105.1,6,29381129,224485512,5396747,5061892,229547404,229145798
29381129_5084887,CM021105.1,6,29381129,224485512,5396747,5084887,229570399,229168793
29381129_5084893,CM021105.1,6,29381129,224485512,5396747,5084893,229570405,229168799
29381129_5084902,CM021105.1,6,29381129,224485512,5396747,5084902,229570414,229168808
29377529_3414489,CM021105.1,6,29377529,226496956,5870998,3414489,229911445,229509839
29377529_3414508,CM021105.1,6,29377529,226496956,5870998,3414508,229911464,229509858
29377529_3414740,CM021105.1,6,29377529,226496956,5870998,3414740,229911696,229510090
29377529_3415113,CM021105.1,6,29377529,226496956,5870998,3415113,229912069,229510463
29377529_3415158,CM021105.1,6,29377529,226496956,5870998,3415158,229912114,229510508
29377529_3418563,CM021105.1,6,29377529,226496956,5870998,3418563,229915519,229513913
29377529_3420408,CM021105.1,6,29377529,226496956,5870998,3420408,229917364,229515758
29377529_3420760,CM021105.1,6,29377529,226496956,5870998,3420760,229917716,229516110
29380738_6798134,CM021105.1,6,29380738,224485512,7798988,6798134,231283646,230882040
29380738_7165707,CM021105.1,6,29380738,224485512,7798988,7165707,231651219,231249613
29380738_7172165,CM021105.1,6,29380738,224485512,7798988,7172165,231657677,231256071
29380738_7172218,CM021105.1,6,29380738,224485512,7798988,7172218,231657730,231256124
29380738_7172337,CM021105.1,6,29380738,224485512,7798988,7172337,231657849,231256243
29380738_7172820,CM021105.1,6,29380738,224485512,7798988,7172820,231658332,231256726
29380738_7172838,CM021105.1,6,29380738,224485512,7798988,7172838,231658350,231256744
29380738_7174090,CM021105.1,6,29380738,224485512,7798988,7174090,231659602,231257996
29380738_7174155,CM021105.1,6,29380738,224485512,7798988,7174155,231659667,231258061
29377529_5472933,CM021105.1,6,29377529,226496956,5870998,5472933,231969889,231568283
29377529_5800471,CM021105.1,6,29377529,226496956,5870998,5800471,232297427,231895821
29378825_504933,CM021105.1,6,29378825,259673853,533511,504933,260178786,259777180
29378825_504981,CM021105.1,6,29378825,259673853,533511,504981,260178834,259777228
287141251_1389,CM021105.1,6,287141251,278515994,7078,1389,278517383,278115777
287141251_1706,CM021105.1,6,287141251,278515994,7078,1706,278517700,278116094
287141251_1846,CM021105.1,6,287141251,278515994,7078,1846,278517840,278116234
29379995_1904,CM021105.1,6,29379995,326429675,3294495,1904,326431579,326029973
29364006_8632,CM021105.1,6,29364006,326429675,365716,8632,326438307,326036701
29364006_8739,CM021105.1,6,29364006,326429675,365716,8739,326438414,326036808
29364006_8836,CM021105.1,6,29364006,326429675,365716,8836,326438511,326036905
29364006_8905,CM021105.1,6,29364006,326429675,365716,8905,326438580,326036974
29364006_9063,CM021105.1,6,29364006,326429675,365716,9063,326438738,326037132
29377142_2044,CM021105.1,6,29377142,326439204,605388,2044,326441248,326039642
29377142_2045,CM021105.1,6,29377142,326439204,605388,2045,326441249,326039643
29377142_2089,CM021105.1,6,29377142,326439204,605388,2089,326441293,326039687
29378134_24950,CM021105.1,6,29378134,326429675,1931519,24950,326454625,326053019
29382370_12194,CM021105.1,6,29382370,326442899,268499,12194,326455093,326053487
29382370_12220,CM021105.1,6,29382370,326442899,268499,12220,326455119,326053513
29364006_27708,CM021105.1,6,29364006,326429675,365716,27708,326457383,326055777
29364006_27724,CM021105.1,6,29364006,326429675,365716,27724,326457399,326055793
29364006_27955,CM021105.1,6,29364006,326429675,365716,27955,326457630,326056024
29364006_28118,CM021105.1,6,29364006,326429675,365716,28118,326457793,326056187
29378133_44550,CM021105.1,6,29378133,326429675,1380310,44550,326474225,326072619
29378133_44565,CM021105.1,6,29378133,326429675,1380310,44565,326474240,326072634
29378133_44567,CM021105.1,6,29378133,326429675,1380310,44567,326474242,326072636
29378133_45389,CM021105.1,6,29378133,326429675,1380310,45389,326475064,326073458
29378133_45401,CM021105.1,6,29378133,326429675,1380310,45401,326475076,326073470
29378133_45402,CM021105.1,6,29378133,326429675,1380310,45402,326475077,326073471
29378133_45421,CM021105.1,6,29378133,326429675,1380310,45421,326475096,326073490
29364006_49095,CM021105.1,6,29364006,326429675,365716,49095,326478770,326077164
29364006_49228,CM021105.1,6,29364006,326429675,365716,49228,326478903,326077297
29364006_49330,CM021105.1,6,29364006,326429675,365716,49330,326479005,326077399
29364006_49381,CM021105.1,6,29364006,326429675,365716,49381,326479056,326077450
29364006_49551,CM021105.1,6,29364006,326429675,365716,49551,326479226,326077620
29364006_49594,CM021105.1,6,29364006,326429675,365716,49594,326479269,326077663
29336465_36899,CM021105.1,6,29336465,326443777,522270,36899,326480676,326079070
29378150_54319,CM021105.1,6,29378150,326438680,2092610,54319,326492999,326091393
29378150_54389,CM021105.1,6,29378150,326438680,2092610,54389,326493069,326091463
29378150_54431,CM021105.1,6,29378150,326438680,2092610,54431,326493111,326091505
29378150_54457,CM021105.1,6,29378150,326438680,2092610,54457,326493137,326091531
29342583_50178,CM021105.1,6,29342583,326443114,50830,50178,326493292,326091686
29342583_50196,CM021105.1,6,29342583,326443114,50830,50196,326493310,326091704
29342583_50248,CM021105.1,6,29342583,326443114,50830,50248,326493362,326091756
29380266_81460,CM021105.1,6,29380266,326437768,1483875,81460,326519228,326117622
29380266_81531,CM021105.1,6,29380266,326437768,1483875,81531,326519299,326117693
29380266_81561,CM021105.1,6,29380266,326437768,1483875,81561,326519329,326117723
29380266_81564,CM021105.1,6,29380266,326437768,1483875,81564,326519332,326117726
29380266_81567,CM021105.1,6,29380266,326437768,1483875,81567,326519335,326117729
29380266_82115,CM021105.1,6,29380266,326437768,1483875,82115,326519883,326118277
29380762_101134,CM021105.1,6,29380762,326438661,1336387,101134,326539795,326138189
29379515_116546,CM021105.1,6,29379515,326429675,810564,116546,326546221,326144615
29382370_136659,CM021105.1,6,29382370,326442899,268499,136659,326579558,326177952
29379515_212676,CM021105.1,6,29379515,326429675,810564,212676,326642351,326240745
29379515_212769,CM021105.1,6,29379515,326429675,810564,212769,326642444,326240838
29336754_204830,CM021105.1,6,29336754,326444339,435466,204830,326649169,326247563
29336754_205368,CM021105.1,6,29336754,326444339,435466,205368,326649707,326248101
29378829_220035,CM021105.1,6,29378829,326429675,7112812,220035,326649710,326248104
29336754_205423,CM021105.1,6,29336754,326444339,435466,205423,326649762,326248156
29336754_205426,CM021105.1,6,29336754,326444339,435466,205426,326649765,326248159
29377552_213013,CM021105.1,6,29377552,326439251,2418268,213013,326652264,326250658
29377552_213027,CM021105.1,6,29377552,326439251,2418268,213027,326652278,326250672
29377552_213028,CM021105.1,6,29377552,326439251,2418268,213028,326652279,326250673
29377552_213030,CM021105.1,6,29377552,326439251,2418268,213030,326652281,326250675
29377552_213051,CM021105.1,6,29377552,326439251,2418268,213051,326652302,326250696
29377552_213062,CM021105.1,6,29377552,326439251,2418268,213062,326652313,326250707
29377552_213129,CM021105.1,6,29377552,326439251,2418268,213129,326652380,326250774
29377552_213210,CM021105.1,6,29377552,326439251,2418268,213210,326652461,326250855
29377552_213227,CM021105.1,6,29377552,326439251,2418268,213227,326652478,326250872
29377892_214876,CM021105.1,6,29377892,326441476,1894709,214876,326656352,326254746
29377892_214891,CM021105.1,6,29377892,326441476,1894709,214891,326656367,326254761
29377892_214912,CM021105.1,6,29377892,326441476,1894709,214912,326656388,326254782
29377892_214917,CM021105.1,6,29377892,326441476,1894709,214917,326656393,326254787
29377892_214925,CM021105.1,6,29377892,326441476,1894709,214925,326656401,326254795
29377892_214927,CM021105.1,6,29377892,326441476,1894709,214927,326656403,326254797
29377892_215006,CM021105.1,6,29377892,326441476,1894709,215006,326656482,326254876
29379515_232170,CM021105.1,6,29379515,326429675,810564,232170,326661845,326260239
29379277_241479,CM021105.1,6,29379277,326440992,592384,241479,326682471,326280865
29379277_241508,CM021105.1,6,29379277,326440992,592384,241508,326682500,326280894
29377892_256672,CM021105.1,6,29377892,326441476,1894709,256672,326698148,326296542
29378829_281253,CM021105.1,6,29378829,326429675,7112812,281253,326710928,326309322
29336465_274472,CM021105.1,6,29336465,326443777,522270,274472,326718249,326316643
29336465_274528,CM021105.1,6,29336465,326443777,522270,274528,326718305,326316699
29336465_274529,CM021105.1,6,29336465,326443777,522270,274529,326718306,326316700
29336465_274543,CM021105.1,6,29336465,326443777,522270,274543,326718320,326316714
29336465_274545,CM021105.1,6,29336465,326443777,522270,274545,326718322,326316716
29336465_274549,CM021105.1,6,29336465,326443777,522270,274549,326718326,326316720
29336465_274565,CM021105.1,6,29336465,326443777,522270,274565,326718342,326316736
29336465_274570,CM021105.1,6,29336465,326443777,522270,274570,326718347,326316741
29382211_293827,CM021105.1,6,29382211,326440445,449272,293827,326734272,326332666
29382211_294117,CM021105.1,6,29382211,326440445,449272,294117,326734562,326332956
29382211_294133,CM021105.1,6,29382211,326440445,449272,294133,326734578,326332972
29382211_294140,CM021105.1,6,29382211,326440445,449272,294140,326734585,326332979
29382211_294182,CM021105.1,6,29382211,326440445,449272,294182,326734627,326333021
29380969_304783,CM021105.1,6,29380969,326442984,558742,304783,326747767,326346161
29379780_331454,CM021105.1,6,29379780,326439992,2112222,331454,326771446,326369840
29379780_331487,CM021105.1,6,29379780,326439992,2112222,331487,326771479,326369873
29379780_331510,CM021105.1,6,29379780,326439992,2112222,331510,326771502,326369896
29379780_331558,CM021105.1,6,29379780,326439992,2112222,331558,326771550,326369944
29379780_331563,CM021105.1,6,29379780,326439992,2112222,331563,326771555,326369949
29379780_331569,CM021105.1,6,29379780,326439992,2112222,331569,326771561,326369955
29379780_331580,CM021105.1,6,29379780,326439992,2112222,331580,326771572,326369966
29379277_331592,CM021105.1,6,29379277,326440992,592384,331592,326772584,326370978
29379277_331594,CM021105.1,6,29379277,326440992,592384,331594,326772586,326370980
29381181_345574,CM021105.1,6,29381181,326429671,2220099,345574,326775245,326373639
29377892_334989,CM021105.1,6,29377892,326441476,1894709,334989,326776465,326374859
29377892_335000,CM021105.1,6,29377892,326441476,1894709,335000,326776476,326374870
29381181_347276,CM021105.1,6,29381181,326429671,2220099,347276,326776947,326375341
29381181_347951,CM021105.1,6,29381181,326429671,2220099,347951,326777622,326376016
29379470_344738,CM021105.1,6,29379470,326436160,3932134,344738,326780898,326379292
29379995_352810,CM021105.1,6,29379995,326429675,3294495,352810,326782485,326380879
29379470_373106,CM021105.1,6,29379470,326436160,3932134,373106,326809266,326407660
29379470_373116,CM021105.1,6,29379470,326436160,3932134,373116,326809276,326407670
29379470_373149,CM021105.1,6,29379470,326436160,3932134,373149,326809309,326407703
29379470_373234,CM021105.1,6,29379470,326436160,3932134,373234,326809394,326407788
29379470_373270,CM021105.1,6,29379470,326436160,3932134,373270,326809430,326407824
29379470_373352,CM021105.1,6,29379470,326436160,3932134,373352,326809512,326407906
29378735_395056,CM021105.1,6,29378735,326429674,11537687,395056,326824730,326423124
29378735_398281,CM021105.1,6,29378735,326429674,11537687,398281,326827955,326426349
29378735_398305,CM021105.1,6,29378735,326429674,11537687,398305,326827979,326426373
29378735_398360,CM021105.1,6,29378735,326429674,11537687,398360,326828034,326426428
29378735_398406,CM021105.1,6,29378735,326429674,11537687,398406,326828080,326426474
29379780_390740,CM021105.1,6,29379780,326439992,2112222,390740,326830732,326429126
29378128_397333,CM021105.1,6,29378128,326439978,764307,397333,326837311,326435705
29378128_397428,CM021105.1,6,29378128,326439978,764307,397428,326837406,326435800
29378128_397541,CM021105.1,6,29378128,326439978,764307,397541,326837519,326435913
29378128_397556,CM021105.1,6,29378128,326439978,764307,397556,326837534,326435928
29378128_397617,CM021105.1,6,29378128,326439978,764307,397617,326837595,326435989
29380762_418425,CM021105.1,6,29380762,326438661,1336387,418425,326857086,326455480
29380762_419066,CM021105.1,6,29380762,326438661,1336387,419066,326857727,326456121
29380762_419146,CM021105.1,6,29380762,326438661,1336387,419146,326857807,326456201
29380762_419184,CM021105.1,6,29380762,326438661,1336387,419184,326857845,326456239
29380762_419190,CM021105.1,6,29380762,326438661,1336387,419190,326857851,326456245
29380762_440819,CM021105.1,6,29380762,326438661,1336387,440819,326879480,326477874
29381181_481137,CM021105.1,6,29381181,326429671,2220099,481137,326910808,326509202
29381181_481161,CM021105.1,6,29381181,326429671,2220099,481161,326910832,326509226
29378829_501748,CM021105.1,6,29378829,326429675,7112812,501748,326931423,326529817
29378829_501755,CM021105.1,6,29378829,326429675,7112812,501755,326931430,326529824
29380762_498357,CM021105.1,6,29380762,326438661,1336387,498357,326937018,326535412
29380762_498397,CM021105.1,6,29380762,326438661,1336387,498397,326937058,326535452
29380762_498409,CM021105.1,6,29380762,326438661,1336387,498409,326937070,326535464
29380762_501996,CM021105.1,6,29380762,326438661,1336387,501996,326940657,326539051
29379024_510232,CM021105.1,6,29379024,326439312,5986474,510232,326949544,326547938
29379024_534076,CM021105.1,6,29379024,326439312,5986474,534076,326973388,326571782
29380574_589081,CM021105.1,6,29380574,326429675,2150942,589081,327018756,326617150
29380275_616125,CM021105.1,6,29380275,326439354,2009575,616125,327055479,326653873
29380275_616169,CM021105.1,6,29380275,326439354,2009575,616169,327055523,326653917
29380275_616170,CM021105.1,6,29380275,326439354,2009575,616170,327055524,326653918
29379515_634004,CM021105.1,6,29379515,326429675,810564,634004,327063679,326662073
29379515_634076,CM021105.1,6,29379515,326429675,810564,634076,327063751,326662145
29378150_655427,CM021105.1,6,29378150,326438680,2092610,655427,327094107,326692501
29379746_670274,CM021105.1,6,29379746,326440742,1951799,670274,327111016,326709410
29379515_683326,CM021105.1,6,29379515,326429675,810564,683326,327113001,326711395
29379515_684458,CM021105.1,6,29379515,326429675,810564,684458,327114133,326712527
29379515_684844,CM021105.1,6,29379515,326429675,810564,684844,327114519,326712913
29379470_688690,CM021105.1,6,29379470,326436160,3932134,688690,327124850,326723244
29379470_688691,CM021105.1,6,29379470,326436160,3932134,688691,327124851,326723245
29379470_688776,CM021105.1,6,29379470,326436160,3932134,688776,327124936,326723330
29379470_688826,CM021105.1,6,29379470,326436160,3932134,688826,327124986,326723380
29378764_720449,CM021105.1,6,29378764,326429674,2287585,720449,327150123,326748517
29378764_720530,CM021105.1,6,29378764,326429674,2287585,720530,327150204,326748598
29378764_720534,CM021105.1,6,29378764,326429674,2287585,720534,327150208,326748602
29380762_712268,CM021105.1,6,29380762,326438661,1336387,712268,327150929,326749323
29377100_730206,CM021105.1,6,29377100,326438594,4094811,730206,327168800,326767194
29377100_730223,CM021105.1,6,29377100,326438594,4094811,730223,327168817,326767211
29377100_730265,CM021105.1,6,29377100,326438594,4094811,730265,327168859,326767253
29377100_730297,CM021105.1,6,29377100,326438594,4094811,730297,327168891,326767285
29377100_730304,CM021105.1,6,29377100,326438594,4094811,730304,327168898,326767292
29377100_730317,CM021105.1,6,29377100,326438594,4094811,730317,327168911,326767305
29377295_757432,CM021105.1,6,29377295,326429675,1281462,757432,327187107,326785501
29377295_757482,CM021105.1,6,29377295,326429675,1281462,757482,327187157,326785551
29377295_757564,CM021105.1,6,29377295,326429675,1281462,757564,327187239,326785633
29379746_755418,CM021105.1,6,29379746,326440742,1951799,755418,327196160,326794554
29379746_755429,CM021105.1,6,29379746,326440742,1951799,755429,327196171,326794565
29378133_770052,CM021105.1,6,29378133,326429675,1380310,770052,327199727,326798121
29378133_770166,CM021105.1,6,29378133,326429675,1380310,770166,327199841,326798235
29379746_774991,CM021105.1,6,29379746,326440742,1951799,774991,327215733,326814127
29380574_787327,CM021105.1,6,29380574,326429675,2150942,787327,327217002,326815396
29380574_787332,CM021105.1,6,29380574,326429675,2150942,787332,327217007,326815401
29380574_787896,CM021105.1,6,29380574,326429675,2150942,787896,327217571,326815965
29380574_787910,CM021105.1,6,29380574,326429675,2150942,787910,327217585,326815979
29380266_795290,CM021105.1,6,29380266,326437768,1483875,795290,327233058,326831452
29380574_803781,CM021105.1,6,29380574,326429675,2150942,803781,327233456,326831850
29380650_804548,CM021105.1,6,29380650,326429673,2896743,804548,327234221,326832615
29380574_819271,CM021105.1,6,29380574,326429675,2150942,819271,327248946,326847340
29380574_819375,CM021105.1,6,29380574,326429675,2150942,819375,327249050,326847444
29380958_841991,CM021105.1,6,29380958,326439309,3881734,841991,327281300,326879694
29377552_868120,CM021105.1,6,29377552,326439251,2418268,868120,327307371,326905765
29377552_868128,CM021105.1,6,29377552,326439251,2418268,868128,327307379,326905773
29377552_868859,CM021105.1,6,29377552,326439251,2418268,868859,327308110,326906504
29377552_868861,CM021105.1,6,29377552,326439251,2418268,868861,327308112,326906506
29377552_869213,CM021105.1,6,29377552,326439251,2418268,869213,327308464,326906858
29377552_869280,CM021105.1,6,29377552,326439251,2418268,869280,327308531,326906925
29377892_884103,CM021105.1,6,29377892,326441476,1894709,884103,327325579,326923973
29377100_887885,CM021105.1,6,29377100,326438594,4094811,887885,327326479,326924873
29378304_920186,CM021105.1,6,29378304,326429675,1702623,920186,327349861,326948255
29378019_924472,CM021105.1,6,29378019,326429675,3545528,924472,327354147,326952541
29380574_970981,CM021105.1,6,29380574,326429675,2150942,970981,327400656,326999050
29380574_971026,CM021105.1,6,29380574,326429675,2150942,971026,327400701,326999095
29380574_971036,CM021105.1,6,29380574,326429675,2150942,971036,327400711,326999105
29379017_959254,CM021105.1,6,29379017,326443169,5058544,959254,327402423,327000817
29377892_987626,CM021105.1,6,29377892,326441476,1894709,987626,327429102,327027496
29377892_992455,CM021105.1,6,29377892,326441476,1894709,992455,327433931,327032325
29377892_992565,CM021105.1,6,29377892,326441476,1894709,992565,327434041,327032435
29377892_992574,CM021105.1,6,29377892,326441476,1894709,992574,327434050,327032444
29377892_993609,CM021105.1,6,29377892,326441476,1894709,993609,327435085,327033479
29377892_1042056,CM021105.1,6,29377892,326441476,1894709,1042056,327483532,327081926
29377892_1042082,CM021105.1,6,29377892,326441476,1894709,1042082,327483558,327081952
29377892_1058638,CM021105.1,6,29377892,326441476,1894709,1058638,327500114,327098508
29377892_1058670,CM021105.1,6,29377892,326441476,1894709,1058670,327500146,327098540
29377892_1058818,CM021105.1,6,29377892,326441476,1894709,1058818,327500294,327098688
29377892_1058820,CM021105.1,6,29377892,326441476,1894709,1058820,327500296,327098690
29377892_1058834,CM021105.1,6,29377892,326441476,1894709,1058834,327500310,327098704
29377892_1058878,CM021105.1,6,29377892,326441476,1894709,1058878,327500354,327098748
29382051_1081431,CM021105.1,6,29382051,326439776,2287615,1081431,327521207,327119601
29379017_1091376,CM021105.1,6,29379017,326443169,5058544,1091376,327534545,327132939
29379017_1091428,CM021105.1,6,29379017,326443169,5058544,1091428,327534597,327132991
29379017_1091465,CM021105.1,6,29379017,326443169,5058544,1091465,327534634,327133028
29380574_1152093,CM021105.1,6,29380574,326429675,2150942,1152093,327581768,327180162
29380574_1152099,CM021105.1,6,29380574,326429675,2150942,1152099,327581774,327180168
29380574_1190224,CM021105.1,6,29380574,326429675,2150942,1190224,327619899,327218293
29380366_1180124,CM021105.1,6,29380366,326441766,1572919,1180124,327621890,327220284
29380497_1204186,CM021105.1,6,29380497,326429674,1219486,1204186,327633860,327232254
29380497_1204216,CM021105.1,6,29380497,326429674,1219486,1204216,327633890,327232284
29380497_1204251,CM021105.1,6,29380497,326429674,1219486,1204251,327633925,327232319
29380497_1204262,CM021105.1,6,29380497,326429674,1219486,1204262,327633936,327232330
29380497_1204280,CM021105.1,6,29380497,326429674,1219486,1204280,327633954,327232348
29380497_1204283,CM021105.1,6,29380497,326429674,1219486,1204283,327633957,327232351
29380497_1204305,CM021105.1,6,29380497,326429674,1219486,1204305,327633979,327232373
29380497_1204307,CM021105.1,6,29380497,326429674,1219486,1204307,327633981,327232375
29380497_1204344,CM021105.1,6,29380497,326429674,1219486,1204344,327634018,327232412
29380497_1204345,CM021105.1,6,29380497,326429674,1219486,1204345,327634019,327232413
29380497_1204386,CM021105.1,6,29380497,326429674,1219486,1204386,327634060,327232454
29378829_1305194,CM021105.1,6,29378829,326429675,7112812,1305194,327734869,327333263
29380275_1308941,CM021105.1,6,29380275,326439354,2009575,1308941,327748295,327346689
29380275_1308962,CM021105.1,6,29380275,326439354,2009575,1308962,327748316,327346710
29380574_1403975,CM021105.1,6,29380574,326429675,2150942,1403975,327833650,327432044
29380574_1404033,CM021105.1,6,29380574,326429675,2150942,1404033,327833708,327432102
29380275_1399799,CM021105.1,6,29380275,326439354,2009575,1399799,327839153,327437547
29380275_1399833,CM021105.1,6,29380275,326439354,2009575,1399833,327839187,327437581
29380275_1399856,CM021105.1,6,29380275,326439354,2009575,1399856,327839210,327437604
29380275_1399895,CM021105.1,6,29380275,326439354,2009575,1399895,327839249,327437643
29380275_1399901,CM021105.1,6,29380275,326439354,2009575,1399901,327839255,327437649
29380275_1399903,CM021105.1,6,29380275,326439354,2009575,1399903,327839257,327437651
29380958_1442338,CM021105.1,6,29380958,326439309,3881734,1442338,327881647,327480041
29381181_1484974,CM021105.1,6,29381181,326429671,2220099,1484974,327914645,327513039
29381181_1485007,CM021105.1,6,29381181,326429671,2220099,1485007,327914678,327513072
29381181_1485066,CM021105.1,6,29381181,326429671,2220099,1485066,327914737,327513131
29381181_1485068,CM021105.1,6,29381181,326429671,2220099,1485068,327914739,327513133
29381181_1485114,CM021105.1,6,29381181,326429671,2220099,1485114,327914785,327513179
29381181_1485116,CM021105.1,6,29381181,326429671,2220099,1485116,327914787,327513181
29381181_1485177,CM021105.1,6,29381181,326429671,2220099,1485177,327914848,327513242
29378829_1558359,CM021105.1,6,29378829,326429675,7112812,1558359,327988034,327586428
29378829_1558448,CM021105.1,6,29378829,326429675,7112812,1558448,327988123,327586517
29378829_1610415,CM021105.1,6,29378829,326429675,7112812,1610415,328040090,327638484
29378829_1610423,CM021105.1,6,29378829,326429675,7112812,1610423,328040098,327638492
29381377_1606997,CM021105.1,6,29381377,326441491,1958789,1606997,328048488,327646882
29377552_1645516,CM021105.1,6,29377552,326439251,2418268,1645516,328084767,327683161
29377552_1645860,CM021105.1,6,29377552,326439251,2418268,1645860,328085111,327683505
29377552_1646019,CM021105.1,6,29377552,326439251,2418268,1646019,328085270,327683664
29377552_1646025,CM021105.1,6,29377552,326439251,2418268,1646025,328085276,327683670
29377552_1646360,CM021105.1,6,29377552,326439251,2418268,1646360,328085611,327684005
29379932_1672462,CM021105.1,6,29379932,326433157,3504731,1672462,328105619,327704013
29379932_1672568,CM021105.1,6,29379932,326433157,3504731,1672568,328105725,327704119
29377552_1698079,CM021105.1,6,29377552,326439251,2418268,1698079,328137330,327735724
29377552_1698167,CM021105.1,6,29377552,326439251,2418268,1698167,328137418,327735812
29377552_1698190,CM021105.1,6,29377552,326439251,2418268,1698190,328137441,327735835
29377552_1698416,CM021105.1,6,29377552,326439251,2418268,1698416,328137667,327736061
29377552_1701408,CM021105.1,6,29377552,326439251,2418268,1701408,328140659,327739053
29379932_1750613,CM021105.1,6,29379932,326433157,3504731,1750613,328183770,327782164
29379932_1750618,CM021105.1,6,29379932,326433157,3504731,1750618,328183775,327782169
29380650_1903439,CM021105.1,6,29380650,326429673,2896743,1903439,328333112,327931506
29380650_1903450,CM021105.1,6,29380650,326429673,2896743,1903450,328333123,327931517
29380650_1903463,CM021105.1,6,29380650,326429673,2896743,1903463,328333136,327931530
29380650_1903464,CM021105.1,6,29380650,326429673,2896743,1903464,328333137,327931531
29380650_1903467,CM021105.1,6,29380650,326429673,2896743,1903467,328333140,327931534
29380650_1903734,CM021105.1,6,29380650,326429673,2896743,1903734,328333407,327931801
29380650_1903738,CM021105.1,6,29380650,326429673,2896743,1903738,328333411,327931805
29380650_1903745,CM021105.1,6,29380650,326429673,2896743,1903745,328333418,327931812
29380650_1921632,CM021105.1,6,29380650,326429673,2896743,1921632,328351305,327949699
29380650_1921671,CM021105.1,6,29380650,326429673,2896743,1921671,328351344,327949738
29380650_1921695,CM021105.1,6,29380650,326429673,2896743,1921695,328351368,327949762
29380650_1921735,CM021105.1,6,29380650,326429673,2896743,1921735,328351408,327949802
29380650_1922193,CM021105.1,6,29380650,326429673,2896743,1922193,328351866,327950260
29377552_1941222,CM021105.1,6,29377552,326439251,2418268,1941222,328380473,327978867
29377552_1941244,CM021105.1,6,29377552,326439251,2418268,1941244,328380495,327978889
29377552_1967671,CM021105.1,6,29377552,326439251,2418268,1967671,328406922,328005316
29378150_2080897,CM021105.1,6,29378150,326438680,2092610,2080897,328519577,328117971
29378150_2081019,CM021105.1,6,29378150,326438680,2092610,2081019,328519699,328118093
29378150_2081037,CM021105.1,6,29378150,326438680,2092610,2081037,328519717,328118111
29381181_2115175,CM021105.1,6,29381181,326429671,2220099,2115175,328544846,328143240
29381181_2115194,CM021105.1,6,29381181,326429671,2220099,2115194,328544865,328143259
29378829_2115934,CM021105.1,6,29378829,326429675,7112812,2115934,328545609,328144003
29378829_2206914,CM021105.1,6,29378829,326429675,7112812,2206914,328636589,328234983
29378764_2215839,CM021105.1,6,29378764,326429674,2287585,2215839,328645513,328243907
29377768_2304793,CM021105.1,6,29377768,326438427,5081604,2304793,328743220,328341614
29377768_2304824,CM021105.1,6,29377768,326438427,5081604,2304824,328743251,328341645
29377768_2304831,CM021105.1,6,29377768,326438427,5081604,2304831,328743258,328341652
29377768_2304842,CM021105.1,6,29377768,326438427,5081604,2304842,328743269,328341663
29377768_2304846,CM021105.1,6,29377768,326438427,5081604,2304846,328743273,328341667
29377768_2304853,CM021105.1,6,29377768,326438427,5081604,2304853,328743280,328341674
29377768_2304861,CM021105.1,6,29377768,326438427,5081604,2304861,328743288,328341682
29377768_2304877,CM021105.1,6,29377768,326438427,5081604,2304877,328743304,328341698
29377768_2304909,CM021105.1,6,29377768,326438427,5081604,2304909,328743336,328341730
29377768_2304942,CM021105.1,6,29377768,326438427,5081604,2304942,328743369,328341763
29377768_2304971,CM021105.1,6,29377768,326438427,5081604,2304971,328743398,328341792
29377768_2304977,CM021105.1,6,29377768,326438427,5081604,2304977,328743404,328341798
29377768_2305061,CM021105.1,6,29377768,326438427,5081604,2305061,328743488,328341882
29377768_2305064,CM021105.1,6,29377768,326438427,5081604,2305064,328743491,328341885
29378339_2392651,CM021105.1,6,29378339,326429674,4202656,2392651,328822325,328420719
29378339_2393157,CM021105.1,6,29378339,326429674,4202656,2393157,328822831,328421225
29378339_2394932,CM021105.1,6,29378339,326429674,4202656,2394932,328824606,328423000
29379047_2556453,CM021105.1,6,29379047,326439064,2755552,2556453,328995517,328593911
29379470_2561257,CM021105.1,6,29379470,326436160,3932134,2561257,328997417,328595811
29379470_2561265,CM021105.1,6,29379470,326436160,3932134,2561265,328997425,328595819
29379047_2611552,CM021105.1,6,29379047,326439064,2755552,2611552,329050616,328649010
29378829_2705855,CM021105.1,6,29378829,326429675,7112812,2705855,329135530,328733924
29379047_2703985,CM021105.1,6,29379047,326439064,2755552,2703985,329143049,328741443
29379047_2704071,CM021105.1,6,29379047,326439064,2755552,2704071,329143135,328741529
29379047_2707254,CM021105.1,6,29379047,326439064,2755552,2707254,329146318,328744712
29379047_2707305,CM021105.1,6,29379047,326439064,2755552,2707305,329146369,328744763
29379047_2707331,CM021105.1,6,29379047,326439064,2755552,2707331,329146395,328744789
29379047_2708285,CM021105.1,6,29379047,326439064,2755552,2708285,329147349,328745743
29379047_2708323,CM021105.1,6,29379047,326439064,2755552,2708323,329147387,328745781
29379470_2722252,CM021105.1,6,29379470,326436160,3932134,2722252,329158412,328756806
29378829_2738701,CM021105.1,6,29378829,326429675,7112812,2738701,329168376,328766770
29378829_2739006,CM021105.1,6,29378829,326429675,7112812,2739006,329168681,328767075
29378829_2739059,CM021105.1,6,29378829,326429675,7112812,2739059,329168734,328767128
29378829_2739133,CM021105.1,6,29378829,326429675,7112812,2739133,329168808,328767202
29379017_2805353,CM021105.1,6,29379017,326443169,5058544,2805353,329248522,328846916
29379017_2806373,CM021105.1,6,29379017,326443169,5058544,2806373,329249542,328847936
29379470_2880170,CM021105.1,6,29379470,326436160,3932134,2880170,329316330,328914724
29379017_2889507,CM021105.1,6,29379017,326443169,5058544,2889507,329332676,328931070
29379470_3027619,CM021105.1,6,29379470,326436160,3932134,3027619,329463779,329062173
29379017_3105428,CM021105.1,6,29379017,326443169,5058544,3105428,329548597,329146991
29379017_3114427,CM021105.1,6,29379017,326443169,5058544,3114427,329557596,329155990
29379017_3128450,CM021105.1,6,29379017,326443169,5058544,3128450,329571619,329170013
29379017_3289976,CM021105.1,6,29379017,326443169,5058544,3289976,329733145,329331539
29378339_3457020,CM021105.1,6,29378339,326429674,4202656,3457020,329886694,329485088
29378339_3457027,CM021105.1,6,29378339,326429674,4202656,3457027,329886701,329485095
29378339_3473732,CM021105.1,6,29378339,326429674,4202656,3473732,329903406,329501800
29378339_3476437,CM021105.1,6,29378339,326429674,4202656,3476437,329906111,329504505
29377100_3481938,CM021105.1,6,29377100,326438594,4094811,3481938,329920532,329518926
29379017_3543200,CM021105.1,6,29379017,326443169,5058544,3543200,329986369,329584763
29379017_3543214,CM021105.1,6,29379017,326443169,5058544,3543214,329986383,329584777
29379017_3543324,CM021105.1,6,29379017,326443169,5058544,3543324,329986493,329584887
29379017_3543330,CM021105.1,6,29379017,326443169,5058544,3543330,329986499,329584893
29379017_3549952,CM021105.1,6,29379017,326443169,5058544,3549952,329993121,329591515
29379017_3550174,CM021105.1,6,29379017,326443169,5058544,3550174,329993343,329591737
29379017_3550632,CM021105.1,6,29379017,326443169,5058544,3550632,329993801,329592195
29377768_3740487,CM021105.1,6,29377768,326438427,5081604,3740487,330178914,329777308
29379024_3774588,CM021105.1,6,29379024,326439312,5986474,3774588,330213900,329812294
29379024_3774615,CM021105.1,6,29379024,326439312,5986474,3774615,330213927,329812321
29379024_3774639,CM021105.1,6,29379024,326439312,5986474,3774639,330213951,329812345
29379024_3774689,CM021105.1,6,29379024,326439312,5986474,3774689,330214001,329812395
29379024_3779659,CM021105.1,6,29379024,326439312,5986474,3779659,330218971,329817365
29379024_3779667,CM021105.1,6,29379024,326439312,5986474,3779667,330218979,329817373
29379024_3779674,CM021105.1,6,29379024,326439312,5986474,3779674,330218986,329817380
29379024_3779739,CM021105.1,6,29379024,326439312,5986474,3779739,330219051,329817445
29379024_3779764,CM021105.1,6,29379024,326439312,5986474,3779764,330219076,329817470
29379024_3779796,CM021105.1,6,29379024,326439312,5986474,3779796,330219108,329817502
29379024_3779894,CM021105.1,6,29379024,326439312,5986474,3779894,330219206,329817600
29379024_3779988,CM021105.1,6,29379024,326439312,5986474,3779988,330219300,329817694
29379024_3779998,CM021105.1,6,29379024,326439312,5986474,3779998,330219310,329817704
29381967_3837355,CM021105.1,6,29381967,326439209,6564291,3837355,330276564,329874958
29381967_3837370,CM021105.1,6,29381967,326439209,6564291,3837370,330276579,329874973
29381967_3837374,CM021105.1,6,29381967,326439209,6564291,3837374,330276583,329874977
29377768_4091337,CM021105.1,6,29377768,326438427,5081604,4091337,330529764,330128158
29377768_4095449,CM021105.1,6,29377768,326438427,5081604,4095449,330533876,330132270
29377249_4109927,CM021105.1,6,29377249,326436407,5732523,4109927,330546334,330144728
29381967_4404084,CM021105.1,6,29381967,326439209,6564291,4404084,330843293,330441687
29377249_4453838,CM021105.1,6,29377249,326436407,5732523,4453838,330890245,330488639
29377249_4453868,CM021105.1,6,29377249,326436407,5732523,4453868,330890275,330488669
29377249_4453968,CM021105.1,6,29377249,326436407,5732523,4453968,330890375,330488769
29377249_4453975,CM021105.1,6,29377249,326436407,5732523,4453975,330890382,330488776
29377249_4454015,CM021105.1,6,29377249,326436407,5732523,4454015,330890422,330488816
29381967_4465974,CM021105.1,6,29381967,326439209,6564291,4465974,330905183,330503577
29381967_4466010,CM021105.1,6,29381967,326439209,6564291,4466010,330905219,330503613
29377249_4564672,CM021105.1,6,29377249,326436407,5732523,4564672,331001079,330599473
29377249_4564683,CM021105.1,6,29377249,326436407,5732523,4564683,331001090,330599484
29377249_4564706,CM021105.1,6,29377249,326436407,5732523,4564706,331001113,330599507
29379024_4613371,CM021105.1,6,29379024,326439312,5986474,4613371,331052683,330651077
29379024_4613476,CM021105.1,6,29379024,326439312,5986474,4613476,331052788,330651182
29379017_4690974,CM021105.1,6,29379017,326443169,5058544,4690974,331134143,330732537
29379017_4691029,CM021105.1,6,29379017,326443169,5058544,4691029,331134198,330732592
29379017_4691056,CM021105.1,6,29379017,326443169,5058544,4691056,331134225,330732619
29379017_4691264,CM021105.1,6,29379017,326443169,5058544,4691264,331134433,330732827
29379017_4691265,CM021105.1,6,29379017,326443169,5058544,4691265,331134434,330732828
29377249_4838466,CM021105.1,6,29377249,326436407,5732523,4838466,331274873,330873267
29377249_4838467,CM021105.1,6,29377249,326436407,5732523,4838467,331274874,330873268
29377249_4838508,CM021105.1,6,29377249,326436407,5732523,4838508,331274915,330873309
29377249_4884077,CM021105.1,6,29377249,326436407,5732523,4884077,331320484,330918878
29377249_4884078,CM021105.1,6,29377249,326436407,5732523,4884078,331320485,330918879
29377249_5342494,CM021105.1,6,29377249,326436407,5732523,5342494,331778901,331377295
29377249_5342556,CM021105.1,6,29377249,326436407,5732523,5342556,331778963,331377357
29377249_5343809,CM021105.1,6,29377249,326436407,5732523,5343809,331780216,331378610
29377249_5343814,CM021105.1,6,29377249,326436407,5732523,5343814,331780221,331378615
29379024_5365683,CM021105.1,6,29379024,326439312,5986474,5365683,331804995,331403389
29377249_5652767,CM021105.1,6,29377249,326436407,5732523,5652767,332089174,331687568
29377249_5652770,CM021105.1,6,29377249,326436407,5732523,5652770,332089177,331687571
29377249_5652785,CM021105.1,6,29377249,326436407,5732523,5652785,332089192,331687586
29377249_5652802,CM021105.1,6,29377249,326436407,5732523,5652802,332089209,331687603
29377249_5652812,CM021105.1,6,29377249,326436407,5732523,5652812,332089219,331687613
29377249_5652813,CM021105.1,6,29377249,326436407,5732523,5652813,332089220,331687614
29378735_6462007,CM021105.1,6,29378735,326429674,11537687,6462007,332891681,332490075
29378735_6462040,CM021105.1,6,29378735,326429674,11537687,6462040,332891714,332490108
29378735_6462103,CM021105.1,6,29378735,326429674,11537687,6462103,332891777,332490171
29378735_6612566,CM021105.1,6,29378735,326429674,11537687,6612566,333042240,332640634
29378735_6612645,CM021105.1,6,29378735,326429674,11537687,6612645,333042319,332640713
29378735_6612654,CM021105.1,6,29378735,326429674,11537687,6612654,333042328,332640722
29378735_6652952,CM021105.1,6,29378735,326429674,11537687,6652952,333082626,332681020
29378735_6654543,CM021105.1,6,29378735,326429674,11537687,6654543,333084217,332682611
29378735_6654570,CM021105.1,6,29378735,326429674,11537687,6654570,333084244,332682638
29378735_7046335,CM021105.1,6,29378735,326429674,11537687,7046335,333476009,333074403
29378735_7046385,CM021105.1,6,29378735,326429674,11537687,7046385,333476059,333074453
29378735_7046416,CM021105.1,6,29378735,326429674,11537687,7046416,333476090,333074484
29378735_7446727,CM021105.1,6,29378735,326429674,11537687,7446727,333876401,333474795
29378735_8158160,CM021105.1,6,29378735,326429674,11537687,8158160,334587834,334186228
29378735_8158275,CM021105.1,6,29378735,326429674,11537687,8158275,334587949,334186343
29378735_8158293,CM021105.1,6,29378735,326429674,11537687,8158293,334587967,334186361
29378735_8158325,CM021105.1,6,29378735,326429674,11537687,8158325,334587999,334186393
29378735_8271048,CM021105.1,6,29378735,326429674,11537687,8271048,334700722,334299116
29378735_9319601,CM021105.1,6,29378735,326429674,11537687,9319601,335749275,335347669
29378735_9348403,CM021105.1,6,29378735,326429674,11537687,9348403,335778077,335376471
29378735_10577921,CM021105.1,6,29378735,326429674,11537687,10577921,337007595,336605989
29378735_10577925,CM021105.1,6,29378735,326429674,11537687,10577925,337007599,336605993
29378735_10577929,CM021105.1,6,29378735,326429674,11537687,10577929,337007603,336605997
29378735_10577944,CM021105.1,6,29378735,326429674,11537687,10577944,337007618,336606012
29378735_10578285,CM021105.1,6,29378735,326429674,11537687,10578285,337007959,336606353
29378735_10581460,CM021105.1,6,29378735,326429674,11537687,10581460,337011134,336609528
29378735_10582269,CM021105.1,6,29378735,326429674,11537687,10582269,337011943,336610337
29378735_10582320,CM021105.1,6,29378735,326429674,11537687,10582320,337011994,336610388
29378735_10597805,CM021105.1,6,29378735,326429674,11537687,10597805,337027479,336625873
29378735_10726534,CM021105.1,6,29378735,326429674,11537687,10726534,337156208,336754602
29378735_10726550,CM021105.1,6,29378735,326429674,11537687,10726550,337156224,336754618
29378735_10930428,CM021105.1,6,29378735,326429674,11537687,10930428,337360102,336958496
29378735_10930434,CM021105.1,6,29378735,326429674,11537687,10930434,337360108,336958502
29378735_10930442,CM021105.1,6,29378735,326429674,11537687,10930442,337360116,336958510
29378735_11090633,CM021105.1,6,29378735,326429674,11537687,11090633,337520307,337118701
29378735_11090941,CM021105.1,6,29378735,326429674,11537687,11090941,337520615,337119009
29377413_1257,CM021105.1,6,29377413,355295009,521587,1257,355296266,354894660
29377413_1368,CM021105.1,6,29377413,355295009,521587,1368,355296377,354894771
29377413_1440,CM021105.1,6,29377413,355295009,521587,1440,355296449,354894843
29379281_8581,CM021105.1,6,29379281,355295013,826376,8581,355303594,354901988
29379281_9156,CM021105.1,6,29379281,355295013,826376,9156,355304169,354902563
29378111_69231,CM021105.1,6,29378111,355295009,2091621,69231,355364240,354962634
29378111_69247,CM021105.1,6,29378111,355295009,2091621,69247,355364256,354962650
29378111_69250,CM021105.1,6,29378111,355295009,2091621,69250,355364259,354962653
29378111_69256,CM021105.1,6,29378111,355295009,2091621,69256,355364265,354962659
29378111_69263,CM021105.1,6,29378111,355295009,2091621,69263,355364272,354962666
29378111_69282,CM021105.1,6,29378111,355295009,2091621,69282,355364291,354962685
29378111_69325,CM021105.1,6,29378111,355295009,2091621,69325,355364334,354962728
29378111_69358,CM021105.1,6,29378111,355295009,2091621,69358,355364367,354962761
29378111_69468,CM021105.1,6,29378111,355295009,2091621,69468,355364477,354962871
29380129_209111,CM021105.1,6,29380129,355295009,2167563,209111,355504120,355102514
29380129_209151,CM021105.1,6,29380129,355295009,2167563,209151,355504160,355102554
29378673_234893,CM021105.1,6,29378673,355295012,776513,234893,355529905,355128299
29378673_234894,CM021105.1,6,29378673,355295012,776513,234894,355529906,355128300
29380329_248889,CM021105.1,6,29380329,355295013,598478,248889,355543902,355142296
29380329_248934,CM021105.1,6,29380329,355295013,598478,248934,355543947,355142341
29380329_248946,CM021105.1,6,29380329,355295013,598478,248946,355543959,355142353
29380329_248976,CM021105.1,6,29380329,355295013,598478,248976,355543989,355142383
29378111_252153,CM021105.1,6,29378111,355295009,2091621,252153,355547162,355145556
29378111_252159,CM021105.1,6,29378111,355295009,2091621,252159,355547168,355145562
29378111_252171,CM021105.1,6,29378111,355295009,2091621,252171,355547180,355145574
29378111_252177,CM021105.1,6,29378111,355295009,2091621,252177,355547186,355145580
29378111_252216,CM021105.1,6,29378111,355295009,2091621,252216,355547225,355145619
29378111_252368,CM021105.1,6,29378111,355295009,2091621,252368,355547377,355145771
29381156_293636,CM021105.1,6,29381156,355295013,2473380,293636,355588649,355187043
29379198_304391,CM021105.1,6,29379198,355295013,1286715,304391,355599404,355197798
29379198_304482,CM021105.1,6,29379198,355295013,1286715,304482,355599495,355197889
29379198_304484,CM021105.1,6,29379198,355295013,1286715,304484,355599497,355197891
29379198_304508,CM021105.1,6,29379198,355295013,1286715,304508,355599521,355197915
29379198_304522,CM021105.1,6,29379198,355295013,1286715,304522,355599535,355197929
29379198_304557,CM021105.1,6,29379198,355295013,1286715,304557,355599570,355197964
29379916_310527,CM021105.1,6,29379916,355295013,3210080,310527,355605540,355203934
29379916_310546,CM021105.1,6,29379916,355295013,3210080,310546,355605559,355203953
29379916_310569,CM021105.1,6,29379916,355295013,3210080,310569,355605582,355203976
29379916_310586,CM021105.1,6,29379916,355295013,3210080,310586,355605599,355203993
29379916_310604,CM021105.1,6,29379916,355295013,3210080,310604,355605617,355204011
29379916_310618,CM021105.1,6,29379916,355295013,3210080,310618,355605631,355204025
29380129_349587,CM021105.1,6,29380129,355295009,2167563,349587,355644596,355242990
29380129_349638,CM021105.1,6,29380129,355295009,2167563,349638,355644647,355243041
29380129_349686,CM021105.1,6,29380129,355295009,2167563,349686,355644695,355243089
29380129_351051,CM021105.1,6,29380129,355295009,2167563,351051,355646060,355244454
29380129_351071,CM021105.1,6,29380129,355295009,2167563,351071,355646080,355244474
29380129_351105,CM021105.1,6,29380129,355295009,2167563,351105,355646114,355244508
29380129_352206,CM021105.1,6,29380129,355295009,2167563,352206,355647215,355245609
29380129_451906,CM021105.1,6,29380129,355295009,2167563,451906,355746915,355345309
29377762_546296,CM021105.1,6,29377762,355295013,1930172,546296,355841309,355439703
29377762_546343,CM021105.1,6,29377762,355295013,1930172,546343,355841356,355439750
29380824_648512,CM021105.1,6,29380824,355295013,3151949,648512,355943525,355541919
29379954_643284,CM021105.1,6,29379954,355301172,764306,643284,355944456,355542850
29377762_701351,CM021105.1,6,29377762,355295013,1930172,701351,355996364,355594758
29377762_701475,CM021105.1,6,29377762,355295013,1930172,701475,355996488,355594882
29377762_701511,CM021105.1,6,29377762,355295013,1930172,701511,355996524,355594918
29381156_898943,CM021105.1,6,29381156,355295013,2473380,898943,356193956,355792350
29381156_898974,CM021105.1,6,29381156,355295013,2473380,898974,356193987,355792381
29381156_899038,CM021105.1,6,29381156,355295013,2473380,899038,356194051,355792445
29377762_1002670,CM021105.1,6,29377762,355295013,1930172,1002670,356297683,355896077
29377762_1002676,CM021105.1,6,29377762,355295013,1930172,1002676,356297689,355896083
29377762_1002760,CM021105.1,6,29377762,355295013,1930172,1002760,356297773,355896167
29377762_1002771,CM021105.1,6,29377762,355295013,1930172,1002771,356297784,355896178
29377762_1002784,CM021105.1,6,29377762,355295013,1930172,1002784,356297797,355896191
29377762_1002798,CM021105.1,6,29377762,355295013,1930172,1002798,356297811,355896205
29380725_1015987,CM021105.1,6,29380725,355295002,2297054,1015987,356310989,355909383
29380725_1016052,CM021105.1,6,29380725,355295002,2297054,1016052,356311054,355909448
29380725_1016076,CM021105.1,6,29380725,355295002,2297054,1016076,356311078,355909472
29380725_1016880,CM021105.1,6,29380725,355295002,2297054,1016880,356311882,355910276
29380725_1017295,CM021105.1,6,29380725,355295002,2297054,1017295,356312297,355910691
29380725_1017333,CM021105.1,6,29380725,355295002,2297054,1017333,356312335,355910729
29380725_1017363,CM021105.1,6,29380725,355295002,2297054,1017363,356312365,355910759
29380725_1017364,CM021105.1,6,29380725,355295002,2297054,1017364,356312366,355910760
29380725_1017419,CM021105.1,6,29380725,355295002,2297054,1017419,356312421,355910815
29380163_1027469,CM021105.1,6,29380163,355295013,2147537,1027469,356322482,355920876
29380163_1027503,CM021105.1,6,29380163,355295013,2147537,1027503,356322516,355920910
29380163_1027531,CM021105.1,6,29380163,355295013,2147537,1027531,356322544,355920938
29377762_1093609,CM021105.1,6,29377762,355295013,1930172,1093609,356388622,355987016
29377762_1093700,CM021105.1,6,29377762,355295013,1930172,1093700,356388713,355987107
29377762_1093754,CM021105.1,6,29377762,355295013,1930172,1093754,356388767,355987161
29380725_1131605,CM021105.1,6,29380725,355295002,2297054,1131605,356426607,356025001
29380725_1131662,CM021105.1,6,29380725,355295002,2297054,1131662,356426664,356025058
29380725_1131717,CM021105.1,6,29380725,355295002,2297054,1131717,356426719,356025113
29381156_1159650,CM021105.1,6,29381156,355295013,2473380,1159650,356454663,356053057
29380192_1165902,CM021105.1,6,29380192,355295013,3251015,1165902,356460915,356059309
29381478_1171436,CM021105.1,6,29381478,355295013,2444086,1171436,356466449,356064843
29381478_1182433,CM021105.1,6,29381478,355295013,2444086,1182433,356477446,356075840
29381478_1182482,CM021105.1,6,29381478,355295013,2444086,1182482,356477495,356075889
29381478_1182510,CM021105.1,6,29381478,355295013,2444086,1182510,356477523,356075917
29381478_1182530,CM021105.1,6,29381478,355295013,2444086,1182530,356477543,356075937
29381478_1182539,CM021105.1,6,29381478,355295013,2444086,1182539,356477552,356075946
29377762_1206539,CM021105.1,6,29377762,355295013,1930172,1206539,356501552,356099946
29377762_1206572,CM021105.1,6,29377762,355295013,1930172,1206572,356501585,356099979
29377762_1206629,CM021105.1,6,29377762,355295013,1930172,1206629,356501642,356100036
29377762_1206742,CM021105.1,6,29377762,355295013,1930172,1206742,356501755,356100149
29377762_1223873,CM021105.1,6,29377762,355295013,1930172,1223873,356518886,356117280
29377762_1223914,CM021105.1,6,29377762,355295013,1930172,1223914,356518927,356117321
29377762_1223962,CM021105.1,6,29377762,355295013,1930172,1223962,356518975,356117369
29378522_1394449,CM021105.1,6,29378522,355295012,4086397,1394449,356689461,356287855
29378522_1394451,CM021105.1,6,29378522,355295012,4086397,1394451,356689463,356287857
29381478_1438488,CM021105.1,6,29381478,355295013,2444086,1438488,356733501,356331895
29381478_1438504,CM021105.1,6,29381478,355295013,2444086,1438504,356733517,356331911
29377482_1449838,CM021105.1,6,29377482,355297834,1898449,1449838,356747672,356346066
29381478_1467190,CM021105.1,6,29381478,355295013,2444086,1467190,356762203,356360597
29380129_1537424,CM021105.1,6,29380129,355295009,2167563,1537424,356832433,356430827
29381478_1566568,CM021105.1,6,29381478,355295013,2444086,1566568,356861581,356459975
29381478_1566675,CM021105.1,6,29381478,355295013,2444086,1566675,356861688,356460082
29382301_1571364,CM021105.1,6,29382301,355298425,3195311,1571364,356869789,356468183
29381478_1614733,CM021105.1,6,29381478,355295013,2444086,1614733,356909746,356508140
29381156_1672326,CM021105.1,6,29381156,355295013,2473380,1672326,356967339,356565733
29377482_1729039,CM021105.1,6,29377482,355297834,1898449,1729039,357026873,356625267
29377482_1729076,CM021105.1,6,29377482,355297834,1898449,1729076,357026910,356625304
29377482_1729117,CM021105.1,6,29377482,355297834,1898449,1729117,357026951,356625345
29382261_1755272,CM021105.1,6,29382261,355295013,4032213,1755272,357050285,356648679
29378111_1775275,CM021105.1,6,29378111,355295009,2091621,1775275,357070284,356668678
29378111_1775285,CM021105.1,6,29378111,355295009,2091621,1775285,357070294,356668688
29378111_1775302,CM021105.1,6,29378111,355295009,2091621,1775302,357070311,356668705
29378111_1775305,CM021105.1,6,29378111,355295009,2091621,1775305,357070314,356668708
29378111_1775323,CM021105.1,6,29378111,355295009,2091621,1775323,357070332,356668726
29380192_1822473,CM021105.1,6,29380192,355295013,3251015,1822473,357117486,356715880
29381478_1873783,CM021105.1,6,29381478,355295013,2444086,1873783,357168796,356767190
29381478_1873833,CM021105.1,6,29381478,355295013,2444086,1873833,357168846,356767240
29381478_1943408,CM021105.1,6,29381478,355295013,2444086,1943408,357238421,356836815
29380129_1982945,CM021105.1,6,29380129,355295009,2167563,1982945,357277954,356876348
29380129_1987409,CM021105.1,6,29380129,355295009,2167563,1987409,357282418,356880812
29380100_2002345,CM021105.1,6,29380100,355298139,2002963,2002345,357300484,356898878
29380100_2002398,CM021105.1,6,29380100,355298139,2002963,2002398,357300537,356898931
29380100_2002423,CM021105.1,6,29380100,355298139,2002963,2002423,357300562,356898956
29380129_2025890,CM021105.1,6,29380129,355295009,2167563,2025890,357320899,356919293
29381156_2098639,CM021105.1,6,29381156,355295013,2473380,2098639,357393652,356992046
29381156_2098747,CM021105.1,6,29381156,355295013,2473380,2098747,357393760,356992154
29381156_2098758,CM021105.1,6,29381156,355295013,2473380,2098758,357393771,356992165
29381156_2098837,CM021105.1,6,29381156,355295013,2473380,2098837,357393850,356992244
29381156_2098870,CM021105.1,6,29381156,355295013,2473380,2098870,357393883,356992277
29381156_2105972,CM021105.1,6,29381156,355295013,2473380,2105972,357400985,356999379
29382301_2108721,CM021105.1,6,29382301,355298425,3195311,2108721,357407146,357005540
29382301_2108731,CM021105.1,6,29382301,355298425,3195311,2108731,357407156,357005550
29382301_2109230,CM021105.1,6,29382301,355298425,3195311,2109230,357407655,357006049
29382301_2192533,CM021105.1,6,29382301,355298425,3195311,2192533,357490958,357089352
29382301_2192572,CM021105.1,6,29382301,355298425,3195311,2192572,357490997,357089391
29382301_2193075,CM021105.1,6,29382301,355298425,3195311,2193075,357491500,357089894
29382301_2193152,CM021105.1,6,29382301,355298425,3195311,2193152,357491577,357089971
29381478_2223977,CM021105.1,6,29381478,355295013,2444086,2223977,357518990,357117384
29381478_2223995,CM021105.1,6,29381478,355295013,2444086,2223995,357519008,357117402
29381478_2224006,CM021105.1,6,29381478,355295013,2444086,2224006,357519019,357117413
29381478_2224022,CM021105.1,6,29381478,355295013,2444086,2224022,357519035,357117429
29381478_2224082,CM021105.1,6,29381478,355295013,2444086,2224082,357519095,357117489
29381478_2224273,CM021105.1,6,29381478,355295013,2444086,2224273,357519286,357117680
29381478_2224289,CM021105.1,6,29381478,355295013,2444086,2224289,357519302,357117696
29381478_2224309,CM021105.1,6,29381478,355295013,2444086,2224309,357519322,357117716
29381478_2224354,CM021105.1,6,29381478,355295013,2444086,2224354,357519367,357117761
29377995_2368118,CM021105.1,6,29377995,355295013,4143800,2368118,357663131,357261525
29377995_2368212,CM021105.1,6,29377995,355295013,4143800,2368212,357663225,357261619
29378522_2405881,CM021105.1,6,29378522,355295012,4086397,2405881,357700893,357299287
29378522_2405909,CM021105.1,6,29378522,355295012,4086397,2405909,357700921,357299315
29382348_2444300,CM021105.1,6,29382348,355295013,6858292,2444300,357739313,357337707
29380824_2577958,CM021105.1,6,29380824,355295013,3151949,2577958,357872971,357471365
29380824_2578015,CM021105.1,6,29380824,355295013,3151949,2578015,357873028,357471422
29380824_2578144,CM021105.1,6,29380824,355295013,3151949,2578144,357873157,357471551
29380824_2598706,CM021105.1,6,29380824,355295013,3151949,2598706,357893719,357492113
29380824_2598932,CM021105.1,6,29380824,355295013,3151949,2598932,357893945,357492339
29380824_2599002,CM021105.1,6,29380824,355295013,3151949,2599002,357894015,357492409
29380824_2714695,CM021105.1,6,29380824,355295013,3151949,2714695,358009708,357608102
29378522_2760456,CM021105.1,6,29378522,355295012,4086397,2760456,358055468,357653862
29377995_2817559,CM021105.1,6,29377995,355295013,4143800,2817559,358112572,357710966
29377995_2817571,CM021105.1,6,29377995,355295013,4143800,2817571,358112584,357710978
29377995_2902438,CM021105.1,6,29377995,355295013,4143800,2902438,358197451,357795845
29377995_2902537,CM021105.1,6,29377995,355295013,4143800,2902537,358197550,357795944
29382301_2905245,CM021105.1,6,29382301,355298425,3195311,2905245,358203670,357802064
29382301_2905311,CM021105.1,6,29382301,355298425,3195311,2905311,358203736,357802130
29378522_2910350,CM021105.1,6,29378522,355295012,4086397,2910350,358205362,357803756
29378522_2910365,CM021105.1,6,29378522,355295012,4086397,2910365,358205377,357803771
29378522_2910666,CM021105.1,6,29378522,355295012,4086397,2910666,358205678,357804072
29380824_2911131,CM021105.1,6,29380824,355295013,3151949,2911131,358206144,357804538
29380824_2911152,CM021105.1,6,29380824,355295013,3151949,2911152,358206165,357804559
29380824_2911196,CM021105.1,6,29380824,355295013,3151949,2911196,358206209,357804603
29380824_2911225,CM021105.1,6,29380824,355295013,3151949,2911225,358206238,357804632
29380824_2911270,CM021105.1,6,29380824,355295013,3151949,2911270,358206283,357804677
29380824_2911273,CM021105.1,6,29380824,355295013,3151949,2911273,358206286,357804680
29380824_2911343,CM021105.1,6,29380824,355295013,3151949,2911343,358206356,357804750
29380824_2911344,CM021105.1,6,29380824,355295013,3151949,2911344,358206357,357804751
29382301_2911350,CM021105.1,6,29382301,355298425,3195311,2911350,358209775,357808169
29382301_2911351,CM021105.1,6,29382301,355298425,3195311,2911351,358209776,357808170
29382301_2911380,CM021105.1,6,29382301,355298425,3195311,2911380,358209805,357808199
29382301_2911411,CM021105.1,6,29382301,355298425,3195311,2911411,358209836,357808230
29382301_2911455,CM021105.1,6,29382301,355298425,3195311,2911455,358209880,357808274
29382301_2911506,CM021105.1,6,29382301,355298425,3195311,2911506,358209931,357808325
29382301_2911529,CM021105.1,6,29382301,355298425,3195311,2911529,358209954,357808348
29382261_2943228,CM021105.1,6,29382261,355295013,4032213,2943228,358238241,357836635
29382301_2948487,CM021105.1,6,29382301,355298425,3195311,2948487,358246912,357845306
29382301_2948546,CM021105.1,6,29382301,355298425,3195311,2948546,358246971,357845365
29379916_3205328,CM021105.1,6,29379916,355295013,3210080,3205328,358500341,358098735
29379916_3205400,CM021105.1,6,29379916,355295013,3210080,3205400,358500413,358098807
29379916_3205432,CM021105.1,6,29379916,355295013,3210080,3205432,358500445,358098839
29379916_3205433,CM021105.1,6,29379916,355295013,3210080,3205433,358500446,358098840
29382261_3495433,CM021105.1,6,29382261,355295013,4032213,3495433,358790446,358388840
29378522_3623889,CM021105.1,6,29378522,355295012,4086397,3623889,358918901,358517295
29378522_3626501,CM021105.1,6,29378522,355295012,4086397,3626501,358921513,358519907
29378522_3735951,CM021105.1,6,29378522,355295012,4086397,3735951,359030963,358629357
29378522_3735974,CM021105.1,6,29378522,355295012,4086397,3735974,359030986,358629380
29378522_3735994,CM021105.1,6,29378522,355295012,4086397,3735994,359031006,358629400
29378522_3737912,CM021105.1,6,29378522,355295012,4086397,3737912,359032924,358631318
29377995_3923129,CM021105.1,6,29377995,355295013,4143800,3923129,359218142,358816536
29377995_3923144,CM021105.1,6,29377995,355295013,4143800,3923144,359218157,358816551
29378522_4083105,CM021105.1,6,29378522,355295012,4086397,4083105,359378117,358976511
29378522_4083136,CM021105.1,6,29378522,355295012,4086397,4083136,359378148,358976542
29378522_4085482,CM021105.1,6,29378522,355295012,4086397,4085482,359380494,358978888
29378522_4085517,CM021105.1,6,29378522,355295012,4086397,4085517,359380529,358978923
29343746_1392,CM021105.1,6,29343746,363690113,74933,1392,363691505,363289899
29343746_19067,CM021105.1,6,29343746,363690113,74933,19067,363709180,363307574
29378290_19537,CM021105.1,6,29378290,363699505,853013,19537,363719042,363317436
29380436_31480,CM021105.1,6,29380436,363690113,287443,31480,363721593,363319987
29381039_23855,CM021105.1,6,29381039,363699316,618137,23855,363723171,363321565
29381039_24329,CM021105.1,6,29381039,363699316,618137,24329,363723645,363322039
29381039_24342,CM021105.1,6,29381039,363699316,618137,24342,363723658,363322052
29381039_24356,CM021105.1,6,29381039,363699316,618137,24356,363723672,363322066
29376107_41237,CM021105.1,6,29376107,363698316,580235,41237,363739553,363337947
29381867_76443,CM021105.1,6,29381867,363693042,697480,76443,363769485,363367879
29378699_82466,CM021105.1,6,29378699,363698047,5765764,82466,363780513,363378907
29378290_91141,CM021105.1,6,29378290,363699505,853013,91141,363790646,363389040
29378290_97666,CM021105.1,6,29378290,363699505,853013,97666,363797171,363395565
29352513_118119,CM021105.1,6,29352513,363690112,420620,118119,363808231,363406625
29352513_118202,CM021105.1,6,29352513,363690112,420620,118202,363808314,363406708
29380569_133360,CM021105.1,6,29380569,363690112,3380187,133360,363823472,363421866
29380569_133384,CM021105.1,6,29380569,363690112,3380187,133384,363823496,363421890
29378194_139377,CM021105.1,6,29378194,363690112,2872916,139377,363829489,363427883
29378194_139446,CM021105.1,6,29378194,363690112,2872916,139446,363829558,363427952
29380057_130354,CM021105.1,6,29380057,363701531,132990,130354,363831885,363430279
29380057_130374,CM021105.1,6,29380057,363701531,132990,130374,363831905,363430299
29380057_130384,CM021105.1,6,29380057,363701531,132990,130384,363831915,363430309
29380057_130385,CM021105.1,6,29380057,363701531,132990,130385,363831916,363430310
29380057_130396,CM021105.1,6,29380057,363701531,132990,130396,363831927,363430321
29380057_130432,CM021105.1,6,29380057,363701531,132990,130432,363831963,363430357
29380057_130434,CM021105.1,6,29380057,363701531,132990,130434,363831965,363430359
29380057_130440,CM021105.1,6,29380057,363701531,132990,130440,363831971,363430365
29380057_130445,CM021105.1,6,29380057,363701531,132990,130445,363831976,363430370
29380057_130455,CM021105.1,6,29380057,363701531,132990,130455,363831986,363430380
29380057_130463,CM021105.1,6,29380057,363701531,132990,130463,363831994,363430388
29380057_130467,CM021105.1,6,29380057,363701531,132990,130467,363831998,363430392
29380057_130522,CM021105.1,6,29380057,363701531,132990,130522,363832053,363430447
29380057_130524,CM021105.1,6,29380057,363701531,132990,130524,363832055,363430449
29378962_143850,CM021105.1,6,29378962,363699802,760907,143850,363843652,363442046
29377194_150691,CM021105.1,6,29377194,363695010,4053103,150691,363845701,363444095
29377194_150692,CM021105.1,6,29377194,363695010,4053103,150692,363845702,363444096
29377194_150702,CM021105.1,6,29377194,363695010,4053103,150702,363845712,363444106
29377194_150713,CM021105.1,6,29377194,363695010,4053103,150713,363845723,363444117
29377194_150793,CM021105.1,6,29377194,363695010,4053103,150793,363845803,363444197
29377194_150875,CM021105.1,6,29377194,363695010,4053103,150875,363845885,363444279
29377194_150903,CM021105.1,6,29377194,363695010,4053103,150903,363845913,363444307
29377194_150934,CM021105.1,6,29377194,363695010,4053103,150934,363845944,363444338
29377194_150940,CM021105.1,6,29377194,363695010,4053103,150940,363845950,363444344
29377194_150961,CM021105.1,6,29377194,363695010,4053103,150961,363845971,363444365
29380839_151692,CM021105.1,6,29380839,363698541,1987989,151692,363850233,363448627
29380839_151795,CM021105.1,6,29380839,363698541,1987989,151795,363850336,363448730
29380569_160540,CM021105.1,6,29380569,363690112,3380187,160540,363850652,363449046
29380569_160589,CM021105.1,6,29380569,363690112,3380187,160589,363850701,363449095
29380839_152334,CM021105.1,6,29380839,363698541,1987989,152334,363850875,363449269
29380839_152463,CM021105.1,6,29380839,363698541,1987989,152463,363851004,363449398
29378194_196591,CM021105.1,6,29378194,363690112,2872916,196591,363886703,363485097
29378962_231676,CM021105.1,6,29378962,363699802,760907,231676,363931478,363529872
29381155_246949,CM021105.1,6,29381155,363698278,1841146,246949,363945227,363543621
29381039_252086,CM021105.1,6,29381039,363699316,618137,252086,363951402,363549796
29381039_252118,CM021105.1,6,29381039,363699316,618137,252118,363951434,363549828
29379996_254003,CM021105.1,6,29379996,363697693,7408375,254003,363951696,363550090
29379996_254060,CM021105.1,6,29379996,363697693,7408375,254060,363951753,363550147
29379996_254083,CM021105.1,6,29379996,363697693,7408375,254083,363951776,363550170
29380436_265160,CM021105.1,6,29380436,363690113,287443,265160,363955273,363553667
29380436_265203,CM021105.1,6,29380436,363690113,287443,265203,363955316,363553710
29380436_265217,CM021105.1,6,29380436,363690113,287443,265217,363955330,363553724
29380436_265234,CM021105.1,6,29380436,363690113,287443,265234,363955347,363553741
29380839_261439,CM021105.1,6,29380839,363698541,1987989,261439,363959980,363558374
29380839_261511,CM021105.1,6,29380839,363698541,1987989,261511,363960052,363558446
29380839_261526,CM021105.1,6,29380839,363698541,1987989,261526,363960067,363558461
29380839_261528,CM021105.1,6,29380839,363698541,1987989,261528,363960069,363558463
29380839_261538,CM021105.1,6,29380839,363698541,1987989,261538,363960079,363558473
29381155_264357,CM021105.1,6,29381155,363698278,1841146,264357,363962635,363561029
29381155_264448,CM021105.1,6,29381155,363698278,1841146,264448,363962726,363561120
29381155_264459,CM021105.1,6,29381155,363698278,1841146,264459,363962737,363561131
29379609_308341,CM021105.1,6,29379609,363690112,4111262,308341,363998453,363596847
29379609_308377,CM021105.1,6,29379609,363690112,4111262,308377,363998489,363596883
29379609_308415,CM021105.1,6,29379609,363690112,4111262,308415,363998527,363596921
29379609_308446,CM021105.1,6,29379609,363690112,4111262,308446,363998558,363596952
29379356_350679,CM021105.1,6,29379356,363697968,3993433,350679,364048647,363647041
29379609_373694,CM021105.1,6,29379609,363690112,4111262,373694,364063806,363662200
29379609_373707,CM021105.1,6,29379609,363690112,4111262,373707,364063819,363662213
29379609_373740,CM021105.1,6,29379609,363690112,4111262,373740,364063852,363662246
29381056_382979,CM021105.1,6,29381056,363698808,1564148,382979,364081787,363680181
29381056_382986,CM021105.1,6,29381056,363698808,1564148,382986,364081794,363680188
29381056_382997,CM021105.1,6,29381056,363698808,1564148,382997,364081805,363680199
29381056_383053,CM021105.1,6,29381056,363698808,1564148,383053,364081861,363680255
29381056_383056,CM021105.1,6,29381056,363698808,1564148,383056,364081864,363680258
29381056_383067,CM021105.1,6,29381056,363698808,1564148,383067,364081875,363680269
29381056_383069,CM021105.1,6,29381056,363698808,1564148,383069,364081877,363680271
29381056_383075,CM021105.1,6,29381056,363698808,1564148,383075,364081883,363680277
29381056_383076,CM021105.1,6,29381056,363698808,1564148,383076,364081884,363680278
29381056_383089,CM021105.1,6,29381056,363698808,1564148,383089,364081897,363680291
29381056_383104,CM021105.1,6,29381056,363698808,1564148,383104,364081912,363680306
29381056_383105,CM021105.1,6,29381056,363698808,1564148,383105,364081913,363680307
29381056_383126,CM021105.1,6,29381056,363698808,1564148,383126,364081934,363680328
29381056_383138,CM021105.1,6,29381056,363698808,1564148,383138,364081946,363680340
29379013_402155,CM021105.1,6,29379013,363697933,3496801,402155,364100088,363698482
29379013_402206,CM021105.1,6,29379013,363697933,3496801,402206,364100139,363698533
29379013_402725,CM021105.1,6,29379013,363697933,3496801,402725,364100658,363699052
29379013_402727,CM021105.1,6,29379013,363697933,3496801,402727,364100660,363699054
29380196_416529,CM021105.1,6,29380196,363698241,2216889,416529,364114770,363713164
29380569_447441,CM021105.1,6,29380569,363690112,3380187,447441,364137553,363735947
29381466_479230,CM021105.1,6,29381466,363690113,2015776,479230,364169343,363767737
29381466_479264,CM021105.1,6,29381466,363690113,2015776,479264,364169377,363767771
29378699_472021,CM021105.1,6,29378699,363698047,5765764,472021,364170068,363768462
29378290_535201,CM021105.1,6,29378290,363699505,853013,535201,364234706,363833100
29380288_537680,CM021105.1,6,29380288,363702968,615716,537680,364240648,363839042
29380288_537782,CM021105.1,6,29380288,363702968,615716,537782,364240750,363839144
29380288_537817,CM021105.1,6,29380288,363702968,615716,537817,364240785,363839179
29380288_537845,CM021105.1,6,29380288,363702968,615716,537845,364240813,363839207
29380822_571050,CM021105.1,6,29380822,363699032,1573166,571050,364270082,363868476
29380822_571091,CM021105.1,6,29380822,363699032,1573166,571091,364270123,363868517
29377380_602323,CM021105.1,6,29377380,363690113,1428414,602323,364292436,363890830
29378290_607944,CM021105.1,6,29378290,363699505,853013,607944,364307449,363905843
29378290_608040,CM021105.1,6,29378290,363699505,853013,608040,364307545,363905939
29378290_608059,CM021105.1,6,29378290,363699505,853013,608059,364307564,363905958
29378290_608092,CM021105.1,6,29378290,363699505,853013,608092,364307597,363905991
29378898_645939,CM021105.1,6,29378898,363700744,779601,645939,364346683,363945077
29378898_645981,CM021105.1,6,29378898,363700744,779601,645981,364346725,363945119
29380822_648079,CM021105.1,6,29380822,363699032,1573166,648079,364347111,363945505
29380822_648105,CM021105.1,6,29380822,363699032,1573166,648105,364347137,363945531
29380822_648110,CM021105.1,6,29380822,363699032,1573166,648110,364347142,363945536
29380822_648111,CM021105.1,6,29380822,363699032,1573166,648111,364347143,363945537
29380822_648137,CM021105.1,6,29380822,363699032,1573166,648137,364347169,363945563
29380822_648156,CM021105.1,6,29380822,363699032,1573166,648156,364347188,363945582
29380822_648158,CM021105.1,6,29380822,363699032,1573166,648158,364347190,363945584
29380822_648192,CM021105.1,6,29380822,363699032,1573166,648192,364347224,363945618
29380822_648202,CM021105.1,6,29380822,363699032,1573166,648202,364347234,363945628
29380822_648213,CM021105.1,6,29380822,363699032,1573166,648213,364347245,363945639
29380822_648217,CM021105.1,6,29380822,363699032,1573166,648217,364347249,363945643
29380822_648225,CM021105.1,6,29380822,363699032,1573166,648225,364347257,363945651
29380822_648234,CM021105.1,6,29380822,363699032,1573166,648234,364347266,363945660
29380822_648238,CM021105.1,6,29380822,363699032,1573166,648238,364347270,363945664
29380822_648250,CM021105.1,6,29380822,363699032,1573166,648250,364347282,363945676
29380822_648252,CM021105.1,6,29380822,363699032,1573166,648252,364347284,363945678
29378962_674732,CM021105.1,6,29378962,363699802,760907,674732,364374534,363972928
29378590_714021,CM021105.1,6,29378590,363690110,5148795,714021,364404131,364002525
29377730_729341,CM021105.1,6,29377730,363690112,2416212,729341,364419453,364017847
29378898_770886,CM021105.1,6,29378898,363700744,779601,770886,364471630,364070024
29378898_771014,CM021105.1,6,29378898,363700744,779601,771014,364471758,364070152
29379996_833378,CM021105.1,6,29379996,363697693,7408375,833378,364531071,364129465
29382469_850070,CM021105.1,6,29382469,363690111,1382004,850070,364540181,364138575
29382469_850083,CM021105.1,6,29382469,363690111,1382004,850083,364540194,364138588
29382469_850088,CM021105.1,6,29382469,363690111,1382004,850088,364540199,364138593
29382469_850091,CM021105.1,6,29382469,363690111,1382004,850091,364540202,364138596
29382469_850118,CM021105.1,6,29382469,363690111,1382004,850118,364540229,364138623
29382469_850131,CM021105.1,6,29382469,363690111,1382004,850131,364540242,364138636
29382469_850132,CM021105.1,6,29382469,363690111,1382004,850132,364540243,364138637
29382469_850155,CM021105.1,6,29382469,363690111,1382004,850155,364540266,364138660
29382469_850166,CM021105.1,6,29382469,363690111,1382004,850166,364540277,364138671
29379996_901856,CM021105.1,6,29379996,363697693,7408375,901856,364599549,364197943
29381466_920960,CM021105.1,6,29381466,363690113,2015776,920960,364611073,364209467
29381466_921076,CM021105.1,6,29381466,363690113,2015776,921076,364611189,364209583
29382141_922744,CM021105.1,6,29382141,363690113,2462319,922744,364612857,364211251
29382141_923259,CM021105.1,6,29382141,363690113,2462319,923259,364613372,364211766
29382141_926540,CM021105.1,6,29382141,363690113,2462319,926540,364616653,364215047
29382141_926562,CM021105.1,6,29382141,363690113,2462319,926562,364616675,364215069
29382141_926583,CM021105.1,6,29382141,363690113,2462319,926583,364616696,364215090
29382141_926979,CM021105.1,6,29382141,363690113,2462319,926979,364617092,364215486
29382141_926984,CM021105.1,6,29382141,363690113,2462319,926984,364617097,364215491
29382141_927008,CM021105.1,6,29382141,363690113,2462319,927008,364617121,364215515
29382141_927025,CM021105.1,6,29382141,363690113,2462319,927025,364617138,364215532
29382141_927071,CM021105.1,6,29382141,363690113,2462319,927071,364617184,364215578
29382141_927124,CM021105.1,6,29382141,363690113,2462319,927124,364617237,364215631
29379996_920481,CM021105.1,6,29379996,363697693,7408375,920481,364618174,364216568
29379996_920572,CM021105.1,6,29379996,363697693,7408375,920572,364618265,364216659
29380569_945464,CM021105.1,6,29380569,363690112,3380187,945464,364635576,364233970
29382141_950668,CM021105.1,6,29382141,363690113,2462319,950668,364640781,364239175
29382141_950706,CM021105.1,6,29382141,363690113,2462319,950706,364640819,364239213
29382141_950719,CM021105.1,6,29382141,363690113,2462319,950719,364640832,364239226
29382141_950727,CM021105.1,6,29382141,363690113,2462319,950727,364640840,364239234
29382141_950728,CM021105.1,6,29382141,363690113,2462319,950728,364640841,364239235
29382141_950897,CM021105.1,6,29382141,363690113,2462319,950897,364641010,364239404
29382141_950899,CM021105.1,6,29382141,363690113,2462319,950899,364641012,364239406
29377279_997304,CM021105.1,6,29377279,363697495,1056798,997304,364694799,364293193
29377730_1054270,CM021105.1,6,29377730,363690112,2416212,1054270,364744382,364342776
29379996_1048922,CM021105.1,6,29379996,363697693,7408375,1048922,364746615,364345009
29379996_1048958,CM021105.1,6,29379996,363697693,7408375,1048958,364746651,364345045
29379996_1049080,CM021105.1,6,29379996,363697693,7408375,1049080,364746773,364345167
29381466_1070900,CM021105.1,6,29381466,363690113,2015776,1070900,364761013,364359407
29381466_1070961,CM021105.1,6,29381466,363690113,2015776,1070961,364761074,364359468
29381466_1073223,CM021105.1,6,29381466,363690113,2015776,1073223,364763336,364361730
29382104_1063726,CM021105.1,6,29382104,363700072,1646082,1063726,364763798,364362192
29382104_1063739,CM021105.1,6,29382104,363700072,1646082,1063739,364763811,364362205
29378590_1109063,CM021105.1,6,29378590,363690110,5148795,1109063,364799173,364397567
29378590_1112652,CM021105.1,6,29378590,363690110,5148795,1112652,364802762,364401156
29378590_1112687,CM021105.1,6,29378590,363690110,5148795,1112687,364802797,364401191
29378699_1128379,CM021105.1,6,29378699,363698047,5765764,1128379,364826426,364424820
29378699_1155430,CM021105.1,6,29378699,363698047,5765764,1155430,364853477,364451871
29378699_1155459,CM021105.1,6,29378699,363698047,5765764,1155459,364853506,364451900
29378699_1155492,CM021105.1,6,29378699,363698047,5765764,1155492,364853539,364451933
29378699_1155565,CM021105.1,6,29378699,363698047,5765764,1155565,364853612,364452006
29380196_1227954,CM021105.1,6,29380196,363698241,2216889,1227954,364926195,364524589
29380196_1228008,CM021105.1,6,29380196,363698241,2216889,1228008,364926249,364524643
29380196_1228039,CM021105.1,6,29380196,363698241,2216889,1228039,364926280,364524674
29380196_1228046,CM021105.1,6,29380196,363698241,2216889,1228046,364926287,364524681
29382141_1286760,CM021105.1,6,29382141,363690113,2462319,1286760,364976873,364575267
29382469_1363579,CM021105.1,6,29382469,363690111,1382004,1363579,365053690,364652084
29379793_1399571,CM021105.1,6,29379793,363691768,1872672,1399571,365091339,364689733
29379793_1401628,CM021105.1,6,29379793,363691768,1872672,1401628,365093396,364691790
29379793_1401640,CM021105.1,6,29379793,363691768,1872672,1401640,365093408,364691802
29379793_1401649,CM021105.1,6,29379793,363691768,1872672,1401649,365093417,364691811
29379996_1401905,CM021105.1,6,29379996,363697693,7408375,1401905,365099598,364697992
29379996_1401987,CM021105.1,6,29379996,363697693,7408375,1401987,365099680,364698074
29379356_1407554,CM021105.1,6,29379356,363697968,3993433,1407554,365105522,364703916
29379356_1407581,CM021105.1,6,29379356,363697968,3993433,1407581,365105549,364703943
29379356_1409354,CM021105.1,6,29379356,363697968,3993433,1409354,365107322,364705716
29379356_1409436,CM021105.1,6,29379356,363697968,3993433,1409436,365107404,364705798
29381466_1440212,CM021105.1,6,29381466,363690113,2015776,1440212,365130325,364728719
29381466_1440216,CM021105.1,6,29381466,363690113,2015776,1440216,365130329,364728723
29381466_1440219,CM021105.1,6,29381466,363690113,2015776,1440219,365130332,364728726
29381466_1440234,CM021105.1,6,29381466,363690113,2015776,1440234,365130347,364728741
29381466_1440242,CM021105.1,6,29381466,363690113,2015776,1440242,365130355,364728749
29381466_1440243,CM021105.1,6,29381466,363690113,2015776,1440243,365130356,364728750
29381466_1440303,CM021105.1,6,29381466,363690113,2015776,1440303,365130416,364728810
29381466_1440305,CM021105.1,6,29381466,363690113,2015776,1440305,365130418,364728812
29381466_1440316,CM021105.1,6,29381466,363690113,2015776,1440316,365130429,364728823
29381466_1440391,CM021105.1,6,29381466,363690113,2015776,1440391,365130504,364728898
29381466_1440392,CM021105.1,6,29381466,363690113,2015776,1440392,365130505,364728899
29381466_1440416,CM021105.1,6,29381466,363690113,2015776,1440416,365130529,364728923
29381466_1440438,CM021105.1,6,29381466,363690113,2015776,1440438,365130551,364728945
29379793_1444206,CM021105.1,6,29379793,363691768,1872672,1444206,365135974,364734368
29379793_1444317,CM021105.1,6,29379793,363691768,1872672,1444317,365136085,364734479
29379356_1440144,CM021105.1,6,29379356,363697968,3993433,1440144,365138112,364736506
29379356_1440224,CM021105.1,6,29379356,363697968,3993433,1440224,365138192,364736586
29379356_1440244,CM021105.1,6,29379356,363697968,3993433,1440244,365138212,364736606
29379356_1440255,CM021105.1,6,29379356,363697968,3993433,1440255,365138223,364736617
29379793_1447649,CM021105.1,6,29379793,363691768,1872672,1447649,365139417,364737811
29379996_1535138,CM021105.1,6,29379996,363697693,7408375,1535138,365232831,364831225
29378590_1591896,CM021105.1,6,29378590,363690110,5148795,1591896,365282006,364880400
29378590_1592258,CM021105.1,6,29378590,363690110,5148795,1592258,365282368,364880762
29378590_1592362,CM021105.1,6,29378590,363690110,5148795,1592362,365282472,364880866
29381367_1587305,CM021105.1,6,29381367,363697535,1966660,1587305,365284840,364883234
29377056_1585747,CM021105.1,6,29377056,363700603,1917104,1585747,365286350,364884744
29378699_1605280,CM021105.1,6,29378699,363698047,5765764,1605280,365303327,364901721
29378699_1605289,CM021105.1,6,29378699,363698047,5765764,1605289,365303336,364901730
29378699_1605333,CM021105.1,6,29378699,363698047,5765764,1605333,365303380,364901774
29381367_1629319,CM021105.1,6,29381367,363697535,1966660,1629319,365326854,364925248
29381367_1629321,CM021105.1,6,29381367,363697535,1966660,1629321,365326856,364925250
29378699_1630935,CM021105.1,6,29378699,363698047,5765764,1630935,365328982,364927376
29378699_1631992,CM021105.1,6,29378699,363698047,5765764,1631992,365330039,364928433
29378699_1632089,CM021105.1,6,29378699,363698047,5765764,1632089,365330136,364928530
29378699_1632131,CM021105.1,6,29378699,363698047,5765764,1632131,365330178,364928572
29377998_1642052,CM021105.1,6,29377998,363690112,4415855,1642052,365332164,364930558
29378699_1635377,CM021105.1,6,29378699,363698047,5765764,1635377,365333424,364931818
29378699_1635406,CM021105.1,6,29378699,363698047,5765764,1635406,365333453,364931847
29379609_1648853,CM021105.1,6,29379609,363690112,4111262,1648853,365338965,364937359
29378699_1652160,CM021105.1,6,29378699,363698047,5765764,1652160,365350207,364948601
29378699_1652278,CM021105.1,6,29378699,363698047,5765764,1652278,365350325,364948719
29378699_1654283,CM021105.1,6,29378699,363698047,5765764,1654283,365352330,364950724
29378699_1654312,CM021105.1,6,29378699,363698047,5765764,1654312,365352359,364950753
29378590_1693780,CM021105.1,6,29378590,363690110,5148795,1693780,365383890,364982284
29378590_1693825,CM021105.1,6,29378590,363690110,5148795,1693825,365383935,364982329
29378590_1693828,CM021105.1,6,29378590,363690110,5148795,1693828,365383938,364982332
29378590_1694180,CM021105.1,6,29378590,363690110,5148795,1694180,365384290,364982684
29381367_1857869,CM021105.1,6,29381367,363697535,1966660,1857869,365555404,365153798
29380839_1861173,CM021105.1,6,29380839,363698541,1987989,1861173,365559714,365158108
29380839_1863977,CM021105.1,6,29380839,363698541,1987989,1863977,365562518,365160912
29380839_1864174,CM021105.1,6,29380839,363698541,1987989,1864174,365562715,365161109
29379996_1914543,CM021105.1,6,29379996,363697693,7408375,1914543,365612236,365210630
29379996_1914559,CM021105.1,6,29379996,363697693,7408375,1914559,365612252,365210646
29378590_1924467,CM021105.1,6,29378590,363690110,5148795,1924467,365614577,365212971
29378590_1924522,CM021105.1,6,29378590,363690110,5148795,1924522,365614632,365213026
29378590_1941900,CM021105.1,6,29378590,363690110,5148795,1941900,365632010,365230404
29377194_1937641,CM021105.1,6,29377194,363695010,4053103,1937641,365632651,365231045
29377194_1937646,CM021105.1,6,29377194,363695010,4053103,1937646,365632656,365231050
29377194_1937727,CM021105.1,6,29377194,363695010,4053103,1937727,365632737,365231131
29377194_1937751,CM021105.1,6,29377194,363695010,4053103,1937751,365632761,365231155
29382141_1954990,CM021105.1,6,29382141,363690113,2462319,1954990,365645103,365243497
29382141_1955027,CM021105.1,6,29382141,363690113,2462319,1955027,365645140,365243534
29382141_1955035,CM021105.1,6,29382141,363690113,2462319,1955035,365645148,365243542
29382141_1955229,CM021105.1,6,29382141,363690113,2462319,1955229,365645342,365243736
29382141_1955240,CM021105.1,6,29382141,363690113,2462319,1955240,365645353,365243747
29382141_1955316,CM021105.1,6,29382141,363690113,2462319,1955316,365645429,365243823
29382141_1955385,CM021105.1,6,29382141,363690113,2462319,1955385,365645498,365243892
29382141_1955409,CM021105.1,6,29382141,363690113,2462319,1955409,365645522,365243916
29382141_1955411,CM021105.1,6,29382141,363690113,2462319,1955411,365645524,365243918
29382141_1955426,CM021105.1,6,29382141,363690113,2462319,1955426,365645539,365243933
29380196_1958553,CM021105.1,6,29380196,363698241,2216889,1958553,365656794,365255188
29380196_1958587,CM021105.1,6,29380196,363698241,2216889,1958587,365656828,365255222
29378590_1980325,CM021105.1,6,29378590,363690110,5148795,1980325,365670435,365268829
29378590_1981407,CM021105.1,6,29378590,363690110,5148795,1981407,365671517,365269911
29378590_1981453,CM021105.1,6,29378590,363690110,5148795,1981453,365671563,365269957
29378590_1981456,CM021105.1,6,29378590,363690110,5148795,1981456,365671566,365269960
29380196_1979293,CM021105.1,6,29380196,363698241,2216889,1979293,365677534,365275928
29380196_1979320,CM021105.1,6,29380196,363698241,2216889,1979320,365677561,365275955
29380196_1979412,CM021105.1,6,29380196,363698241,2216889,1979412,365677653,365276047
29380196_1979908,CM021105.1,6,29380196,363698241,2216889,1979908,365678149,365276543
29378590_1998963,CM021105.1,6,29378590,363690110,5148795,1998963,365689073,365287467
29378590_1998983,CM021105.1,6,29378590,363690110,5148795,1998983,365689093,365287487
29378590_1999043,CM021105.1,6,29378590,363690110,5148795,1999043,365689153,365287547
29380196_1990949,CM021105.1,6,29380196,363698241,2216889,1990949,365689190,365287584
29380196_1992225,CM021105.1,6,29380196,363698241,2216889,1992225,365690466,365288860
29378590_2044565,CM021105.1,6,29378590,363690110,5148795,2044565,365734675,365333069
29378590_2044751,CM021105.1,6,29378590,363690110,5148795,2044751,365734861,365333255
29378590_2044791,CM021105.1,6,29378590,363690110,5148795,2044791,365734901,365333295
29379013_2052159,CM021105.1,6,29379013,363697933,3496801,2052159,365750092,365348486
29379013_2052181,CM021105.1,6,29379013,363697933,3496801,2052181,365750114,365348508
29379013_2052637,CM021105.1,6,29379013,363697933,3496801,2052637,365750570,365348964
29378590_2068866,CM021105.1,6,29378590,363690110,5148795,2068866,365758976,365357370
29378590_2087162,CM021105.1,6,29378590,363690110,5148795,2087162,365777272,365375666
29378590_2088875,CM021105.1,6,29378590,363690110,5148795,2088875,365778985,365377379
29378590_2088952,CM021105.1,6,29378590,363690110,5148795,2088952,365779062,365377456
29378590_2088955,CM021105.1,6,29378590,363690110,5148795,2088955,365779065,365377459
29378590_2089695,CM021105.1,6,29378590,363690110,5148795,2089695,365779805,365378199
29378590_2089708,CM021105.1,6,29378590,363690110,5148795,2089708,365779818,365378212
29379996_2132687,CM021105.1,6,29379996,363697693,7408375,2132687,365830380,365428774
29379996_2139445,CM021105.1,6,29379996,363697693,7408375,2139445,365837138,365435532
29378590_2176335,CM021105.1,6,29378590,363690110,5148795,2176335,365866445,365464839
29378590_2179653,CM021105.1,6,29378590,363690110,5148795,2179653,365869763,365468157
29378590_2179742,CM021105.1,6,29378590,363690110,5148795,2179742,365869852,365468246
29378590_2179805,CM021105.1,6,29378590,363690110,5148795,2179805,365869915,365468309
29378590_2192529,CM021105.1,6,29378590,363690110,5148795,2192529,365882639,365481033
29379996_2362040,CM021105.1,6,29379996,363697693,7408375,2362040,366059733,365658127
29379996_2362110,CM021105.1,6,29379996,363697693,7408375,2362110,366059803,365658197
29377194_2508596,CM021105.1,6,29377194,363695010,4053103,2508596,366203606,365802000
29378590_2547870,CM021105.1,6,29378590,363690110,5148795,2547870,366237980,365836374
29378590_2547890,CM021105.1,6,29378590,363690110,5148795,2547890,366238000,365836394
29378590_2547947,CM021105.1,6,29378590,363690110,5148795,2547947,366238057,365836451
29378590_2547996,CM021105.1,6,29378590,363690110,5148795,2547996,366238106,365836500
29377998_2622033,CM021105.1,6,29377998,363690112,4415855,2622033,366312145,365910539
29377106_2618191,CM021105.1,6,29377106,363698796,2977991,2618191,366316987,365915381
29379609_2768272,CM021105.1,6,29379609,363690112,4111262,2768272,366458384,366056778
29379609_2768376,CM021105.1,6,29379609,363690112,4111262,2768376,366458488,366056882
29378590_2810620,CM021105.1,6,29378590,363690110,5148795,2810620,366500730,366099124
29378590_2810771,CM021105.1,6,29378590,363690110,5148795,2810771,366500881,366099275
29378590_2810839,CM021105.1,6,29378590,363690110,5148795,2810839,366500949,366099343
29377194_2824794,CM021105.1,6,29377194,363695010,4053103,2824794,366519804,366118198
29378590_2866844,CM021105.1,6,29378590,363690110,5148795,2866844,366556954,366155348
29379356_2859558,CM021105.1,6,29379356,363697968,3993433,2859558,366557526,366155920
29378590_2872285,CM021105.1,6,29378590,363690110,5148795,2872285,366562395,366160789
29377106_2876340,CM021105.1,6,29377106,363698796,2977991,2876340,366575136,366173530
29377106_2971118,CM021105.1,6,29377106,363698796,2977991,2971118,366669914,366268308
29379609_2987389,CM021105.1,6,29379609,363690112,4111262,2987389,366677501,366275895
29379609_2987613,CM021105.1,6,29379609,363690112,4111262,2987613,366677725,366276119
29379356_3147106,CM021105.1,6,29379356,363697968,3993433,3147106,366845074,366443468
29379356_3147127,CM021105.1,6,29379356,363697968,3993433,3147127,366845095,366443489
29379356_3148531,CM021105.1,6,29379356,363697968,3993433,3148531,366846499,366444893
29379356_3148570,CM021105.1,6,29379356,363697968,3993433,3148570,366846538,366444932
29377194_3217701,CM021105.1,6,29377194,363695010,4053103,3217701,366912711,366511105
29378590_3253996,CM021105.1,6,29378590,363690110,5148795,3253996,366944106,366542500
29378590_3254073,CM021105.1,6,29378590,363690110,5148795,3254073,366944183,366542577
29378590_3254588,CM021105.1,6,29378590,363690110,5148795,3254588,366944698,366543092
29378590_3254790,CM021105.1,6,29378590,363690110,5148795,3254790,366944900,366543294
29378590_3257378,CM021105.1,6,29378590,363690110,5148795,3257378,366947488,366545882
29378590_3257399,CM021105.1,6,29378590,363690110,5148795,3257399,366947509,366545903
29378590_3257507,CM021105.1,6,29378590,363690110,5148795,3257507,366947617,366546011
29378590_3257688,CM021105.1,6,29378590,363690110,5148795,3257688,366947798,366546192
29378590_3257708,CM021105.1,6,29378590,363690110,5148795,3257708,366947818,366546212
29378590_3257749,CM021105.1,6,29378590,363690110,5148795,3257749,366947859,366546253
29378590_3382885,CM021105.1,6,29378590,363690110,5148795,3382885,367072995,366671389
29378590_3431694,CM021105.1,6,29378590,363690110,5148795,3431694,367121804,366720198
29379013_3456894,CM021105.1,6,29379013,363697933,3496801,3456894,367154827,366753221
29379013_3456944,CM021105.1,6,29379013,363697933,3496801,3456944,367154877,366753271
29379609_3518536,CM021105.1,6,29379609,363690112,4111262,3518536,367208648,366807042
29377194_3576412,CM021105.1,6,29377194,363695010,4053103,3576412,367271422,366869816
29379356_3637250,CM021105.1,6,29379356,363697968,3993433,3637250,367335218,366933612
29379356_3637281,CM021105.1,6,29379356,363697968,3993433,3637281,367335249,366933643
29379356_3637303,CM021105.1,6,29379356,363697968,3993433,3637303,367335271,366933665
29379356_3637323,CM021105.1,6,29379356,363697968,3993433,3637323,367335291,366933685
29379356_3637374,CM021105.1,6,29379356,363697968,3993433,3637374,367335342,366933736
29379356_3637425,CM021105.1,6,29379356,363697968,3993433,3637425,367335393,366933787
29379356_3637426,CM021105.1,6,29379356,363697968,3993433,3637426,367335394,366933788
29379356_3637428,CM021105.1,6,29379356,363697968,3993433,3637428,367335396,366933790
29379356_3637537,CM021105.1,6,29379356,363697968,3993433,3637537,367335505,366933899
29379356_3637759,CM021105.1,6,29379356,363697968,3993433,3637759,367335727,366934121
29379356_3637772,CM021105.1,6,29379356,363697968,3993433,3637772,367335740,366934134
29379356_3637776,CM021105.1,6,29379356,363697968,3993433,3637776,367335744,366934138
29379356_3642611,CM021105.1,6,29379356,363697968,3993433,3642611,367340579,366938973
29379356_3642647,CM021105.1,6,29379356,363697968,3993433,3642647,367340615,366939009
29379996_3683894,CM021105.1,6,29379996,363697693,7408375,3683894,367381587,366979981
29379996_3683900,CM021105.1,6,29379996,363697693,7408375,3683900,367381593,366979987
29379996_3683915,CM021105.1,6,29379996,363697693,7408375,3683915,367381608,366980002
29379996_3686061,CM021105.1,6,29379996,363697693,7408375,3686061,367383754,366982148
29379996_3686062,CM021105.1,6,29379996,363697693,7408375,3686062,367383755,366982149
29379996_3686069,CM021105.1,6,29379996,363697693,7408375,3686069,367383762,366982156
29379996_3686187,CM021105.1,6,29379996,363697693,7408375,3686187,367383880,366982274
29378590_3718532,CM021105.1,6,29378590,363690110,5148795,3718532,367408642,367007036
29379356_3736434,CM021105.1,6,29379356,363697968,3993433,3736434,367434402,367032796
29379356_3736459,CM021105.1,6,29379356,363697968,3993433,3736459,367434427,367032821
29379356_3736467,CM021105.1,6,29379356,363697968,3993433,3736467,367434435,367032829
29379356_3736476,CM021105.1,6,29379356,363697968,3993433,3736476,367434444,367032838
29379356_3736477,CM021105.1,6,29379356,363697968,3993433,3736477,367434445,367032839
29379356_3736479,CM021105.1,6,29379356,363697968,3993433,3736479,367434447,367032841
29379356_3736499,CM021105.1,6,29379356,363697968,3993433,3736499,367434467,367032861
29379356_3736506,CM021105.1,6,29379356,363697968,3993433,3736506,367434474,367032868
29379356_3736515,CM021105.1,6,29379356,363697968,3993433,3736515,367434483,367032877
29379356_3736518,CM021105.1,6,29379356,363697968,3993433,3736518,367434486,367032880
29379356_3736520,CM021105.1,6,29379356,363697968,3993433,3736520,367434488,367032882
29379356_3736569,CM021105.1,6,29379356,363697968,3993433,3736569,367434537,367032931
29379356_3736610,CM021105.1,6,29379356,363697968,3993433,3736610,367434578,367032972
29377170_3938453,CM021105.1,6,29377170,363694142,12000214,3938453,367632595,367230989
29377170_3938487,CM021105.1,6,29377170,363694142,12000214,3938487,367632629,367231023
29377998_4173186,CM021105.1,6,29377998,363690112,4415855,4173186,367863298,367461692
29379996_4337358,CM021105.1,6,29379996,363697693,7408375,4337358,368035051,367633445
29379996_4339093,CM021105.1,6,29379996,363697693,7408375,4339093,368036786,367635180
29379996_4344726,CM021105.1,6,29379996,363697693,7408375,4344726,368042419,367640813
29379996_4931276,CM021105.1,6,29379996,363697693,7408375,4931276,368628969,368227363
29379996_4931367,CM021105.1,6,29379996,363697693,7408375,4931367,368629060,368227454
29379996_5067244,CM021105.1,6,29379996,363697693,7408375,5067244,368764937,368363331
29379996_5067273,CM021105.1,6,29379996,363697693,7408375,5067273,368764966,368363360
29379996_5070801,CM021105.1,6,29379996,363697693,7408375,5070801,368768494,368366888
29379996_5070820,CM021105.1,6,29379996,363697693,7408375,5070820,368768513,368366907
29382329_5168316,CM021105.1,6,29382329,363698495,5728562,5168316,368866811,368465205
29382329_5168323,CM021105.1,6,29382329,363698495,5728562,5168323,368866818,368465212
29382329_5168420,CM021105.1,6,29382329,363698495,5728562,5168420,368866915,368465309
29382329_5253287,CM021105.1,6,29382329,363698495,5728562,5253287,368951782,368550176
29382329_5253311,CM021105.1,6,29382329,363698495,5728562,5253311,368951806,368550200
29382329_5253314,CM021105.1,6,29382329,363698495,5728562,5253314,368951809,368550203
29382329_5253332,CM021105.1,6,29382329,363698495,5728562,5253332,368951827,368550221
29382329_5256574,CM021105.1,6,29382329,363698495,5728562,5256574,368955069,368553463
29382329_5256853,CM021105.1,6,29382329,363698495,5728562,5256853,368955348,368553742
29382329_5257354,CM021105.1,6,29382329,363698495,5728562,5257354,368955849,368554243
29382329_5263878,CM021105.1,6,29382329,363698495,5728562,5263878,368962373,368560767
29382329_5263899,CM021105.1,6,29382329,363698495,5728562,5263899,368962394,368560788
29379996_5305857,CM021105.1,6,29379996,363697693,7408375,5305857,369003550,368601944
29379996_5399403,CM021105.1,6,29379996,363697693,7408375,5399403,369097096,368695490
29379996_5399457,CM021105.1,6,29379996,363697693,7408375,5399457,369097150,368695544
29379996_5399499,CM021105.1,6,29379996,363697693,7408375,5399499,369097192,368695586
29379996_5399500,CM021105.1,6,29379996,363697693,7408375,5399500,369097193,368695587
29379996_5399511,CM021105.1,6,29379996,363697693,7408375,5399511,369097204,368695598
29379996_5441860,CM021105.1,6,29379996,363697693,7408375,5441860,369139553,368737947
29379996_5644932,CM021105.1,6,29379996,363697693,7408375,5644932,369342625,368941019
29379996_5676120,CM021105.1,6,29379996,363697693,7408375,5676120,369373813,368972207
29382329_5695375,CM021105.1,6,29382329,363698495,5728562,5695375,369393870,368992264
29377170_5915975,CM021105.1,6,29377170,363694142,12000214,5915975,369610117,369208511
29377170_5916079,CM021105.1,6,29377170,363694142,12000214,5916079,369610221,369208615
29377170_6210319,CM021105.1,6,29377170,363694142,12000214,6210319,369904461,369502855
29377170_6694657,CM021105.1,6,29377170,363694142,12000214,6694657,370388799,369987193
29377170_6699730,CM021105.1,6,29377170,363694142,12000214,6699730,370393872,369992266
29377170_6717520,CM021105.1,6,29377170,363694142,12000214,6717520,370411662,370010056
29377170_6757555,CM021105.1,6,29377170,363694142,12000214,6757555,370451697,370050091
29377170_6757668,CM021105.1,6,29377170,363694142,12000214,6757668,370451810,370050204
29377170_6758163,CM021105.1,6,29377170,363694142,12000214,6758163,370452305,370050699
29377170_6758266,CM021105.1,6,29377170,363694142,12000214,6758266,370452408,370050802
29377170_6853625,CM021105.1,6,29377170,363694142,12000214,6853625,370547767,370146161
29377170_6853690,CM021105.1,6,29377170,363694142,12000214,6853690,370547832,370146226
29377170_6971253,CM021105.1,6,29377170,363694142,12000214,6971253,370665395,370263789
29377170_6977367,CM021105.1,6,29377170,363694142,12000214,6977367,370671509,370269903
29377170_7638403,CM021105.1,6,29377170,363694142,12000214,7638403,371332545,370930939
29377170_7638465,CM021105.1,6,29377170,363694142,12000214,7638465,371332607,370931001
29377170_7638613,CM021105.1,6,29377170,363694142,12000214,7638613,371332755,370931149
29377170_7804888,CM021105.1,6,29377170,363694142,12000214,7804888,371499030,371097424
29377170_8690805,CM021105.1,6,29377170,363694142,12000214,8690805,372384947,371983341
29377170_8690878,CM021105.1,6,29377170,363694142,12000214,8690878,372385020,371983414
29377170_8691350,CM021105.1,6,29377170,363694142,12000214,8691350,372385492,371983886
29377170_8692212,CM021105.1,6,29377170,363694142,12000214,8692212,372386354,371984748
29377170_9848985,CM021105.1,6,29377170,363694142,12000214,9848985,373543127,373141521
29377170_9969011,CM021105.1,6,29377170,363694142,12000214,9969011,373663153,373261547
29377170_9969030,CM021105.1,6,29377170,363694142,12000214,9969030,373663172,373261566
29377170_9969060,CM021105.1,6,29377170,363694142,12000214,9969060,373663202,373261596
29377170_10113001,CM021105.1,6,29377170,363694142,12000214,10113001,373807143,373405537
29377170_10113012,CM021105.1,6,29377170,363694142,12000214,10113012,373807154,373405548
29377170_10736143,CM021105.1,6,29377170,363694142,12000214,10736143,374430285,374028679
29377170_10736238,CM021105.1,6,29377170,363694142,12000214,10736238,374430380,374028774
29377170_10736243,CM021105.1,6,29377170,363694142,12000214,10736243,374430385,374028779
29377170_10736354,CM021105.1,6,29377170,363694142,12000214,10736354,374430496,374028890
29377170_11787948,CM021105.1,6,29377170,363694142,12000214,11787948,375482090,375080484
29377170_11787953,CM021105.1,6,29377170,363694142,12000214,11787953,375482095,375080489
29377170_11788006,CM021105.1,6,29377170,363694142,12000214,11788006,375482148,375080542
29377170_11788049,CM021105.1,6,29377170,363694142,12000214,11788049,375482191,375080585
29377170_11788073,CM021105.1,6,29377170,363694142,12000214,11788073,375482215,375080609
29377170_11873262,CM021105.1,6,29377170,363694142,12000214,11873262,375567404,375165798
29377170_11873346,CM021105.1,6,29377170,363694142,12000214,11873346,375567488,375165882
29381372_65833,CM021105.1,6,29381372,418206636,1310172,65833,418272469,417870863
29381461_179419,CM021105.1,6,29381461,418206631,657193,179419,418386050,417984444
29381461_179435,CM021105.1,6,29381461,418206631,657193,179435,418386066,417984460
29381461_179614,CM021105.1,6,29381461,418206631,657193,179614,418386245,417984639
29351250_225287,CM021105.1,6,29351250,418207661,442167,225287,418432948,418031342
29351250_225328,CM021105.1,6,29351250,418207661,442167,225328,418432989,418031383
29381461_278920,CM021105.1,6,29381461,418206631,657193,278920,418485551,418083945
29381461_278922,CM021105.1,6,29381461,418206631,657193,278922,418485553,418083947
29381461_279005,CM021105.1,6,29381461,418206631,657193,279005,418485636,418084030
29382223_5400,CM021105.1,6,29382223,439597864,41595,5400,439603264,439201658
29382223_5470,CM021105.1,6,29382223,439597864,41595,5470,439603334,439201728
28415762_6733,CM021105.1,6,28415762,442442719,9572,6733,442449452,442047846
29380393_182462,CM021105.1,6,29380393,458082911,529606,182462,458265373,457863767
29379310_110005,CM021105.1,6,29379310,478570119,827305,110005,478680124,478278518
29379310_110055,CM021105.1,6,29379310,478570119,827305,110055,478680174,478278568
29379310_110056,CM021105.1,6,29379310,478570119,827305,110056,478680175,478278569
29381356_450787,CM021105.1,6,29381356,479667892,507211,450787,480118679,479717073
29381356_450890,CM021105.1,6,29381356,479667892,507211,450890,480118782,479717176
29044609_1455,CM021105.1,6,29044609,505420128,4479,1455,505421583,505019977
29378831_45429,CM021105.1,6,29378831,506570397,313958,45429,506615826,506214220
29378831_45446,CM021105.1,6,29378831,506570397,313958,45446,506615843,506214237
29378831_45469,CM021105.1,6,29378831,506570397,313958,45469,506615866,506214260
29378831_45505,CM021105.1,6,29378831,506570397,313958,45505,506615902,506214296
29378831_45545,CM021105.1,6,29378831,506570397,313958,45545,506615942,506214336
29381137_280500,CM021105.1,6,29381137,506571743,666162,280500,506852243,506450637
29381137_280897,CM021105.1,6,29381137,506571743,666162,280897,506852640,506451034
29381137_282132,CM021105.1,6,29381137,506571743,666162,282132,506853875,506452269
29381137_282153,CM021105.1,6,29381137,506571743,666162,282153,506853896,506452290
29381137_282263,CM021105.1,6,29381137,506571743,666162,282263,506854006,506452400
29381137_282270,CM021105.1,6,29381137,506571743,666162,282270,506854013,506452407
29381137_282333,CM021105.1,6,29381137,506571743,666162,282333,506854076,506452470
29381137_282334,CM021105.1,6,29381137,506571743,666162,282334,506854077,506452471
29379021_288605,CM021105.1,6,29379021,506570400,794710,288605,506859005,506457399
29382172_753574,CM021105.1,6,29382172,506570400,804670,753574,507323974,506922368
29382172_753720,CM021105.1,6,29382172,506570400,804670,753720,507324120,506922514
29382172_753862,CM021105.1,6,29382172,506570400,804670,753862,507324262,506922656
29382172_775131,CM021105.1,6,29382172,506570400,804670,775131,507345531,506943925
29382172_776287,CM021105.1,6,29382172,506570400,804670,776287,507346687,506945081
29353612_959984,CM021105.1,6,29353612,506570507,1020911,959984,507530491,507128885
29353612_1001474,CM021105.1,6,29353612,506570507,1020911,1001474,507571981,507170375
29379324_2088411,CM021105.1,6,29379324,506570396,2180420,2088411,508658807,508257201
29379268_2780,CM021105.1,6,29379268,509994435,1174284,2780,509997215,509595609
29379268_2970,CM021105.1,6,29379268,509994435,1174284,2970,509997405,509595799
29378967_29333,CM021105.1,6,29378967,509994432,5107475,29333,510023765,509622159
29379214_49307,CM021105.1,6,29379214,509994435,369666,49307,510043742,509642136
29380515_78211,CM021105.1,6,29380515,509994431,365491,78211,510072642,509671036
29380515_78249,CM021105.1,6,29380515,509994431,365491,78249,510072680,509671074
29379268_90616,CM021105.1,6,29379268,509994435,1174284,90616,510085051,509683445
29379268_91124,CM021105.1,6,29379268,509994435,1174284,91124,510085559,509683953
29378213_107184,CM021105.1,6,29378213,509994432,1159645,107184,510101616,509700010
29378967_152040,CM021105.1,6,29378967,509994432,5107475,152040,510146472,509744866
29378967_152075,CM021105.1,6,29378967,509994432,5107475,152075,510146507,509744901
29378967_152495,CM021105.1,6,29378967,509994432,5107475,152495,510146927,509745321
29378967_152588,CM021105.1,6,29378967,509994432,5107475,152588,510147020,509745414
29378967_152615,CM021105.1,6,29378967,509994432,5107475,152615,510147047,509745441
29378967_174658,CM021105.1,6,29378967,509994432,5107475,174658,510169090,509767484
29378213_186510,CM021105.1,6,29378213,509994432,1159645,186510,510180942,509779336
29378213_230086,CM021105.1,6,29378213,509994432,1159645,230086,510224518,509822912
29380102_332626,CM021105.1,6,29380102,509994627,1016597,332626,510327253,509925647
29380102_332666,CM021105.1,6,29380102,509994627,1016597,332666,510327293,509925687
29380102_332715,CM021105.1,6,29380102,509994627,1016597,332715,510327342,509925736
29379496_351831,CM021105.1,6,29379496,509994432,787631,351831,510346263,509944657
29379496_351948,CM021105.1,6,29379496,509994432,787631,351948,510346380,509944774
29381694_405766,CM021105.1,6,29381694,509994432,1090609,405766,510400198,509998592
29378213_437566,CM021105.1,6,29378213,509994432,1159645,437566,510431998,510030392
29378213_437583,CM021105.1,6,29378213,509994432,1159645,437583,510432015,510030409
29378213_437624,CM021105.1,6,29378213,509994432,1159645,437624,510432056,510030450
29378213_437625,CM021105.1,6,29378213,509994432,1159645,437625,510432057,510030451
29378213_445634,CM021105.1,6,29378213,509994432,1159645,445634,510440066,510038460
29378213_445673,CM021105.1,6,29378213,509994432,1159645,445673,510440105,510038499
29378213_448209,CM021105.1,6,29378213,509994432,1159645,448209,510442641,510041035
29377459_448627,CM021105.1,6,29377459,509994435,2580113,448627,510443062,510041456
29377459_482225,CM021105.1,6,29377459,509994435,2580113,482225,510476660,510075054
29377459_482233,CM021105.1,6,29377459,509994435,2580113,482233,510476668,510075062
29377459_482353,CM021105.1,6,29377459,509994435,2580113,482353,510476788,510075182
29380102_483734,CM021105.1,6,29380102,509994627,1016597,483734,510478361,510076755
29380102_483834,CM021105.1,6,29380102,509994627,1016597,483834,510478461,510076855
29380102_514490,CM021105.1,6,29380102,509994627,1016597,514490,510509117,510107511
29380102_514528,CM021105.1,6,29380102,509994627,1016597,514528,510509155,510107549
29380102_537973,CM021105.1,6,29380102,509994627,1016597,537973,510532600,510130994
29380102_583979,CM021105.1,6,29380102,509994627,1016597,583979,510578606,510177000
29379090_667653,CM021105.1,6,29379090,509994428,3036353,667653,510662081,510260475
29380102_682794,CM021105.1,6,29380102,509994627,1016597,682794,510677421,510275815
29380102_682865,CM021105.1,6,29380102,509994627,1016597,682865,510677492,510275886
29380102_682907,CM021105.1,6,29380102,509994627,1016597,682907,510677534,510275928
29378967_732393,CM021105.1,6,29378967,509994432,5107475,732393,510726825,510325219
29379090_746420,CM021105.1,6,29379090,509994428,3036353,746420,510740848,510339242
29379090_746439,CM021105.1,6,29379090,509994428,3036353,746439,510740867,510339261
29379090_746450,CM021105.1,6,29379090,509994428,3036353,746450,510740878,510339272
29377322_878429,CM021105.1,6,29377322,509994431,1503915,878429,510872860,510471254
29377322_878455,CM021105.1,6,29377322,509994431,1503915,878455,510872886,510471280
29377322_934784,CM021105.1,6,29377322,509994431,1503915,934784,510929215,510527609
29380102_940100,CM021105.1,6,29380102,509994627,1016597,940100,510934727,510533121
29380102_940121,CM021105.1,6,29380102,509994627,1016597,940121,510934748,510533142
29380102_940388,CM021105.1,6,29380102,509994627,1016597,940388,510935015,510533409
29380102_971379,CM021105.1,6,29380102,509994627,1016597,971379,510966006,510564400
29380102_971477,CM021105.1,6,29380102,509994627,1016597,971477,510966104,510564498
29380102_971499,CM021105.1,6,29380102,509994627,1016597,971499,510966126,510564520
29380102_971608,CM021105.1,6,29380102,509994627,1016597,971608,510966235,510564629
29377459_1264289,CM021105.1,6,29377459,509994435,2580113,1264289,511258724,510857118
29377459_1264303,CM021105.1,6,29377459,509994435,2580113,1264303,511258738,510857132
29377459_1264306,CM021105.1,6,29377459,509994435,2580113,1264306,511258741,510857135
29377459_1264317,CM021105.1,6,29377459,509994435,2580113,1264317,511258752,510857146
29377459_1264347,CM021105.1,6,29377459,509994435,2580113,1264347,511258782,510857176
29377459_1264363,CM021105.1,6,29377459,509994435,2580113,1264363,511258798,510857192
29377459_1264405,CM021105.1,6,29377459,509994435,2580113,1264405,511258840,510857234
29377459_1264408,CM021105.1,6,29377459,509994435,2580113,1264408,511258843,510857237
29377459_1264432,CM021105.1,6,29377459,509994435,2580113,1264432,511258867,510857261
29377459_1264437,CM021105.1,6,29377459,509994435,2580113,1264437,511258872,510857266
29377459_1264447,CM021105.1,6,29377459,509994435,2580113,1264447,511258882,510857276
29377459_1264600,CM021105.1,6,29377459,509994435,2580113,1264600,511259035,510857429
29377459_1264903,CM021105.1,6,29377459,509994435,2580113,1264903,511259338,510857732
29377459_1264916,CM021105.1,6,29377459,509994435,2580113,1264916,511259351,510857745
29377459_1264982,CM021105.1,6,29377459,509994435,2580113,1264982,511259417,510857811
29382065_1307907,CM021105.1,6,29382065,509994432,2888673,1307907,511302339,510900733
29382065_1307938,CM021105.1,6,29382065,509994432,2888673,1307938,511302370,510900764
29382065_1308096,CM021105.1,6,29382065,509994432,2888673,1308096,511302528,510900922
29377251_1521602,CM021105.1,6,29377251,509995913,1857441,1521602,511517515,511115909
29377251_1521691,CM021105.1,6,29377251,509995913,1857441,1521691,511517604,511115998
29377251_1521694,CM021105.1,6,29377251,509995913,1857441,1521694,511517607,511116001
29377251_1521729,CM021105.1,6,29377251,509995913,1857441,1521729,511517642,511116036
29377251_1521787,CM021105.1,6,29377251,509995913,1857441,1521787,511517700,511116094
29377251_1521788,CM021105.1,6,29377251,509995913,1857441,1521788,511517701,511116095
29377251_1521830,CM021105.1,6,29377251,509995913,1857441,1521830,511517743,511116137
29377571_3446,CM021105.1,6,29377571,512312774,53184,3446,512316220,511914614
29379090_2504699,CM021105.1,6,29379090,509994428,3036353,2504699,512499127,512097521
29379090_2504700,CM021105.1,6,29379090,509994428,3036353,2504700,512499128,512097522
29379090_2504756,CM021105.1,6,29379090,509994428,3036353,2504756,512499184,512097578
29379090_2504845,CM021105.1,6,29379090,509994428,3036353,2504845,512499273,512097667
29380676_228686,CM021105.1,6,29380676,512314728,358142,228686,512543414,512141808
29379090_2589790,CM021105.1,6,29379090,509994428,3036353,2589790,512584218,512182612
29379090_2589848,CM021105.1,6,29379090,509994428,3036353,2589848,512584276,512182670
29380832_3368987,CM021105.1,6,29380832,509994432,3953609,3368987,513363419,512961813
29380832_3369013,CM021105.1,6,29380832,509994432,3953609,3369013,513363445,512961839
29378967_3864152,CM021105.1,6,29378967,509994432,5107475,3864152,513858584,513456978
29378967_3864272,CM021105.1,6,29378967,509994432,5107475,3864272,513858704,513457098
29380832_3907948,CM021105.1,6,29380832,509994432,3953609,3907948,513902380,513500774
29380832_3941056,CM021105.1,6,29380832,509994432,3953609,3941056,513935488,513533882
29377232_4277824,CM021105.1,6,29377232,509994435,4351504,4277824,514272259,513870653
29377232_4277882,CM021105.1,6,29377232,509994435,4351504,4277882,514272317,513870711
29377232_4277910,CM021105.1,6,29377232,509994435,4351504,4277910,514272345,513870739
29381887_63524,CM021105.1,6,29381887,522517659,144647,63524,522581183,522179577
29381887_63617,CM021105.1,6,29381887,522517659,144647,63617,522581276,522179670
29381887_63644,CM021105.1,6,29381887,522517659,144647,63644,522581303,522179697
29381887_63649,CM021105.1,6,29381887,522517659,144647,63649,522581308,522179702
29381887_63669,CM021105.1,6,29381887,522517659,144647,63669,522581328,522179722
29381887_63679,CM021105.1,6,29381887,522517659,144647,63679,522581338,522179732
29381887_63683,CM021105.1,6,29381887,522517659,144647,63683,522581342,522179736
29379891_616958,CM021105.1,6,29379891,536919397,1628291,616958,537536355,537134749
29379891_616989,CM021105.1,6,29379891,536919397,1628291,616989,537536386,537134780
29379891_704712,CM021105.1,6,29379891,536919397,1628291,704712,537624109,537222503
29381164_969459,CM021105.1,6,29381164,536919202,1102332,969459,537888661,537487055
29381354_1559735,CM021105.1,6,29381354,536919200,2942753,1559735,538478935,538077329
29381354_1561306,CM021105.1,6,29381354,536919200,2942753,1561306,538480506,538078900
29381354_1561322,CM021105.1,6,29381354,536919200,2942753,1561322,538480522,538078916
29381354_1991271,CM021105.1,6,29381354,536919200,2942753,1991271,538910471,538508865
29381354_1991294,CM021105.1,6,29381354,536919200,2942753,1991294,538910494,538508888
29381354_1991340,CM021105.1,6,29381354,536919200,2942753,1991340,538910540,538508934
29381354_2261730,CM021105.1,6,29381354,536919200,2942753,2261730,539180930,538779324
29381354_2261836,CM021105.1,6,29381354,536919200,2942753,2261836,539181036,538779430
29354202_25483,CM021105.1,6,29354202,567762490,102834,25483,567787973,567386367
29354202_74072,CM021105.1,6,29354202,567762490,102834,74072,567836562,567434956
29354202_74103,CM021105.1,6,29354202,567762490,102834,74103,567836593,567434987
29354202_74281,CM021105.1,6,29354202,567762490,102834,74281,567836771,567435165
29354202_74327,CM021105.1,6,29354202,567762490,102834,74327,567836817,567435211
29381686_216196,CM021105.1,6,29381686,578178870,359257,216196,578395066,577993460
29381686_216238,CM021105.1,6,29381686,578178870,359257,216238,578395108,577993502
29381686_216239,CM021105.1,6,29381686,578178870,359257,216239,578395109,577993503
29381686_223060,CM021105.1,6,29381686,578178870,359257,223060,578401930,578000324
29381686_223075,CM021105.1,6,29381686,578178870,359257,223075,578401945,578000339
29381686_223259,CM021105.1,6,29381686,578178870,359257,223259,578402129,578000523
29377278_384790,CM021105.1,6,29377278,587233917,684765,384790,587618707,587217101
29377278_384812,CM021105.1,6,29377278,587233917,684765,384812,587618729,587217123
29377278_384819,CM021105.1,6,29377278,587233917,684765,384819,587618736,587217130
29377278_384820,CM021105.1,6,29377278,587233917,684765,384820,587618737,587217131
29377278_484145,CM021105.1,6,29377278,587233917,684765,484145,587718062,587316456
29377278_512129,CM021105.1,6,29377278,587233917,684765,512129,587746046,587344440
29377278_512160,CM021105.1,6,29377278,587233917,684765,512160,587746077,587344471
29377278_606103,CM021105.1,6,29377278,587233917,684765,606103,587840020,587438414
29377278_606116,CM021105.1,6,29377278,587233917,684765,606116,587840033,587438427
29377278_606208,CM021105.1,6,29377278,587233917,684765,606208,587840125,587438519
29377278_606586,CM021105.1,6,29377278,587233917,684765,606586,587840503,587438897
29377278_606592,CM021105.1,6,29377278,587233917,684765,606592,587840509,587438903
29377278_606648,CM021105.1,6,29377278,587233917,684765,606648,587840565,587438959
29377278_623030,CM021105.1,6,29377278,587233917,684765,623030,587856947,587455341
29377278_623072,CM021105.1,6,29377278,587233917,684765,623072,587856989,587455383
29377278_623073,CM021105.1,6,29377278,587233917,684765,623073,587856990,587455384
29377278_623147,CM021105.1,6,29377278,587233917,684765,623147,587857064,587455458
29380087_230341,CM021105.1,6,29380087,592987686,881075,230341,593218027,592816421
29380087_230385,CM021105.1,6,29380087,592987686,881075,230385,593218071,592816465
29380087_230406,CM021105.1,6,29380087,592987686,881075,230406,593218092,592816486
29380087_230736,CM021105.1,6,29380087,592987686,881075,230736,593218422,592816816
29380087_230886,CM021105.1,6,29380087,592987686,881075,230886,593218572,592816966
29380087_235196,CM021105.1,6,29380087,592987686,881075,235196,593222882,592821276
29378578_318294,CM021105.1,6,29378578,592988731,732606,318294,593307025,592905419
29378578_514091,CM021105.1,6,29378578,592988731,732606,514091,593502822,593101216
29378578_514186,CM021105.1,6,29378578,592988731,732606,514186,593502917,593101311
29381042_587796,CM021105.1,6,29381042,592988374,1280306,587796,593576170,593174564
29381042_658361,CM021105.1,6,29381042,592988374,1280306,658361,593646735,593245129
29381042_678691,CM021105.1,6,29381042,592988374,1280306,678691,593667065,593265459
29381042_685735,CM021105.1,6,29381042,592988374,1280306,685735,593674109,593272503
29381042_685801,CM021105.1,6,29381042,592988374,1280306,685801,593674175,593272569
29381042_783243,CM021105.1,6,29381042,592988374,1280306,783243,593771617,593370011
29381042_783364,CM021105.1,6,29381042,592988374,1280306,783364,593771738,593370132
29381042_783372,CM021105.1,6,29381042,592988374,1280306,783372,593771746,593370140
29381042_783378,CM021105.1,6,29381042,592988374,1280306,783378,593771752,593370146
29381042_783390,CM021105.1,6,29381042,592988374,1280306,783390,593771764,593370158
29381042_783405,CM021105.1,6,29381042,592988374,1280306,783405,593771779,593370173
29381042_966383,CM021105.1,6,29381042,592988374,1280306,966383,593954757,593553151
29381042_966433,CM021105.1,6,29381042,592988374,1280306,966433,593954807,593553201
29381042_966493,CM021105.1,6,29381042,592988374,1280306,966493,593954867,593553261
29381042_993808,CM021105.1,6,29381042,592988374,1280306,993808,593982182,593580576
29378345_10495,CM021105.1,6,29378345,623521386,678408,10495,623531881,623130275
29378345_10560,CM021105.1,6,29378345,623521386,678408,10560,623531946,623130340
29378345_66228,CM021105.1,6,29378345,623521386,678408,66228,623587614,623186008
29378345_97585,CM021105.1,6,29378345,623521386,678408,97585,623618971,623217365
29378345_97951,CM021105.1,6,29378345,623521386,678408,97951,623619337,623217731
29378345_97992,CM021105.1,6,29378345,623521386,678408,97992,623619378,623217772
29380273_147331,CM021105.1,6,29380273,623520107,1581795,147331,623667438,623265832
29380273_989526,CM021105.1,6,29380273,623520107,1581795,989526,624509633,624108027
29379138_1387575,CM021105.1,6,29379138,623520109,4463544,1387575,624907684,624506078
29379138_1419888,CM021105.1,6,29379138,623520109,4463544,1419888,624939997,624538391
29379138_1419913,CM021105.1,6,29379138,623520109,4463544,1419913,624940022,624538416
29379138_1442951,CM021105.1,6,29379138,623520109,4463544,1442951,624963060,624561454
29379138_1443019,CM021105.1,6,29379138,623520109,4463544,1443019,624963128,624561522
29379138_2014124,CM021105.1,6,29379138,623520109,4463544,2014124,625534233,625132627
29379138_2014146,CM021105.1,6,29379138,623520109,4463544,2014146,625534255,625132649
29379138_2014285,CM021105.1,6,29379138,623520109,4463544,2014285,625534394,625132788
29379138_2014317,CM021105.1,6,29379138,623520109,4463544,2014317,625534426,625132820
29379138_2041355,CM021105.1,6,29379138,623520109,4463544,2041355,625561464,625159858
29379138_3214282,CM021105.1,6,29379138,623520109,4463544,3214282,626734391,626332785
29379138_3285636,CM021105.1,6,29379138,623520109,4463544,3285636,626805745,626404139
29114849_6668,CM021105.1,6,29114849,627399154,11592,6668,627405822,627004216
29114849_6677,CM021105.1,6,29114849,627399154,11592,6677,627405831,627004225
29114849_6700,CM021105.1,6,29114849,627399154,11592,6700,627405854,627004248
29114849_6803,CM021105.1,6,29114849,627399154,11592,6803,627405957,627004351
456782_8877,CM021105.1,6,456782,644340748,12152,8877,644349625,643948019
456782_9048,CM021105.1,6,456782,644340748,12152,9048,644349796,643948190
29109334_2507,CM021105.1,6,29109334,675249990,6791,2507,675252497,674850891
29109334_2668,CM021105.1,6,29109334,675249990,6791,2668,675252658,674851052
29336484_2641,CM021105.1,6,29336484,676276744,19786,2641,676279385,675877779
29336484_2660,CM021105.1,6,29336484,676276744,19786,2660,676279404,675877798
29336484_2662,CM021105.1,6,29336484,676276744,19786,2662,676279406,675877800
29336484_2664,CM021105.1,6,29336484,676276744,19786,2664,676279408,675877802
29336484_2674,CM021105.1,6,29336484,676276744,19786,2674,676279418,675877812
29336484_2679,CM021105.1,6,29336484,676276744,19786,2679,676279423,675877817
29379213_337876,CM021106.1,7,29379213,5816780,1713111,337876,6154656,337876
29379213_340950,CM021106.1,7,29379213,5816780,1713111,340950,6157730,340950
29379213_341199,CM021106.1,7,29379213,5816780,1713111,341199,6157979,341199
29379213_1237848,CM021106.1,7,29379213,5816780,1713111,1237848,7054628,1237848
29379883_234165,CM021106.1,7,29379883,22691220,313588,234165,22925385,17108605
29381923_498345,CM021106.1,7,29381923,22691220,501688,498345,23189565,17372785
29381923_498387,CM021106.1,7,29381923,22691220,501688,498387,23189607,17372827
29381177_1103899,CM021106.1,7,29381177,22691220,1613698,1103899,23795119,17978339
29381177_1103916,CM021106.1,7,29381177,22691220,1613698,1103916,23795136,17978356
29381177_1124140,CM021106.1,7,29381177,22691220,1613698,1124140,23815360,17998580
29381177_1492144,CM021106.1,7,29381177,22691220,1613698,1492144,24183364,18366584
29381177_1492191,CM021106.1,7,29381177,22691220,1613698,1492191,24183411,18366631
29381177_1492493,CM021106.1,7,29381177,22691220,1613698,1492493,24183713,18366933
29381177_1561096,CM021106.1,7,29381177,22691220,1613698,1561096,24252316,18435536
29381177_1561136,CM021106.1,7,29381177,22691220,1613698,1561136,24252356,18435576
29381177_1574116,CM021106.1,7,29381177,22691220,1613698,1574116,24265336,18448556
29334616_72131,CM021106.1,7,29334616,37715343,211833,72131,37787474,31970694
29334616_72218,CM021106.1,7,29334616,37715343,211833,72218,37787561,31970781
29334616_116757,CM021106.1,7,29334616,37715343,211833,116757,37832100,32015320
29334616_161665,CM021106.1,7,29334616,37715343,211833,161665,37877008,32060228
29376180_176421,CM021106.1,7,29376180,37712803,257731,176421,37889224,32072444
29381158_222331,CM021106.1,7,29381158,37712794,1442640,222331,37935125,32118345
29380654_444547,CM021106.1,7,29380654,37713926,2592633,444547,38158473,32341693
29378294_702410,CM021106.1,7,29378294,37714019,1080056,702410,38416429,32599649
29378294_732520,CM021106.1,7,29378294,37714019,1080056,732520,38446539,32629759
29378294_732527,CM021106.1,7,29378294,37714019,1080056,732527,38446546,32629766
29378294_733100,CM021106.1,7,29378294,37714019,1080056,733100,38447119,32630339
29378294_737460,CM021106.1,7,29378294,37714019,1080056,737460,38451479,32634699
29380816_902776,CM021106.1,7,29380816,37712799,2406003,902776,38615575,32798795
29380816_902859,CM021106.1,7,29380816,37712799,2406003,902859,38615658,32798878
29380816_902875,CM021106.1,7,29380816,37712799,2406003,902875,38615674,32798894
29380816_902948,CM021106.1,7,29380816,37712799,2406003,902948,38615747,32798967
29378294_993978,CM021106.1,7,29378294,37714019,1080056,993978,38707997,32891217
29378294_994004,CM021106.1,7,29378294,37714019,1080056,994004,38708023,32891243
29378294_994178,CM021106.1,7,29378294,37714019,1080056,994178,38708197,32891417
29378294_994210,CM021106.1,7,29378294,37714019,1080056,994210,38708229,32891449
29378294_994223,CM021106.1,7,29378294,37714019,1080056,994223,38708242,32891462
29378294_994290,CM021106.1,7,29378294,37714019,1080056,994290,38708309,32891529
29378294_1040173,CM021106.1,7,29378294,37714019,1080056,1040173,38754192,32937412
29380654_1896747,CM021106.1,7,29380654,37713926,2592633,1896747,39610673,33793893
29380654_1896774,CM021106.1,7,29380654,37713926,2592633,1896774,39610700,33793920
29380654_2278663,CM021106.1,7,29380654,37713926,2592633,2278663,39992589,34175809
29380654_2280036,CM021106.1,7,29380654,37713926,2592633,2280036,39993962,34177182
29380654_2280109,CM021106.1,7,29380654,37713926,2592633,2280109,39994035,34177255
29343895_19275,CM021106.1,7,29343895,40578011,23405,19275,40597286,34780506
29343895_19282,CM021106.1,7,29343895,40578011,23405,19282,40597293,34780513
29350240_27364,CM021106.1,7,29350240,40578126,32545,27364,40605490,34788710
29350240_27366,CM021106.1,7,29350240,40578126,32545,27366,40605492,34788712
29350240_27466,CM021106.1,7,29350240,40578126,32545,27466,40605592,34788812
29350240_27478,CM021106.1,7,29350240,40578126,32545,27478,40605604,34788824
29350240_27479,CM021106.1,7,29350240,40578126,32545,27479,40605605,34788825
29350240_27519,CM021106.1,7,29350240,40578126,32545,27519,40605645,34788865
29350240_27530,CM021106.1,7,29350240,40578126,32545,27530,40605656,34788876
29350240_27581,CM021106.1,7,29350240,40578126,32545,27581,40605707,34788927
29381314_110728,CM021106.1,7,29381314,40578005,232767,110728,40688733,34871953
29381314_110746,CM021106.1,7,29381314,40578005,232767,110746,40688751,34871971
29359382_245290,CM021106.1,7,29359382,53472381,251099,245290,53717671,47900891
29359382_245334,CM021106.1,7,29359382,53472381,251099,245334,53717715,47900935
29374077_241671,CM021106.1,7,29374077,103919083,363250,241671,104160754,98343974
29377716_315706,CM021106.1,7,29377716,121881969,1078569,315706,122197675,116380895
29381034_353609,CM021106.1,7,29381034,121881969,1323866,353609,122235578,116418798
29380224_401882,CM021106.1,7,29380224,121881959,715550,401882,122283841,116467061
29380224_401948,CM021106.1,7,29380224,121881959,715550,401948,122283907,116467127
29378777_428980,CM021106.1,7,29378777,121882261,6102118,428980,122311241,116494461
29378777_429002,CM021106.1,7,29378777,121882261,6102118,429002,122311263,116494483
29377394_441037,CM021106.1,7,29377394,121881968,1121896,441037,122323005,116506225
29377394_484968,CM021106.1,7,29377394,121881968,1121896,484968,122366936,116550156
29380854_510409,CM021106.1,7,29380854,121881968,8295417,510409,122392377,116575597
29378577_648978,CM021106.1,7,29378577,121884098,693156,648978,122533076,116716296
29378577_649061,CM021106.1,7,29378577,121884098,693156,649061,122533159,116716379
29378577_649763,CM021106.1,7,29378577,121884098,693156,649763,122533861,116717081
29378653_717753,CM021106.1,7,29378653,121882303,4353445,717753,122600056,116783276
29378653_717780,CM021106.1,7,29378653,121882303,4353445,717780,122600083,116783303
29378777_762119,CM021106.1,7,29378777,121882261,6102118,762119,122644380,116827600
29381925_1046115,CM021106.1,7,29381925,121881968,2229464,1046115,122928083,117111303
29381925_1046122,CM021106.1,7,29381925,121881968,2229464,1046122,122928090,117111310
29381925_1046137,CM021106.1,7,29381925,121881968,2229464,1046137,122928105,117111325
29381925_1053452,CM021106.1,7,29381925,121881968,2229464,1053452,122935420,117118640
29381925_1053456,CM021106.1,7,29381925,121881968,2229464,1053456,122935424,117118644
29381925_1053466,CM021106.1,7,29381925,121881968,2229464,1053466,122935434,117118654
29381925_1053477,CM021106.1,7,29381925,121881968,2229464,1053477,122935445,117118665
29381925_1053534,CM021106.1,7,29381925,121881968,2229464,1053534,122935502,117118722
29381925_1053542,CM021106.1,7,29381925,121881968,2229464,1053542,122935510,117118730
29381925_1053543,CM021106.1,7,29381925,121881968,2229464,1053543,122935511,117118731
29378777_1103369,CM021106.1,7,29378777,121882261,6102118,1103369,122985630,117168850
29381913_1444879,CM021106.1,7,29381913,121881969,6613606,1444879,123326848,117510068
29381913_1445041,CM021106.1,7,29381913,121881969,6613606,1445041,123327010,117510230
29381913_1445044,CM021106.1,7,29381913,121881969,6613606,1445044,123327013,117510233
29381913_1447933,CM021106.1,7,29381913,121881969,6613606,1447933,123329902,117513122
29381913_1478034,CM021106.1,7,29381913,121881969,6613606,1478034,123360003,117543223
29381913_1478291,CM021106.1,7,29381913,121881969,6613606,1478291,123360260,117543480
29381913_1478303,CM021106.1,7,29381913,121881969,6613606,1478303,123360272,117543492
29381913_1478320,CM021106.1,7,29381913,121881969,6613606,1478320,123360289,117543509
29381913_1507645,CM021106.1,7,29381913,121881969,6613606,1507645,123389614,117572834
29381913_1507653,CM021106.1,7,29381913,121881969,6613606,1507653,123389622,117572842
29381913_1507694,CM021106.1,7,29381913,121881969,6613606,1507694,123389663,117572883
29381913_1507711,CM021106.1,7,29381913,121881969,6613606,1507711,123389680,117572900
29381913_1507754,CM021106.1,7,29381913,121881969,6613606,1507754,123389723,117572943
29381913_1507755,CM021106.1,7,29381913,121881969,6613606,1507755,123389724,117572944
29381913_1507810,CM021106.1,7,29381913,121881969,6613606,1507810,123389779,117572999
29381913_1507865,CM021106.1,7,29381913,121881969,6613606,1507865,123389834,117573054
29381913_1508554,CM021106.1,7,29381913,121881969,6613606,1508554,123390523,117573743
29381913_1509140,CM021106.1,7,29381913,121881969,6613606,1509140,123391109,117574329
29381913_1509141,CM021106.1,7,29381913,121881969,6613606,1509141,123391110,117574330
29381913_1509156,CM021106.1,7,29381913,121881969,6613606,1509156,123391125,117574345
29381913_1509171,CM021106.1,7,29381913,121881969,6613606,1509171,123391140,117574360
29378653_1838788,CM021106.1,7,29378653,121882303,4353445,1838788,123721091,117904311
29378653_1838869,CM021106.1,7,29378653,121882303,4353445,1838869,123721172,117904392
29378653_1838877,CM021106.1,7,29378653,121882303,4353445,1838877,123721180,117904400
29378653_1839079,CM021106.1,7,29378653,121882303,4353445,1839079,123721382,117904602
29378653_1839152,CM021106.1,7,29378653,121882303,4353445,1839152,123721455,117904675
29378653_1839174,CM021106.1,7,29378653,121882303,4353445,1839174,123721477,117904697
29378653_1910927,CM021106.1,7,29378653,121882303,4353445,1910927,123793230,117976450
29378653_1910965,CM021106.1,7,29378653,121882303,4353445,1910965,123793268,117976488
29381925_2053228,CM021106.1,7,29381925,121881968,2229464,2053228,123935196,118118416
29381925_2053254,CM021106.1,7,29381925,121881968,2229464,2053254,123935222,118118442
29381925_2053255,CM021106.1,7,29381925,121881968,2229464,2053255,123935223,118118443
29381925_2053289,CM021106.1,7,29381925,121881968,2229464,2053289,123935257,118118477
29381925_2053327,CM021106.1,7,29381925,121881968,2229464,2053327,123935295,118118515
29381925_2053332,CM021106.1,7,29381925,121881968,2229464,2053332,123935300,118118520
29381925_2053348,CM021106.1,7,29381925,121881968,2229464,2053348,123935316,118118536
29381925_2053351,CM021106.1,7,29381925,121881968,2229464,2053351,123935319,118118539
29381925_2053353,CM021106.1,7,29381925,121881968,2229464,2053353,123935321,118118541
29381925_2053366,CM021106.1,7,29381925,121881968,2229464,2053366,123935334,118118554
29381925_2053383,CM021106.1,7,29381925,121881968,2229464,2053383,123935351,118118571
29381925_2053385,CM021106.1,7,29381925,121881968,2229464,2053385,123935353,118118573
29381913_2067187,CM021106.1,7,29381913,121881969,6613606,2067187,123949156,118132376
29381913_2067202,CM021106.1,7,29381913,121881969,6613606,2067202,123949171,118132391
29381913_2067300,CM021106.1,7,29381913,121881969,6613606,2067300,123949269,118132489
29381913_2067328,CM021106.1,7,29381913,121881969,6613606,2067328,123949297,118132517
29381913_2067428,CM021106.1,7,29381913,121881969,6613606,2067428,123949397,118132617
29381913_2067434,CM021106.1,7,29381913,121881969,6613606,2067434,123949403,118132623
29381913_2067437,CM021106.1,7,29381913,121881969,6613606,2067437,123949406,118132626
29381913_2067462,CM021106.1,7,29381913,121881969,6613606,2067462,123949431,118132651
29381913_2067477,CM021106.1,7,29381913,121881969,6613606,2067477,123949446,118132666
29381913_2067506,CM021106.1,7,29381913,121881969,6613606,2067506,123949475,118132695
29381913_2067509,CM021106.1,7,29381913,121881969,6613606,2067509,123949478,118132698
29381925_2124480,CM021106.1,7,29381925,121881968,2229464,2124480,124006448,118189668
29381925_2124481,CM021106.1,7,29381925,121881968,2229464,2124481,124006449,118189669
29381925_2124515,CM021106.1,7,29381925,121881968,2229464,2124515,124006483,118189703
29381925_2124540,CM021106.1,7,29381925,121881968,2229464,2124540,124006508,118189728
29381925_2124551,CM021106.1,7,29381925,121881968,2229464,2124551,124006519,118189739
29378653_2222843,CM021106.1,7,29378653,121882303,4353445,2222843,124105146,118288366
29378653_2222980,CM021106.1,7,29378653,121882303,4353445,2222980,124105283,118288503
29379796_2293520,CM021106.1,7,29379796,121881969,3554840,2293520,124175489,118358709
29378268_2306032,CM021106.1,7,29378268,121881968,3003906,2306032,124188000,118371220
29381913_2382830,CM021106.1,7,29381913,121881969,6613606,2382830,124264799,118448019
29381913_2382903,CM021106.1,7,29381913,121881969,6613606,2382903,124264872,118448092
29381913_2382906,CM021106.1,7,29381913,121881969,6613606,2382906,124264875,118448095
29381913_2382940,CM021106.1,7,29381913,121881969,6613606,2382940,124264909,118448129
29381913_2386358,CM021106.1,7,29381913,121881969,6613606,2386358,124268327,118451547
29380854_2478058,CM021106.1,7,29380854,121881968,8295417,2478058,124360026,118543246
29380854_2478116,CM021106.1,7,29380854,121881968,8295417,2478116,124360084,118543304
29381913_2908861,CM021106.1,7,29381913,121881969,6613606,2908861,124790830,118974050
29381913_2908901,CM021106.1,7,29381913,121881969,6613606,2908901,124790870,118974090
29381913_2908928,CM021106.1,7,29381913,121881969,6613606,2908928,124790897,118974117
29381913_2908976,CM021106.1,7,29381913,121881969,6613606,2908976,124790945,118974165
29381913_2909014,CM021106.1,7,29381913,121881969,6613606,2909014,124790983,118974203
29381913_2909024,CM021106.1,7,29381913,121881969,6613606,2909024,124790993,118974213
29381913_2909028,CM021106.1,7,29381913,121881969,6613606,2909028,124790997,118974217
29381913_2909181,CM021106.1,7,29381913,121881969,6613606,2909181,124791150,118974370
29381913_2918727,CM021106.1,7,29381913,121881969,6613606,2918727,124800696,118983916
29381913_2918763,CM021106.1,7,29381913,121881969,6613606,2918763,124800732,118983952
29381913_2918808,CM021106.1,7,29381913,121881969,6613606,2918808,124800777,118983997
29381913_2918904,CM021106.1,7,29381913,121881969,6613606,2918904,124800873,118984093
29381913_2918905,CM021106.1,7,29381913,121881969,6613606,2918905,124800874,118984094
29381913_3098042,CM021106.1,7,29381913,121881969,6613606,3098042,124980011,119163231
29378653_3641273,CM021106.1,7,29378653,121882303,4353445,3641273,125523576,119706796
29378653_3641276,CM021106.1,7,29378653,121882303,4353445,3641276,125523579,119706799
29378653_3641284,CM021106.1,7,29378653,121882303,4353445,3641284,125523587,119706807
29378653_3641327,CM021106.1,7,29378653,121882303,4353445,3641327,125523630,119706850
29378653_3793402,CM021106.1,7,29378653,121882303,4353445,3793402,125675705,119858925
29378653_3793595,CM021106.1,7,29378653,121882303,4353445,3793595,125675898,119859118
29378653_4146144,CM021106.1,7,29378653,121882303,4353445,4146144,126028447,120211667
29378777_4273543,CM021106.1,7,29378777,121882261,6102118,4273543,126155804,120339024
29378777_4273546,CM021106.1,7,29378777,121882261,6102118,4273546,126155807,120339027
29378777_4273551,CM021106.1,7,29378777,121882261,6102118,4273551,126155812,120339032
29378777_4273583,CM021106.1,7,29378777,121882261,6102118,4273583,126155844,120339064
29378777_4273594,CM021106.1,7,29378777,121882261,6102118,4273594,126155855,120339075
29378777_4273636,CM021106.1,7,29378777,121882261,6102118,4273636,126155897,120339117
29378777_4273790,CM021106.1,7,29378777,121882261,6102118,4273790,126156051,120339271
29381913_4553355,CM021106.1,7,29381913,121881969,6613606,4553355,126435324,120618544
29381913_4553369,CM021106.1,7,29381913,121881969,6613606,4553369,126435338,120618558
29378777_5023657,CM021106.1,7,29378777,121882261,6102118,5023657,126905918,121089138
29381913_5655954,CM021106.1,7,29381913,121881969,6613606,5655954,127537923,121721143
29381913_5656049,CM021106.1,7,29381913,121881969,6613606,5656049,127538018,121721238
29380854_7973629,CM021106.1,7,29380854,121881968,8295417,7973629,129855597,124038817
29380854_7973703,CM021106.1,7,29380854,121881968,8295417,7973703,129855671,124038891
29373773_12672,CM021106.1,7,29373773,132343719,24996,12672,132356391,126539611
29379984_199599,CM021106.1,7,29379984,132338213,762083,199599,132537812,126721032
29379984_199797,CM021106.1,7,29379984,132338213,762083,199797,132538010,126721230
29379984_199965,CM021106.1,7,29379984,132338213,762083,199965,132538178,126721398
29379984_229321,CM021106.1,7,29379984,132338213,762083,229321,132567534,126750754
29379984_229373,CM021106.1,7,29379984,132338213,762083,229373,132567586,126750806
29381846_252979,CM021106.1,7,29381846,132337011,273486,252979,132589990,126773210
29379984_385478,CM021106.1,7,29379984,132338213,762083,385478,132723691,126906911
29379984_452037,CM021106.1,7,29379984,132338213,762083,452037,132790250,126973470
29378317_478479,CM021106.1,7,29378317,132338890,938105,478479,132817369,127000589
29380640_493148,CM021106.1,7,29380640,132338645,3051895,493148,132831793,127015013
29380640_493159,CM021106.1,7,29380640,132338645,3051895,493159,132831804,127015024
29380640_493160,CM021106.1,7,29380640,132338645,3051895,493160,132831805,127015025
29380640_493274,CM021106.1,7,29380640,132338645,3051895,493274,132831919,127015139
29378317_496605,CM021106.1,7,29378317,132338890,938105,496605,132835495,127018715
29378317_496699,CM021106.1,7,29378317,132338890,938105,496699,132835589,127018809
29378881_628093,CM021106.1,7,29378881,132338481,2202586,628093,132966574,127149794
29378881_628098,CM021106.1,7,29378881,132338481,2202586,628098,132966579,127149799
29378881_628124,CM021106.1,7,29378881,132338481,2202586,628124,132966605,127149825
29378881_628236,CM021106.1,7,29378881,132338481,2202586,628236,132966717,127149937
29379984_671265,CM021106.1,7,29379984,132338213,762083,671265,133009478,127192698
29379993_690402,CM021106.1,7,29379993,132337014,2345573,690402,133027416,127210636
29379993_690465,CM021106.1,7,29379993,132337014,2345573,690465,133027479,127210699
29379993_690511,CM021106.1,7,29379993,132337014,2345573,690511,133027525,127210745
29379993_690524,CM021106.1,7,29379993,132337014,2345573,690524,133027538,127210758
29379993_690535,CM021106.1,7,29379993,132337014,2345573,690535,133027549,127210769
29379993_690542,CM021106.1,7,29379993,132337014,2345573,690542,133027556,127210776
29379993_690572,CM021106.1,7,29379993,132337014,2345573,690572,133027586,127210806
29379993_690604,CM021106.1,7,29379993,132337014,2345573,690604,133027618,127210838
29378317_900239,CM021106.1,7,29378317,132338890,938105,900239,133239129,127422349
29378317_930487,CM021106.1,7,29378317,132338890,938105,930487,133269377,127452597
29379993_935278,CM021106.1,7,29379993,132337014,2345573,935278,133272292,127455512
29379993_935299,CM021106.1,7,29379993,132337014,2345573,935299,133272313,127455533
29377097_1010929,CM021106.1,7,29377097,132337014,3818863,1010929,133347943,127531163
29377097_1015688,CM021106.1,7,29377097,132337014,3818863,1015688,133352702,127535922
29379993_1137675,CM021106.1,7,29379993,132337014,2345573,1137675,133474689,127657909
29378373_1146346,CM021106.1,7,29378373,132338995,3599844,1146346,133485341,127668561
29378373_1178224,CM021106.1,7,29378373,132338995,3599844,1178224,133517219,127700439
29378373_1486779,CM021106.1,7,29378373,132338995,3599844,1486779,133825774,128008994
29378373_1486801,CM021106.1,7,29378373,132338995,3599844,1486801,133825796,128009016
29378373_1533197,CM021106.1,7,29378373,132338995,3599844,1533197,133872192,128055412
29378373_1613510,CM021106.1,7,29378373,132338995,3599844,1613510,133952505,128135725
29379993_1686043,CM021106.1,7,29379993,132337014,2345573,1686043,134023057,128206277
29378881_1722102,CM021106.1,7,29378881,132338481,2202586,1722102,134060583,128243803
29378881_1722104,CM021106.1,7,29378881,132338481,2202586,1722104,134060585,128243805
29378881_1722106,CM021106.1,7,29378881,132338481,2202586,1722106,134060587,128243807
29380346_1744191,CM021106.1,7,29380346,132338858,1808735,1744191,134083049,128266269
29380640_1752345,CM021106.1,7,29380640,132338645,3051895,1752345,134090990,128274210
29380640_1752356,CM021106.1,7,29380640,132338645,3051895,1752356,134091001,128274221
29380640_1752384,CM021106.1,7,29380640,132338645,3051895,1752384,134091029,128274249
29380640_1752390,CM021106.1,7,29380640,132338645,3051895,1752390,134091035,128274255
29380640_1752452,CM021106.1,7,29380640,132338645,3051895,1752452,134091097,128274317
29378373_1817364,CM021106.1,7,29378373,132338995,3599844,1817364,134156359,128339579
29378373_1817428,CM021106.1,7,29378373,132338995,3599844,1817428,134156423,128339643
29378373_1817498,CM021106.1,7,29378373,132338995,3599844,1817498,134156493,128339713
29377097_1885381,CM021106.1,7,29377097,132337014,3818863,1885381,134222395,128405615
29377097_1886231,CM021106.1,7,29377097,132337014,3818863,1886231,134223245,128406465
29377097_1886304,CM021106.1,7,29377097,132337014,3818863,1886304,134223318,128406538
29377097_2832018,CM021106.1,7,29377097,132337014,3818863,2832018,135169032,129352252
29377097_2866572,CM021106.1,7,29377097,132337014,3818863,2866572,135203586,129386806
29377097_2868989,CM021106.1,7,29377097,132337014,3818863,2868989,135206003,129389223
29377097_2880366,CM021106.1,7,29377097,132337014,3818863,2880366,135217380,129400600
29377097_2883650,CM021106.1,7,29377097,132337014,3818863,2883650,135220664,129403884
29377097_2883661,CM021106.1,7,29377097,132337014,3818863,2883661,135220675,129403895
29377097_2883662,CM021106.1,7,29377097,132337014,3818863,2883662,135220676,129403896
29377097_2885236,CM021106.1,7,29377097,132337014,3818863,2885236,135222250,129405470
29378373_2903674,CM021106.1,7,29378373,132338995,3599844,2903674,135242669,129425889
29378373_2903691,CM021106.1,7,29378373,132338995,3599844,2903691,135242686,129425906
29378373_2904088,CM021106.1,7,29378373,132338995,3599844,2904088,135243083,129426303
29377097_3600406,CM021106.1,7,29377097,132337014,3818863,3600406,135937420,130120640
29381943_316713,CM021106.1,7,29381943,162139629,913034,316713,162456342,156639562
29381572_12726,CM021106.1,7,29381572,181967439,1508212,12726,181980165,176163385
29365696_34404,CM021106.1,7,29365696,181967440,111322,34404,182001844,176185064
29365696_34482,CM021106.1,7,29365696,181967440,111322,34482,182001922,176185142
29379462_525056,CM021106.1,7,29379462,181967436,1477175,525056,182492492,176675712
29379462_525500,CM021106.1,7,29379462,181967436,1477175,525500,182492936,176676156
29379462_525512,CM021106.1,7,29379462,181967436,1477175,525512,182492948,176676168
29381572_1326254,CM021106.1,7,29381572,181967439,1508212,1326254,183293693,177476913
29381572_1326314,CM021106.1,7,29381572,181967439,1508212,1326314,183293753,177476973
29381572_1326315,CM021106.1,7,29381572,181967439,1508212,1326315,183293754,177476974
29381572_1326340,CM021106.1,7,29381572,181967439,1508212,1326340,183293779,177476999
29381572_1326346,CM021106.1,7,29381572,181967439,1508212,1326346,183293785,177477005
29381951_157302,CM021106.1,7,29381951,191330391,181268,157302,191487693,185670913
29362881_277152,CM021106.1,7,29362881,200352505,497698,277152,200629657,194812877
29351431_395181,CM021106.1,7,29351431,200352717,1311602,395181,200747898,194931118
29379434_15961,CM021106.1,7,29379434,204278371,1826717,15961,204294332,198477552
29379434_15962,CM021106.1,7,29379434,204278371,1826717,15962,204294333,198477553
29379434_15973,CM021106.1,7,29379434,204278371,1826717,15973,204294344,198477564
29379434_15994,CM021106.1,7,29379434,204278371,1826717,15994,204294365,198477585
29379434_78845,CM021106.1,7,29379434,204278371,1826717,78845,204357216,198540436
29379930_96776,CM021106.1,7,29379930,204280686,1095646,96776,204377462,198560682
29379434_100368,CM021106.1,7,29379434,204278371,1826717,100368,204378739,198561959
29379434_100452,CM021106.1,7,29379434,204278371,1826717,100452,204378823,198562043
29377723_102830,CM021106.1,7,29377723,204278372,257041,102830,204381202,198564422
29377723_102868,CM021106.1,7,29377723,204278372,257041,102868,204381240,198564460
29377723_102899,CM021106.1,7,29377723,204278372,257041,102899,204381271,198564491
29377723_102900,CM021106.1,7,29377723,204278372,257041,102900,204381272,198564492
29377723_102953,CM021106.1,7,29377723,204278372,257041,102953,204381325,198564545
29377723_102965,CM021106.1,7,29377723,204278372,257041,102965,204381337,198564557
29377723_102968,CM021106.1,7,29377723,204278372,257041,102968,204381340,198564560
29377723_103031,CM021106.1,7,29377723,204278372,257041,103031,204381403,198564623
29377723_103038,CM021106.1,7,29377723,204278372,257041,103038,204381410,198564630
29377188_112752,CM021106.1,7,29377188,204278372,687595,112752,204391124,198574344
29377188_112860,CM021106.1,7,29377188,204278372,687595,112860,204391232,198574452
29379991_134533,CM021106.1,7,29379991,204278777,3745999,134533,204413310,198596530
29379991_134574,CM021106.1,7,29379991,204278777,3745999,134574,204413351,198596571
29379991_134576,CM021106.1,7,29379991,204278777,3745999,134576,204413353,198596573
29379991_134623,CM021106.1,7,29379991,204278777,3745999,134623,204413400,198596620
29379930_134703,CM021106.1,7,29379930,204280686,1095646,134703,204415389,198598609
29381290_216144,CM021106.1,7,29381290,204280373,5807803,216144,204496517,198679737
29381290_216213,CM021106.1,7,29381290,204280373,5807803,216213,204496586,198679806
29377188_240835,CM021106.1,7,29377188,204278372,687595,240835,204519207,198702427
29377188_240957,CM021106.1,7,29377188,204278372,687595,240957,204519329,198702549
29377188_240971,CM021106.1,7,29377188,204278372,687595,240971,204519343,198702563
29377188_240982,CM021106.1,7,29377188,204278372,687595,240982,204519354,198702574
29381290_246347,CM021106.1,7,29381290,204280373,5807803,246347,204526720,198709940
29381290_458508,CM021106.1,7,29381290,204280373,5807803,458508,204738881,198922101
29380308_556528,CM021106.1,7,29380308,204278372,3527647,556528,204834900,199018120
29380308_556550,CM021106.1,7,29380308,204278372,3527647,556550,204834922,199018142
29379930_603496,CM021106.1,7,29379930,204280686,1095646,603496,204884182,199067402
29379930_673436,CM021106.1,7,29379930,204280686,1095646,673436,204954122,199137342
29379502_757285,CM021106.1,7,29379502,204278371,1304983,757285,205035656,199218876
29379502_757291,CM021106.1,7,29379502,204278371,1304983,757291,205035662,199218882
29379502_757293,CM021106.1,7,29379502,204278371,1304983,757293,205035664,199218884
29379502_757294,CM021106.1,7,29379502,204278371,1304983,757294,205035665,199218885
29379502_757301,CM021106.1,7,29379502,204278371,1304983,757301,205035672,199218892
29379502_757317,CM021106.1,7,29379502,204278371,1304983,757317,205035688,199218908
29379502_757328,CM021106.1,7,29379502,204278371,1304983,757328,205035699,199218919
29379502_757334,CM021106.1,7,29379502,204278371,1304983,757334,205035705,199218925
29379502_757339,CM021106.1,7,29379502,204278371,1304983,757339,205035710,199218930
29379502_757342,CM021106.1,7,29379502,204278371,1304983,757342,205035713,199218933
29379502_757350,CM021106.1,7,29379502,204278371,1304983,757350,205035721,199218941
29379502_757371,CM021106.1,7,29379502,204278371,1304983,757371,205035742,199218962
29379502_757372,CM021106.1,7,29379502,204278371,1304983,757372,205035743,199218963
29379502_757373,CM021106.1,7,29379502,204278371,1304983,757373,205035744,199218964
29379502_757405,CM021106.1,7,29379502,204278371,1304983,757405,205035776,199218996
29379502_757407,CM021106.1,7,29379502,204278371,1304983,757407,205035778,199218998
29379502_757429,CM021106.1,7,29379502,204278371,1304983,757429,205035800,199219020
29379502_757440,CM021106.1,7,29379502,204278371,1304983,757440,205035811,199219031
29379502_757445,CM021106.1,7,29379502,204278371,1304983,757445,205035816,199219036
29379502_757482,CM021106.1,7,29379502,204278371,1304983,757482,205035853,199219073
29380760_1001704,CM021106.1,7,29380760,204279092,1311464,1001704,205280796,199464016
29380760_1001733,CM021106.1,7,29380760,204279092,1311464,1001733,205280825,199464045
29379958_1038988,CM021106.1,7,29379958,204278646,3646785,1038988,205317634,199500854
29379958_1039099,CM021106.1,7,29379958,204278646,3646785,1039099,205317745,199500965
29379958_1039129,CM021106.1,7,29379958,204278646,3646785,1039129,205317775,199500995
29379958_1039143,CM021106.1,7,29379958,204278646,3646785,1039143,205317789,199501009
29380723_1046280,CM021106.1,7,29380723,204278372,2112039,1046280,205324652,199507872
29380308_1248561,CM021106.1,7,29380308,204278372,3527647,1248561,205526933,199710153
29380308_1248565,CM021106.1,7,29380308,204278372,3527647,1248565,205526937,199710157
29380308_1248589,CM021106.1,7,29380308,204278372,3527647,1248589,205526961,199710181
29380308_1248612,CM021106.1,7,29380308,204278372,3527647,1248612,205526984,199710204
29380308_1248633,CM021106.1,7,29380308,204278372,3527647,1248633,205527005,199710225
29380308_1248639,CM021106.1,7,29380308,204278372,3527647,1248639,205527011,199710231
29380308_1248650,CM021106.1,7,29380308,204278372,3527647,1248650,205527022,199710242
29380308_1248686,CM021106.1,7,29380308,204278372,3527647,1248686,205527058,199710278
29380723_1290870,CM021106.1,7,29380723,204278372,2112039,1290870,205569242,199752462
29380760_1303245,CM021106.1,7,29380760,204279092,1311464,1303245,205582337,199765557
29380760_1303331,CM021106.1,7,29380760,204279092,1311464,1303331,205582423,199765643
29380723_1311557,CM021106.1,7,29380723,204278372,2112039,1311557,205589929,199773149
29380723_1409944,CM021106.1,7,29380723,204278372,2112039,1409944,205688316,199871536
29380723_1410006,CM021106.1,7,29380723,204278372,2112039,1410006,205688378,199871598
29380723_1410035,CM021106.1,7,29380723,204278372,2112039,1410035,205688407,199871627
29380723_1410164,CM021106.1,7,29380723,204278372,2112039,1410164,205688536,199871756
29380308_1411119,CM021106.1,7,29380308,204278372,3527647,1411119,205689491,199872711
29380308_1411198,CM021106.1,7,29380308,204278372,3527647,1411198,205689570,199872790
29380308_1411204,CM021106.1,7,29380308,204278372,3527647,1411204,205689576,199872796
29380158_1437425,CM021106.1,7,29380158,204278370,2167518,1437425,205715795,199899015
29380308_1475412,CM021106.1,7,29380308,204278372,3527647,1475412,205753784,199937004
29380308_1565422,CM021106.1,7,29380308,204278372,3527647,1565422,205843794,200027014
29380308_1565461,CM021106.1,7,29380308,204278372,3527647,1565461,205843833,200027053
29380308_1565474,CM021106.1,7,29380308,204278372,3527647,1565474,205843846,200027066
29380308_1565501,CM021106.1,7,29380308,204278372,3527647,1565501,205843873,200027093
29380308_1565544,CM021106.1,7,29380308,204278372,3527647,1565544,205843916,200027136
29380308_1565602,CM021106.1,7,29380308,204278372,3527647,1565602,205843974,200027194
29380308_1565617,CM021106.1,7,29380308,204278372,3527647,1565617,205843989,200027209
29380308_1565618,CM021106.1,7,29380308,204278372,3527647,1565618,205843990,200027210
29380308_1566787,CM021106.1,7,29380308,204278372,3527647,1566787,205845159,200028379
29380308_1770200,CM021106.1,7,29380308,204278372,3527647,1770200,206048572,200231792
29380308_1770218,CM021106.1,7,29380308,204278372,3527647,1770218,206048590,200231810
29380308_1770236,CM021106.1,7,29380308,204278372,3527647,1770236,206048608,200231828
29380308_1826831,CM021106.1,7,29380308,204278372,3527647,1826831,206105203,200288423
29380308_1826882,CM021106.1,7,29380308,204278372,3527647,1826882,206105254,200288474
29380308_1827115,CM021106.1,7,29380308,204278372,3527647,1827115,206105487,200288707
29380308_1827116,CM021106.1,7,29380308,204278372,3527647,1827116,206105488,200288708
29380308_1827127,CM021106.1,7,29380308,204278372,3527647,1827127,206105499,200288719
29380308_1827129,CM021106.1,7,29380308,204278372,3527647,1827129,206105501,200288721
29380308_1827131,CM021106.1,7,29380308,204278372,3527647,1827131,206105503,200288723
29380308_1827148,CM021106.1,7,29380308,204278372,3527647,1827148,206105520,200288740
29380308_1827169,CM021106.1,7,29380308,204278372,3527647,1827169,206105541,200288761
29380308_1827177,CM021106.1,7,29380308,204278372,3527647,1827177,206105549,200288769
29380308_1827188,CM021106.1,7,29380308,204278372,3527647,1827188,206105560,200288780
29380723_2107652,CM021106.1,7,29380723,204278372,2112039,2107652,206386024,200569244
29379958_2379617,CM021106.1,7,29379958,204278646,3646785,2379617,206658263,200841483
29379958_2379687,CM021106.1,7,29379958,204278646,3646785,2379687,206658333,200841553
29379958_2379688,CM021106.1,7,29379958,204278646,3646785,2379688,206658334,200841554
29379958_2379691,CM021106.1,7,29379958,204278646,3646785,2379691,206658337,200841557
29379958_2379777,CM021106.1,7,29379958,204278646,3646785,2379777,206658423,200841643
29379958_2379807,CM021106.1,7,29379958,204278646,3646785,2379807,206658453,200841673
29381290_2391798,CM021106.1,7,29381290,204280373,5807803,2391798,206672171,200855391
29380308_2493059,CM021106.1,7,29380308,204278372,3527647,2493059,206771431,200954651
29380308_2493064,CM021106.1,7,29380308,204278372,3527647,2493064,206771436,200954656
29379991_2841612,CM021106.1,7,29379991,204278777,3745999,2841612,207120389,201303609
29379991_2841634,CM021106.1,7,29379991,204278777,3745999,2841634,207120411,201303631
29379991_2858686,CM021106.1,7,29379991,204278777,3745999,2858686,207137463,201320683
29379991_2903447,CM021106.1,7,29379991,204278777,3745999,2903447,207182224,201365444
29379991_2903529,CM021106.1,7,29379991,204278777,3745999,2903529,207182306,201365526
29379991_2903787,CM021106.1,7,29379991,204278777,3745999,2903787,207182564,201365784
29381290_3493531,CM021106.1,7,29381290,204280373,5807803,3493531,207773904,201957124
29350254_156136,CM021106.1,7,29350254,215578937,160245,156136,215735073,209918293
29350254_156149,CM021106.1,7,29350254,215578937,160245,156149,215735086,209918306
29378368_5450,CM021106.1,7,29378368,231497190,1051192,5450,231502640,225685860
29378368_5480,CM021106.1,7,29378368,231497190,1051192,5480,231502670,225685890
29382167_20820,CM021106.1,7,29382167,231497190,1103874,20820,231518010,225701230
29378368_33026,CM021106.1,7,29378368,231497190,1051192,33026,231530216,225713436
29382020_39254,CM021106.1,7,29382020,231497189,3754130,39254,231536443,225719663
29382020_42406,CM021106.1,7,29382020,231497189,3754130,42406,231539595,225722815
29382020_42408,CM021106.1,7,29382020,231497189,3754130,42408,231539597,225722817
29381309_80899,CM021106.1,7,29381309,231497189,1160031,80899,231578088,225761308
293683531_82395,CM021106.1,7,293683531,231497189,609111,82395,231579584,225762804
293683531_82396,CM021106.1,7,293683531,231497189,609111,82396,231579585,225762805
293683531_82402,CM021106.1,7,293683531,231497189,609111,82402,231579591,225762811
293683531_82436,CM021106.1,7,293683531,231497189,609111,82436,231579625,225762845
293683531_82457,CM021106.1,7,293683531,231497189,609111,82457,231579646,225762866
293683531_82480,CM021106.1,7,293683531,231497189,609111,82480,231579669,225762889
293683531_82486,CM021106.1,7,293683531,231497189,609111,82486,231579675,225762895
293683531_82500,CM021106.1,7,293683531,231497189,609111,82500,231579689,225762909
293683531_82504,CM021106.1,7,293683531,231497189,609111,82504,231579693,225762913
293683531_82582,CM021106.1,7,293683531,231497189,609111,82582,231579771,225762991
29382167_100171,CM021106.1,7,29382167,231497190,1103874,100171,231597361,225780581
29382167_100202,CM021106.1,7,29382167,231497190,1103874,100202,231597392,225780612
29378368_127607,CM021106.1,7,29378368,231497190,1051192,127607,231624797,225808017
29363277_151906,CM021106.1,7,29363277,231497190,251283,151906,231649096,225832316
29380711_154041,CM021106.1,7,29380711,231497189,980317,154041,231651230,225834450
29378944_161407,CM021106.1,7,29378944,231497190,388896,161407,231658597,225841817
29380154_197325,CM021106.1,7,29380154,231497190,1389634,197325,231694515,225877735
29380154_197339,CM021106.1,7,29380154,231497190,1389634,197339,231694529,225877749
29380154_197354,CM021106.1,7,29380154,231497190,1389634,197354,231694544,225877764
29380154_197381,CM021106.1,7,29380154,231497190,1389634,197381,231694571,225877791
29380154_197382,CM021106.1,7,29380154,231497190,1389634,197382,231694572,225877792
29380154_197410,CM021106.1,7,29380154,231497190,1389634,197410,231694600,225877820
29380154_197444,CM021106.1,7,29380154,231497190,1389634,197444,231694634,225877854
29380154_197445,CM021106.1,7,29380154,231497190,1389634,197445,231694635,225877855
29380154_197451,CM021106.1,7,29380154,231497190,1389634,197451,231694641,225877861
29382020_218162,CM021106.1,7,29382020,231497189,3754130,218162,231715351,225898571
29382020_218186,CM021106.1,7,29382020,231497189,3754130,218186,231715375,225898595
29382020_218288,CM021106.1,7,29382020,231497189,3754130,218288,231715477,225898697
29382020_218318,CM021106.1,7,29382020,231497189,3754130,218318,231715507,225898727
29382020_218341,CM021106.1,7,29382020,231497189,3754130,218341,231715530,225898750
293683531_284477,CM021106.1,7,293683531,231497189,609111,284477,231781666,225964886
293683531_284516,CM021106.1,7,293683531,231497189,609111,284516,231781705,225964925
293683531_284533,CM021106.1,7,293683531,231497189,609111,284533,231781722,225964942
293683531_284534,CM021106.1,7,293683531,231497189,609111,284534,231781723,225964943
293683531_284538,CM021106.1,7,293683531,231497189,609111,284538,231781727,225964947
293683531_284543,CM021106.1,7,293683531,231497189,609111,284543,231781732,225964952
29378545_291524,CM021106.1,7,29378545,231497190,4940653,291524,231788714,225971934
29378545_298740,CM021106.1,7,29378545,231497190,4940653,298740,231795930,225979150
29378545_298801,CM021106.1,7,29378545,231497190,4940653,298801,231795991,225979211
29378545_298828,CM021106.1,7,29378545,231497190,4940653,298828,231796018,225979238
29381309_304907,CM021106.1,7,29381309,231497189,1160031,304907,231802096,225985316
29378545_310001,CM021106.1,7,29378545,231497190,4940653,310001,231807191,225990411
29378944_331790,CM021106.1,7,29378944,231497190,388896,331790,231828980,226012200
29378944_331797,CM021106.1,7,29378944,231497190,388896,331797,231828987,226012207
29378944_331825,CM021106.1,7,29378944,231497190,388896,331825,231829015,226012235
29378944_331954,CM021106.1,7,29378944,231497190,388896,331954,231829144,226012364
29380309_357099,CM021106.1,7,29380309,231497189,5976979,357099,231854288,226037508
29380309_357146,CM021106.1,7,29380309,231497189,5976979,357146,231854335,226037555
29380309_357202,CM021106.1,7,29380309,231497189,5976979,357202,231854391,226037611
29379096_482563,CM021106.1,7,29379096,231497189,520399,482563,231979752,226162972
29377211_766580,CM021106.1,7,29377211,231497190,2243086,766580,232263770,226446990
29377211_766629,CM021106.1,7,29377211,231497190,2243086,766629,232263819,226447039
29380649_815934,CM021106.1,7,29380649,231497190,4474223,815934,232313124,226496344
29381309_842667,CM021106.1,7,29381309,231497189,1160031,842667,232339856,226523076
29377210_930195,CM021106.1,7,29377210,231497190,2442116,930195,232427385,226610605
29378545_1010192,CM021106.1,7,29378545,231497190,4940653,1010192,232507382,226690602
29378545_1010300,CM021106.1,7,29378545,231497190,4940653,1010300,232507490,226690710
29378545_1010339,CM021106.1,7,29378545,231497190,4940653,1010339,232507529,226690749
29377600_1018505,CM021106.1,7,29377600,231497189,3039931,1018505,232515694,226698914
29377600_1018506,CM021106.1,7,29377600,231497189,3039931,1018506,232515695,226698915
29377600_1056702,CM021106.1,7,29377600,231497189,3039931,1056702,232553891,226737111
29377600_1056763,CM021106.1,7,29377600,231497189,3039931,1056763,232553952,226737172
29377600_1072241,CM021106.1,7,29377600,231497189,3039931,1072241,232569430,226752650
29377600_1072283,CM021106.1,7,29377600,231497189,3039931,1072283,232569472,226752692
29377600_1072284,CM021106.1,7,29377600,231497189,3039931,1072284,232569473,226752693
29377600_1072327,CM021106.1,7,29377600,231497189,3039931,1072327,232569516,226752736
29377600_1072329,CM021106.1,7,29377600,231497189,3039931,1072329,232569518,226752738
29380154_1150108,CM021106.1,7,29380154,231497190,1389634,1150108,232647298,226830518
29380154_1150170,CM021106.1,7,29380154,231497190,1389634,1150170,232647360,226830580
29377600_1170081,CM021106.1,7,29377600,231497189,3039931,1170081,232667270,226850490
29377600_1170112,CM021106.1,7,29377600,231497189,3039931,1170112,232667301,226850521
29377600_1170206,CM021106.1,7,29377600,231497189,3039931,1170206,232667395,226850615
29377600_1170233,CM021106.1,7,29377600,231497189,3039931,1170233,232667422,226850642
29378545_1258466,CM021106.1,7,29378545,231497190,4940653,1258466,232755656,226938876
29378545_1258721,CM021106.1,7,29378545,231497190,4940653,1258721,232755911,226939131
29378545_1267857,CM021106.1,7,29378545,231497190,4940653,1267857,232765047,226948267
29378545_1313113,CM021106.1,7,29378545,231497190,4940653,1313113,232810303,226993523
29378545_1313115,CM021106.1,7,29378545,231497190,4940653,1313115,232810305,226993525
29378545_1313152,CM021106.1,7,29378545,231497190,4940653,1313152,232810342,226993562
29378545_1313198,CM021106.1,7,29378545,231497190,4940653,1313198,232810388,226993608
29377600_1335156,CM021106.1,7,29377600,231497189,3039931,1335156,232832345,227015565
29377600_1335184,CM021106.1,7,29377600,231497189,3039931,1335184,232832373,227015593
29381440_1342648,CM021106.1,7,29381440,231497188,1499404,1342648,232839836,227023056
29378545_1559980,CM021106.1,7,29378545,231497190,4940653,1559980,233057170,227240390
29378545_1560905,CM021106.1,7,29378545,231497190,4940653,1560905,233058095,227241315
29380649_1726169,CM021106.1,7,29380649,231497190,4474223,1726169,233223359,227406579
29380649_1726183,CM021106.1,7,29380649,231497190,4474223,1726183,233223373,227406593
29380649_1729551,CM021106.1,7,29380649,231497190,4474223,1729551,233226741,227409961
29377082_1730863,CM021106.1,7,29377082,231497190,4148452,1730863,233228053,227411273
29377082_1730915,CM021106.1,7,29377082,231497190,4148452,1730915,233228105,227411325
29378545_2231879,CM021106.1,7,29378545,231497190,4940653,2231879,233729069,227912289
29378545_2232439,CM021106.1,7,29378545,231497190,4940653,2232439,233729629,227912849
29378545_2232647,CM021106.1,7,29378545,231497190,4940653,2232647,233729837,227913057
29380948_2266105,CM021106.1,7,29380948,231497187,2791889,2266105,233763292,227946512
29380948_2266228,CM021106.1,7,29380948,231497187,2791889,2266228,233763415,227946635
29378545_2303314,CM021106.1,7,29378545,231497190,4940653,2303314,233800504,227983724
29380948_2477677,CM021106.1,7,29380948,231497187,2791889,2477677,233974864,228158084
29380948_2477687,CM021106.1,7,29380948,231497187,2791889,2477687,233974874,228158094
29380948_2531679,CM021106.1,7,29380948,231497187,2791889,2531679,234028866,228212086
29381140_2596417,CM021106.1,7,29381140,231497190,3238255,2596417,234093607,228276827
29381140_2596458,CM021106.1,7,29381140,231497190,3238255,2596458,234093648,228276868
29381140_2596508,CM021106.1,7,29381140,231497190,3238255,2596508,234093698,228276918
29381140_2670101,CM021106.1,7,29381140,231497190,3238255,2670101,234167291,228350511
29381140_2670728,CM021106.1,7,29381140,231497190,3238255,2670728,234167918,228351138
29378545_2676788,CM021106.1,7,29378545,231497190,4940653,2676788,234173978,228357198
29381140_2799546,CM021106.1,7,29381140,231497190,3238255,2799546,234296736,228479956
29381140_2799651,CM021106.1,7,29381140,231497190,3238255,2799651,234296841,228480061
29381140_2799665,CM021106.1,7,29381140,231497190,3238255,2799665,234296855,228480075
29381140_2799710,CM021106.1,7,29381140,231497190,3238255,2799710,234296900,228480120
29381140_2799726,CM021106.1,7,29381140,231497190,3238255,2799726,234296916,228480136
29381140_2799742,CM021106.1,7,29381140,231497190,3238255,2799742,234296932,228480152
29381140_2799756,CM021106.1,7,29381140,231497190,3238255,2799756,234296946,228480166
29380309_2953632,CM021106.1,7,29380309,231497189,5976979,2953632,234450821,228634041
29380309_2953717,CM021106.1,7,29380309,231497189,5976979,2953717,234450906,228634126
29380309_2953748,CM021106.1,7,29380309,231497189,5976979,2953748,234450937,228634157
29380309_2953786,CM021106.1,7,29380309,231497189,5976979,2953786,234450975,228634195
29377082_3189210,CM021106.1,7,29377082,231497190,4148452,3189210,234686400,228869620
29377082_3189212,CM021106.1,7,29377082,231497190,4148452,3189212,234686402,228869622
29377082_3189223,CM021106.1,7,29377082,231497190,4148452,3189223,234686413,228869633
29377082_3189267,CM021106.1,7,29377082,231497190,4148452,3189267,234686457,228869677
29380309_3204348,CM021106.1,7,29380309,231497189,5976979,3204348,234701537,228884757
29382020_3268767,CM021106.1,7,29382020,231497189,3754130,3268767,234765956,228949176
29380309_3504154,CM021106.1,7,29380309,231497189,5976979,3504154,235001343,229184563
29380309_3755687,CM021106.1,7,29380309,231497189,5976979,3755687,235252876,229436096
29378545_3964653,CM021106.1,7,29378545,231497190,4940653,3964653,235461843,229645063
29378545_4030294,CM021106.1,7,29378545,231497190,4940653,4030294,235527484,229710704
29378545_4047805,CM021106.1,7,29378545,231497190,4940653,4047805,235544995,229728215
29378545_4047829,CM021106.1,7,29378545,231497190,4940653,4047829,235545019,229728239
29378545_4048056,CM021106.1,7,29378545,231497190,4940653,4048056,235545246,229728466
29380309_4671362,CM021106.1,7,29380309,231497189,5976979,4671362,236168551,230351771
29380309_4671443,CM021106.1,7,29380309,231497189,5976979,4671443,236168632,230351852
29378545_4874810,CM021106.1,7,29378545,231497190,4940653,4874810,236372000,230555220
29378545_4883289,CM021106.1,7,29378545,231497190,4940653,4883289,236380479,230563699
29378545_4883291,CM021106.1,7,29378545,231497190,4940653,4883291,236380481,230563701
29378545_4883337,CM021106.1,7,29378545,231497190,4940653,4883337,236380527,230563747
29380309_5399055,CM021106.1,7,29380309,231497189,5976979,5399055,236896244,231079464
29380309_5399240,CM021106.1,7,29380309,231497189,5976979,5399240,236896429,231079649
29380309_5915278,CM021106.1,7,29380309,231497189,5976979,5915278,237412467,231595687
29341462_12490,CM021106.1,7,29341462,237844172,23676,12490,237856662,232039882
29341462_12500,CM021106.1,7,29341462,237844172,23676,12500,237856672,232039892
29341462_12517,CM021106.1,7,29341462,237844172,23676,12517,237856689,232039909
29341462_12523,CM021106.1,7,29341462,237844172,23676,12523,237856695,232039915
29341462_12535,CM021106.1,7,29341462,237844172,23676,12535,237856707,232039927
29341462_12538,CM021106.1,7,29341462,237844172,23676,12538,237856710,232039930
29341462_12548,CM021106.1,7,29341462,237844172,23676,12548,237856720,232039940
29341462_12556,CM021106.1,7,29341462,237844172,23676,12556,237856728,232039948
29341462_12634,CM021106.1,7,29341462,237844172,23676,12634,237856806,232040026
29341462_12654,CM021106.1,7,29341462,237844172,23676,12654,237856826,232040046
29341462_12676,CM021106.1,7,29341462,237844172,23676,12676,237856848,232040068
29341462_12677,CM021106.1,7,29341462,237844172,23676,12677,237856849,232040069
29341462_12691,CM021106.1,7,29341462,237844172,23676,12691,237856863,232040083
29341462_12707,CM021106.1,7,29341462,237844172,23676,12707,237856879,232040099
29381231_249341,CM021106.1,7,29381231,237844458,1754202,249341,238093799,232277019
29381231_249346,CM021106.1,7,29381231,237844458,1754202,249346,238093804,232277024
29381231_249347,CM021106.1,7,29381231,237844458,1754202,249347,238093805,232277025
29381231_249355,CM021106.1,7,29381231,237844458,1754202,249355,238093813,232277033
29381231_249357,CM021106.1,7,29381231,237844458,1754202,249357,238093815,232277035
29381231_249369,CM021106.1,7,29381231,237844458,1754202,249369,238093827,232277047
29381231_249381,CM021106.1,7,29381231,237844458,1754202,249381,238093839,232277059
29381231_249389,CM021106.1,7,29381231,237844458,1754202,249389,238093847,232277067
29381231_249416,CM021106.1,7,29381231,237844458,1754202,249416,238093874,232277094
29381231_249427,CM021106.1,7,29381231,237844458,1754202,249427,238093885,232277105
29381231_249440,CM021106.1,7,29381231,237844458,1754202,249440,238093898,232277118
29381231_249445,CM021106.1,7,29381231,237844458,1754202,249445,238093903,232277123
29381231_249472,CM021106.1,7,29381231,237844458,1754202,249472,238093930,232277150
29381231_249474,CM021106.1,7,29381231,237844458,1754202,249474,238093932,232277152
29381231_249482,CM021106.1,7,29381231,237844458,1754202,249482,238093940,232277160
29381231_249491,CM021106.1,7,29381231,237844458,1754202,249491,238093949,232277169
29380538_267805,CM021106.1,7,29380538,237844173,1928270,267805,238111978,232295198
29380538_267892,CM021106.1,7,29380538,237844173,1928270,267892,238112065,232295285
29380538_268362,CM021106.1,7,29380538,237844173,1928270,268362,238112535,232295755
29381927_327220,CM021106.1,7,29381927,237844173,7504292,327220,238171393,232354613
29381927_327225,CM021106.1,7,29381927,237844173,7504292,327225,238171398,232354618
29381927_327231,CM021106.1,7,29381927,237844173,7504292,327231,238171404,232354624
29381927_327278,CM021106.1,7,29381927,237844173,7504292,327278,238171451,232354671
29381927_327301,CM021106.1,7,29381927,237844173,7504292,327301,238171474,232354694
29381927_327325,CM021106.1,7,29381927,237844173,7504292,327325,238171498,232354718
29381927_327334,CM021106.1,7,29381927,237844173,7504292,327334,238171507,232354727
29381927_341908,CM021106.1,7,29381927,237844173,7504292,341908,238186081,232369301
29381927_343477,CM021106.1,7,29381927,237844173,7504292,343477,238187650,232370870
29381927_343508,CM021106.1,7,29381927,237844173,7504292,343508,238187681,232370901
29381927_343513,CM021106.1,7,29381927,237844173,7504292,343513,238187686,232370906
29381927_343564,CM021106.1,7,29381927,237844173,7504292,343564,238187737,232370957
29381927_343592,CM021106.1,7,29381927,237844173,7504292,343592,238187765,232370985
29381927_343613,CM021106.1,7,29381927,237844173,7504292,343613,238187786,232371006
29381927_343651,CM021106.1,7,29381927,237844173,7504292,343651,238187824,232371044
29380538_391378,CM021106.1,7,29380538,237844173,1928270,391378,238235551,232418771
29380538_430317,CM021106.1,7,29380538,237844173,1928270,430317,238274490,232457710
29380538_430326,CM021106.1,7,29380538,237844173,1928270,430326,238274499,232457719
29380538_430327,CM021106.1,7,29380538,237844173,1928270,430327,238274500,232457720
29380538_430331,CM021106.1,7,29380538,237844173,1928270,430331,238274504,232457724
29380538_430348,CM021106.1,7,29380538,237844173,1928270,430348,238274521,232457741
29380538_430367,CM021106.1,7,29380538,237844173,1928270,430367,238274540,232457760
29380538_430374,CM021106.1,7,29380538,237844173,1928270,430374,238274547,232457767
29380412_438382,CM021106.1,7,29380412,237844175,1280863,438382,238282557,232465777
29380412_438421,CM021106.1,7,29380412,237844175,1280863,438421,238282596,232465816
29380412_438961,CM021106.1,7,29380412,237844175,1280863,438961,238283136,232466356
29380412_448110,CM021106.1,7,29380412,237844175,1280863,448110,238292285,232475505
29380169_455159,CM021106.1,7,29380169,237844175,1380591,455159,238299334,232482554
29380169_455254,CM021106.1,7,29380169,237844175,1380591,455254,238299429,232482649
29380412_466839,CM021106.1,7,29380412,237844175,1280863,466839,238311014,232494234
29380412_466855,CM021106.1,7,29380412,237844175,1280863,466855,238311030,232494250
29380412_466872,CM021106.1,7,29380412,237844175,1280863,466872,238311047,232494267
29380412_466899,CM021106.1,7,29380412,237844175,1280863,466899,238311074,232494294
29380412_466924,CM021106.1,7,29380412,237844175,1280863,466924,238311099,232494319
29380412_466931,CM021106.1,7,29380412,237844175,1280863,466931,238311106,232494326
29380412_466939,CM021106.1,7,29380412,237844175,1280863,466939,238311114,232494334
29380412_466961,CM021106.1,7,29380412,237844175,1280863,466961,238311136,232494356
29380412_467040,CM021106.1,7,29380412,237844175,1280863,467040,238311215,232494435
29382404_717316,CM021106.1,7,29382404,237844175,1396780,717316,238561491,232744711
29380538_876545,CM021106.1,7,29380538,237844173,1928270,876545,238720718,232903938
29380538_921690,CM021106.1,7,29380538,237844173,1928270,921690,238765863,232949083
29382404_1042434,CM021106.1,7,29382404,237844175,1396780,1042434,238886609,233069829
29382404_1042466,CM021106.1,7,29382404,237844175,1396780,1042466,238886641,233069861
29382404_1042479,CM021106.1,7,29382404,237844175,1396780,1042479,238886654,233069874
29382404_1042481,CM021106.1,7,29382404,237844175,1396780,1042481,238886656,233069876
29380412_1051246,CM021106.1,7,29380412,237844175,1280863,1051246,238895421,233078641
29380412_1051310,CM021106.1,7,29380412,237844175,1280863,1051310,238895485,233078705
29380412_1052202,CM021106.1,7,29380412,237844175,1280863,1052202,238896377,233079597
29380412_1052204,CM021106.1,7,29380412,237844175,1280863,1052204,238896379,233079599
29380412_1052284,CM021106.1,7,29380412,237844175,1280863,1052284,238896459,233079679
29382135_1449678,CM021106.1,7,29382135,237844172,4026853,1449678,239293850,233477070
29382135_1449679,CM021106.1,7,29382135,237844172,4026853,1449679,239293851,233477071
29380538_1465160,CM021106.1,7,29380538,237844173,1928270,1465160,239309333,233492553
29380193_1543308,CM021106.1,7,29380193,237844175,2313093,1543308,239387483,233570703
29380193_1543315,CM021106.1,7,29380193,237844175,2313093,1543315,239387490,233570710
29380193_1582136,CM021106.1,7,29380193,237844175,2313093,1582136,239426311,233609531
29380193_1582237,CM021106.1,7,29380193,237844175,2313093,1582237,239426412,233609632
29380193_1606380,CM021106.1,7,29380193,237844175,2313093,1606380,239450555,233633775
29382135_1609165,CM021106.1,7,29382135,237844172,4026853,1609165,239453337,233636557
29382135_1609199,CM021106.1,7,29382135,237844172,4026853,1609199,239453371,233636591
29382135_1610598,CM021106.1,7,29382135,237844172,4026853,1610598,239454770,233637990
29382135_1610650,CM021106.1,7,29382135,237844172,4026853,1610650,239454822,233638042
29382135_1610768,CM021106.1,7,29382135,237844172,4026853,1610768,239454940,233638160
29382135_1610887,CM021106.1,7,29382135,237844172,4026853,1610887,239455059,233638279
29380193_1613441,CM021106.1,7,29380193,237844175,2313093,1613441,239457616,233640836
29380193_1613486,CM021106.1,7,29380193,237844175,2313093,1613486,239457661,233640881
29380193_1613668,CM021106.1,7,29380193,237844175,2313093,1613668,239457843,233641063
29380193_1613727,CM021106.1,7,29380193,237844175,2313093,1613727,239457902,233641122
29380193_1613821,CM021106.1,7,29380193,237844175,2313093,1613821,239457996,233641216
29382135_1622674,CM021106.1,7,29382135,237844172,4026853,1622674,239466846,233650066
29382135_1622769,CM021106.1,7,29382135,237844172,4026853,1622769,239466941,233650161
29382135_1674657,CM021106.1,7,29382135,237844172,4026853,1674657,239518829,233702049
29382135_1674742,CM021106.1,7,29382135,237844172,4026853,1674742,239518914,233702134
29382135_1674745,CM021106.1,7,29382135,237844172,4026853,1674745,239518917,233702137
29382135_1674775,CM021106.1,7,29382135,237844172,4026853,1674775,239518947,233702167
29382135_1674942,CM021106.1,7,29382135,237844172,4026853,1674942,239519114,233702334
29380538_1686400,CM021106.1,7,29380538,237844173,1928270,1686400,239530573,233713793
29380538_1686695,CM021106.1,7,29380538,237844173,1928270,1686695,239530868,233714088
29380538_1686729,CM021106.1,7,29380538,237844173,1928270,1686729,239530902,233714122
29382135_1694711,CM021106.1,7,29382135,237844172,4026853,1694711,239538883,233722103
29382135_1694741,CM021106.1,7,29382135,237844172,4026853,1694741,239538913,233722133
29353611_2623,CM021106.1,7,29353611,239538882,141622,2623,239541505,233724725
29353611_2647,CM021106.1,7,29353611,239538882,141622,2647,239541529,233724749
29353611_2678,CM021106.1,7,29353611,239538882,141622,2678,239541560,233724780
29353611_2683,CM021106.1,7,29353611,239538882,141622,2683,239541565,233724785
29353611_2739,CM021106.1,7,29353611,239538882,141622,2739,239541621,233724841
29353611_2740,CM021106.1,7,29353611,239538882,141622,2740,239541622,233724842
29353611_135654,CM021106.1,7,29353611,239538882,141622,135654,239674536,233857756
29353611_135677,CM021106.1,7,29353611,239538882,141622,135677,239674559,233857779
29353611_135685,CM021106.1,7,29353611,239538882,141622,135685,239674567,233857787
29353611_135699,CM021106.1,7,29353611,239538882,141622,135699,239674581,233857801
29353611_135701,CM021106.1,7,29353611,239538882,141622,135701,239674583,233857803
29353611_135715,CM021106.1,7,29353611,239538882,141622,135715,239674597,233857817
29377351_2040043,CM021106.1,7,29377351,237844172,2525213,2040043,239884215,234067435
29380193_2182591,CM021106.1,7,29380193,237844175,2313093,2182591,240026766,234209986
29380193_2245374,CM021106.1,7,29380193,237844175,2313093,2245374,240089549,234272769
29343544_4569,CM021106.1,7,29343544,241566567,6400,4569,241571136,235754356
29376064_48084,CM021106.1,7,29376064,243942707,242633,48084,243990791,238174011
29376064_120180,CM021106.1,7,29376064,243942707,242633,120180,244062887,238246107
29376064_120252,CM021106.1,7,29376064,243942707,242633,120252,244062959,238246179
29381927_6425334,CM021106.1,7,29381927,237844173,7504292,6425334,244269507,238452727
29381927_6491411,CM021106.1,7,29381927,237844173,7504292,6491411,244335584,238518804
29382330_6927,CM021106.1,7,29382330,284130592,829925,6927,284137519,278320739
29382330_6990,CM021106.1,7,29382330,284130592,829925,6990,284137582,278320802
29380025_54060,CM021106.1,7,29380025,284132169,2060204,54060,284186229,278369449
29346254_72455,CM021106.1,7,29346254,284130592,280877,72455,284203047,278386267
29346254_74354,CM021106.1,7,29346254,284130592,280877,74354,284204946,278388166
29346254_74369,CM021106.1,7,29346254,284130592,280877,74369,284204961,278388181
29346254_74419,CM021106.1,7,29346254,284130592,280877,74419,284205011,278388231
29346254_74420,CM021106.1,7,29346254,284130592,280877,74420,284205012,278388232
29346254_75286,CM021106.1,7,29346254,284130592,280877,75286,284205878,278389098
29346254_78265,CM021106.1,7,29346254,284130592,280877,78265,284208857,278392077
29346254_78302,CM021106.1,7,29346254,284130592,280877,78302,284208894,278392114
29346254_78336,CM021106.1,7,29346254,284130592,280877,78336,284208928,278392148
29346254_78340,CM021106.1,7,29346254,284130592,280877,78340,284208932,278392152
29346254_78366,CM021106.1,7,29346254,284130592,280877,78366,284208958,278392178
29346254_78380,CM021106.1,7,29346254,284130592,280877,78380,284208972,278392192
29346254_78385,CM021106.1,7,29346254,284130592,280877,78385,284208977,278392197
29346254_78415,CM021106.1,7,29346254,284130592,280877,78415,284209007,278392227
29346254_78430,CM021106.1,7,29346254,284130592,280877,78430,284209022,278392242
29346254_78448,CM021106.1,7,29346254,284130592,280877,78448,284209040,278392260
29346254_78450,CM021106.1,7,29346254,284130592,280877,78450,284209042,278392262
29346254_78457,CM021106.1,7,29346254,284130592,280877,78457,284209049,278392269
29346254_78458,CM021106.1,7,29346254,284130592,280877,78458,284209050,278392270
29346254_78490,CM021106.1,7,29346254,284130592,280877,78490,284209082,278392302
29380199_113905,CM021106.1,7,29380199,284130593,3499922,113905,284244498,278427718
29381658_144539,CM021106.1,7,29381658,284130591,8310102,144539,284275130,278458350
29381658_144562,CM021106.1,7,29381658,284130591,8310102,144562,284275153,278458373
29381658_144634,CM021106.1,7,29381658,284130591,8310102,144634,284275225,278458445
29380025_200693,CM021106.1,7,29380025,284132169,2060204,200693,284332862,278516082
29380025_200723,CM021106.1,7,29380025,284132169,2060204,200723,284332892,278516112
29380025_200774,CM021106.1,7,29380025,284132169,2060204,200774,284332943,278516163
29380025_200790,CM021106.1,7,29380025,284132169,2060204,200790,284332959,278516179
29380025_200986,CM021106.1,7,29380025,284132169,2060204,200986,284333155,278516375
29380025_201514,CM021106.1,7,29380025,284132169,2060204,201514,284333683,278516903
29380025_201587,CM021106.1,7,29380025,284132169,2060204,201587,284333756,278516976
29380853_260597,CM021106.1,7,29380853,284130591,2176869,260597,284391188,278574408
29380853_260631,CM021106.1,7,29380853,284130591,2176869,260631,284391222,278574442
29380853_260724,CM021106.1,7,29380853,284130591,2176869,260724,284391315,278574535
29382330_380089,CM021106.1,7,29382330,284130592,829925,380089,284510681,278693901
29382330_380223,CM021106.1,7,29382330,284130592,829925,380223,284510815,278694035
29381931_392717,CM021106.1,7,29381931,284130593,1874178,392717,284523310,278706530
29381931_392730,CM021106.1,7,29381931,284130593,1874178,392730,284523323,278706543
29381931_392733,CM021106.1,7,29381931,284130593,1874178,392733,284523326,278706546
29381931_392744,CM021106.1,7,29381931,284130593,1874178,392744,284523337,278706557
29381931_392765,CM021106.1,7,29381931,284130593,1874178,392765,284523358,278706578
29382330_408411,CM021106.1,7,29382330,284130592,829925,408411,284539003,278722223
29382330_447780,CM021106.1,7,29382330,284130592,829925,447780,284578372,278761592
29382330_448065,CM021106.1,7,29382330,284130592,829925,448065,284578657,278761877
29340214_508393,CM021106.1,7,29340214,284130591,711635,508393,284638984,278822204
29379234_627778,CM021106.1,7,29379234,284130592,1188094,627778,284758370,278941590
29379234_628017,CM021106.1,7,29379234,284130592,1188094,628017,284758609,278941829
29379386_630771,CM021106.1,7,29379386,284131441,2395266,630771,284762212,278945432
29380853_689091,CM021106.1,7,29380853,284130591,2176869,689091,284819682,279002902
29382330_698942,CM021106.1,7,29382330,284130592,829925,698942,284829534,279012754
29381560_736308,CM021106.1,7,29381560,284130592,4227107,736308,284866900,279050120
29381560_736376,CM021106.1,7,29381560,284130592,4227107,736376,284866968,279050188
29381560_736378,CM021106.1,7,29381560,284130592,4227107,736378,284866970,279050190
29381560_736630,CM021106.1,7,29381560,284130592,4227107,736630,284867222,279050442
29382330_762891,CM021106.1,7,29382330,284130592,829925,762891,284893483,279076703
29378246_803381,CM021106.1,7,29378246,284130593,4827412,803381,284933974,279117194
29378246_804421,CM021106.1,7,29378246,284130593,4827412,804421,284935014,279118234
29382330_811876,CM021106.1,7,29382330,284130592,829925,811876,284942468,279125688
29382330_811922,CM021106.1,7,29382330,284130592,829925,811922,284942514,279125734
29382330_811940,CM021106.1,7,29382330,284130592,829925,811940,284942532,279125752
29382330_812102,CM021106.1,7,29382330,284130592,829925,812102,284942694,279125914
29382330_812107,CM021106.1,7,29382330,284130592,829925,812107,284942699,279125919
29382330_812131,CM021106.1,7,29382330,284130592,829925,812131,284942723,279125943
29379386_814316,CM021106.1,7,29379386,284131441,2395266,814316,284945757,279128977
29379386_814327,CM021106.1,7,29379386,284131441,2395266,814327,284945768,279128988
29379386_814328,CM021106.1,7,29379386,284131441,2395266,814328,284945769,279128989
29379386_814379,CM021106.1,7,29379386,284131441,2395266,814379,284945820,279129040
29380853_842267,CM021106.1,7,29380853,284130591,2176869,842267,284972858,279156078
29379386_982339,CM021106.1,7,29379386,284131441,2395266,982339,285113780,279297000
29379386_982592,CM021106.1,7,29379386,284131441,2395266,982592,285114033,279297253
29379386_983075,CM021106.1,7,29379386,284131441,2395266,983075,285114516,279297736
29382476_1045477,CM021106.1,7,29382476,284131167,3170202,1045477,285176644,279359864
29379386_1089732,CM021106.1,7,29379386,284131441,2395266,1089732,285221173,279404393
29382476_1109062,CM021106.1,7,29382476,284131167,3170202,1109062,285240229,279423449
29382476_1134009,CM021106.1,7,29382476,284131167,3170202,1134009,285265176,279448396
29382476_1134377,CM021106.1,7,29382476,284131167,3170202,1134377,285265544,279448764
29380025_1140260,CM021106.1,7,29380025,284132169,2060204,1140260,285272429,279455649
29380692_1206716,CM021106.1,7,29380692,284130592,4920493,1206716,285337308,279520528
29380692_1206848,CM021106.1,7,29380692,284130592,4920493,1206848,285337440,279520660
29380692_1206922,CM021106.1,7,29380692,284130592,4920493,1206922,285337514,279520734
29379628_1211964,CM021106.1,7,29379628,284132369,3459401,1211964,285344333,279527553
29379628_1211967,CM021106.1,7,29379628,284132369,3459401,1211967,285344336,279527556
29379628_1211969,CM021106.1,7,29379628,284132369,3459401,1211969,285344338,279527558
29379628_1230856,CM021106.1,7,29379628,284132369,3459401,1230856,285363225,279546445
29379628_1339940,CM021106.1,7,29379628,284132369,3459401,1339940,285472309,279655529
29378246_1397487,CM021106.1,7,29378246,284130593,4827412,1397487,285528080,279711300
29380853_1614643,CM021106.1,7,29380853,284130591,2176869,1614643,285745234,279928454
29378246_1672785,CM021106.1,7,29378246,284130593,4827412,1672785,285803378,279986598
29378246_1678822,CM021106.1,7,29378246,284130593,4827412,1678822,285809415,279992635
29378246_1678834,CM021106.1,7,29378246,284130593,4827412,1678834,285809427,279992647
29379628_1682403,CM021106.1,7,29379628,284132369,3459401,1682403,285814772,279997992
29382476_1719577,CM021106.1,7,29382476,284131167,3170202,1719577,285850744,280033964
29382476_1720052,CM021106.1,7,29382476,284131167,3170202,1720052,285851219,280034439
29379843_5331,CM021106.1,7,29379843,285862698,366627,5331,285868029,280051249
29377847_1789759,CM021106.1,7,29377847,284131853,2069234,1789759,285921612,280104832
29381658_1815332,CM021106.1,7,29381658,284130591,8310102,1815332,285945923,280129143
29380170_1841765,CM021106.1,7,29380170,284130593,3723274,1841765,285972358,280155578
29380170_1841776,CM021106.1,7,29380170,284130593,3723274,1841776,285972369,280155589
29380170_1841828,CM021106.1,7,29380170,284130593,3723274,1841828,285972421,280155641
29380170_1841835,CM021106.1,7,29380170,284130593,3723274,1841835,285972428,280155648
29380170_1841869,CM021106.1,7,29380170,284130593,3723274,1841869,285972462,280155682
29380199_1974690,CM021106.1,7,29380199,284130593,3499922,1974690,286105283,280288503
29380199_1974691,CM021106.1,7,29380199,284130593,3499922,1974691,286105284,280288504
29380199_1976918,CM021106.1,7,29380199,284130593,3499922,1976918,286107511,280290731
29381674_245539,CM021106.1,7,29381674,285862697,293590,245539,286108236,280291456
29380199_1977740,CM021106.1,7,29380199,284130593,3499922,1977740,286108333,280291553
29380199_1977798,CM021106.1,7,29380199,284130593,3499922,1977798,286108391,280291611
29380199_1977877,CM021106.1,7,29380199,284130593,3499922,1977877,286108470,280291690
29380199_1977914,CM021106.1,7,29380199,284130593,3499922,1977914,286108507,280291727
29379843_266433,CM021106.1,7,29379843,285862698,366627,266433,286129131,280312351
29379843_266873,CM021106.1,7,29379843,285862698,366627,266873,286129571,280312791
29379386_2097428,CM021106.1,7,29379386,284131441,2395266,2097428,286228869,280412089
29379386_2097470,CM021106.1,7,29379386,284131441,2395266,2097470,286228911,280412131
29379386_2246522,CM021106.1,7,29379386,284131441,2395266,2246522,286377963,280561183
29382476_2332050,CM021106.1,7,29382476,284131167,3170202,2332050,286463217,280646437
29382476_2332079,CM021106.1,7,29382476,284131167,3170202,2332079,286463246,280646466
29382476_2332083,CM021106.1,7,29382476,284131167,3170202,2332083,286463250,280646470
29382476_2332086,CM021106.1,7,29382476,284131167,3170202,2332086,286463253,280646473
29382476_2332087,CM021106.1,7,29382476,284131167,3170202,2332087,286463254,280646474
29350342_616295,CM021106.1,7,29350342,285863340,714804,616295,286479635,280662855
29381560_2665039,CM021106.1,7,29381560,284130592,4227107,2665039,286795631,280978851
29381560_2666577,CM021106.1,7,29381560,284130592,4227107,2666577,286797169,280980389
29381560_2666640,CM021106.1,7,29381560,284130592,4227107,2666640,286797232,280980452
29381560_2666652,CM021106.1,7,29381560,284130592,4227107,2666652,286797244,280980464
29381560_2666736,CM021106.1,7,29381560,284130592,4227107,2666736,286797328,280980548
29381560_2666737,CM021106.1,7,29381560,284130592,4227107,2666737,286797329,280980549
29381560_2666784,CM021106.1,7,29381560,284130592,4227107,2666784,286797376,280980596
29381560_2666787,CM021106.1,7,29381560,284130592,4227107,2666787,286797379,280980599
29381560_2666893,CM021106.1,7,29381560,284130592,4227107,2666893,286797485,280980705
29382476_2769360,CM021106.1,7,29382476,284131167,3170202,2769360,286900527,281083747
29382476_2769422,CM021106.1,7,29382476,284131167,3170202,2769422,286900589,281083809
29381560_2836086,CM021106.1,7,29381560,284130592,4227107,2836086,286966678,281149898
29381560_2836112,CM021106.1,7,29381560,284130592,4227107,2836112,286966704,281149924
29381560_2836114,CM021106.1,7,29381560,284130592,4227107,2836114,286966706,281149926
29381560_2847389,CM021106.1,7,29381560,284130592,4227107,2847389,286977981,281161201
29381560_2847400,CM021106.1,7,29381560,284130592,4227107,2847400,286977992,281161212
29381560_2847429,CM021106.1,7,29381560,284130592,4227107,2847429,286978021,281161241
29381560_2847543,CM021106.1,7,29381560,284130592,4227107,2847543,286978135,281161355
29382476_2943984,CM021106.1,7,29382476,284131167,3170202,2943984,287075151,281258371
29380170_2958749,CM021106.1,7,29380170,284130593,3723274,2958749,287089342,281272562
29380692_3050031,CM021106.1,7,29380692,284130592,4920493,3050031,287180623,281363843
29377790_3306684,CM021106.1,7,29377790,284130593,6160195,3306684,287437277,281620497
29380692_3318996,CM021106.1,7,29380692,284130592,4920493,3318996,287449588,281632808
29380692_3319089,CM021106.1,7,29380692,284130592,4920493,3319089,287449681,281632901
29380692_3319145,CM021106.1,7,29380692,284130592,4920493,3319145,287449737,281632957
29380692_3323680,CM021106.1,7,29380692,284130592,4920493,3323680,287454272,281637492
29380692_3323759,CM021106.1,7,29380692,284130592,4920493,3323759,287454351,281637571
29380692_3332509,CM021106.1,7,29380692,284130592,4920493,3332509,287463101,281646321
29380692_3333581,CM021106.1,7,29380692,284130592,4920493,3333581,287464173,281647393
29380692_3333638,CM021106.1,7,29380692,284130592,4920493,3333638,287464230,281647450
29380692_3333673,CM021106.1,7,29380692,284130592,4920493,3333673,287464265,281647485
29380692_3333877,CM021106.1,7,29380692,284130592,4920493,3333877,287464469,281647689
29380692_3333941,CM021106.1,7,29380692,284130592,4920493,3333941,287464533,281647753
29380692_3333971,CM021106.1,7,29380692,284130592,4920493,3333971,287464563,281647783
29381560_3364607,CM021106.1,7,29381560,284130592,4227107,3364607,287495199,281678419
29381560_3364623,CM021106.1,7,29381560,284130592,4227107,3364623,287495215,281678435
29380199_3391167,CM021106.1,7,29380199,284130593,3499922,3391167,287521760,281704980
29380199_3391214,CM021106.1,7,29380199,284130593,3499922,3391214,287521807,281705027
29380199_3391263,CM021106.1,7,29380199,284130593,3499922,3391263,287521856,281705076
29380199_3391313,CM021106.1,7,29380199,284130593,3499922,3391313,287521906,281705126
29380199_3391963,CM021106.1,7,29380199,284130593,3499922,3391963,287522556,281705776
29381560_3620615,CM021106.1,7,29381560,284130592,4227107,3620615,287751207,281934427
29381560_3637618,CM021106.1,7,29381560,284130592,4227107,3637618,287768210,281951430
29377790_3755760,CM021106.1,7,29377790,284130593,6160195,3755760,287886353,282069573
29377790_3918383,CM021106.1,7,29377790,284130593,6160195,3918383,288048976,282232196
29381560_3923032,CM021106.1,7,29381560,284130592,4227107,3923032,288053624,282236844
29380692_4327697,CM021106.1,7,29380692,284130592,4920493,4327697,288458289,282641509
29378855_4462661,CM021106.1,7,29378855,284130591,6865701,4462661,288593252,282776472
29378855_4462662,CM021106.1,7,29378855,284130591,6865701,4462662,288593253,282776473
29378855_4462663,CM021106.1,7,29378855,284130591,6865701,4462663,288593254,282776474
29378855_4462694,CM021106.1,7,29378855,284130591,6865701,4462694,288593285,282776505
29378855_4462749,CM021106.1,7,29378855,284130591,6865701,4462749,288593340,282776560
29381658_4898632,CM021106.1,7,29381658,284130591,8310102,4898632,289029223,283212443
29381658_4898693,CM021106.1,7,29381658,284130591,8310102,4898693,289029284,283212504
943884_8817,CM021106.1,7,943884,289096471,10318,8817,289105288,283288508
29378855_5080189,CM021106.1,7,29378855,284130591,6865701,5080189,289210780,283394000
29377790_5237338,CM021106.1,7,29377790,284130593,6160195,5237338,289367931,283551151
29377790_5237357,CM021106.1,7,29377790,284130593,6160195,5237357,289367950,283551170
29377790_5237366,CM021106.1,7,29377790,284130593,6160195,5237366,289367959,283551179
29377790_5237402,CM021106.1,7,29377790,284130593,6160195,5237402,289367995,283551215
29378855_5433636,CM021106.1,7,29378855,284130591,6865701,5433636,289564227,283747447
29378855_5433731,CM021106.1,7,29378855,284130591,6865701,5433731,289564322,283747542
29378855_5453034,CM021106.1,7,29378855,284130591,6865701,5453034,289583625,283766845
29377790_5464157,CM021106.1,7,29377790,284130593,6160195,5464157,289594750,283777970
29377790_5464217,CM021106.1,7,29377790,284130593,6160195,5464217,289594810,283778030
29377790_5465089,CM021106.1,7,29377790,284130593,6160195,5465089,289595682,283778902
29377790_5465215,CM021106.1,7,29377790,284130593,6160195,5465215,289595808,283779028
29377790_5845736,CM021106.1,7,29377790,284130593,6160195,5845736,289976329,284159549
29377790_5846090,CM021106.1,7,29377790,284130593,6160195,5846090,289976683,284159903
29378855_6490610,CM021106.1,7,29378855,284130591,6865701,6490610,290621201,284804421
29381697_49906,CM021106.1,7,29381697,291242083,576034,49906,291291989,285475209
29381697_51848,CM021106.1,7,29381697,291242083,576034,51848,291293931,285477151
29381697_51877,CM021106.1,7,29381697,291242083,576034,51877,291293960,285477180
29381697_51887,CM021106.1,7,29381697,291242083,576034,51887,291293970,285477190
29381697_51913,CM021106.1,7,29381697,291242083,576034,51913,291293996,285477216
29381658_7965232,CM021106.1,7,29381658,284130591,8310102,7965232,292095823,286279043
29381658_7965319,CM021106.1,7,29381658,284130591,8310102,7965319,292095910,286279130
29381658_7965355,CM021106.1,7,29381658,284130591,8310102,7965355,292095946,286279166
29381719_17354,CM021106.1,7,29381719,304614016,505168,17354,304631370,298814590
29381719_17399,CM021106.1,7,29381719,304614016,505168,17399,304631415,298814635
29378241_30176,CM021106.1,7,29378241,304613273,1024399,30176,304643449,298826669
29378241_30183,CM021106.1,7,29378241,304613273,1024399,30183,304643456,298826676
29378241_30190,CM021106.1,7,29378241,304613273,1024399,30190,304643463,298826683
29378241_30201,CM021106.1,7,29378241,304613273,1024399,30201,304643474,298826694
29378241_30223,CM021106.1,7,29378241,304613273,1024399,30223,304643496,298826716
29378241_30226,CM021106.1,7,29378241,304613273,1024399,30226,304643499,298826719
29378241_30252,CM021106.1,7,29378241,304613273,1024399,30252,304643525,298826745
29378241_30272,CM021106.1,7,29378241,304613273,1024399,30272,304643545,298826765
29378241_30284,CM021106.1,7,29378241,304613273,1024399,30284,304643557,298826777
29378241_30300,CM021106.1,7,29378241,304613273,1024399,30300,304643573,298826793
29378241_30305,CM021106.1,7,29378241,304613273,1024399,30305,304643578,298826798
29378241_30343,CM021106.1,7,29378241,304613273,1024399,30343,304643616,298826836
29378241_30357,CM021106.1,7,29378241,304613273,1024399,30357,304643630,298826850
29378241_30371,CM021106.1,7,29378241,304613273,1024399,30371,304643644,298826864
29378241_30377,CM021106.1,7,29378241,304613273,1024399,30377,304643650,298826870
29378241_36770,CM021106.1,7,29378241,304613273,1024399,36770,304650043,298833263
29378241_152036,CM021106.1,7,29378241,304613273,1024399,152036,304765309,298948529
29378241_154781,CM021106.1,7,29378241,304613273,1024399,154781,304768054,298951274
29378241_154785,CM021106.1,7,29378241,304613273,1024399,154785,304768058,298951278
29378241_154786,CM021106.1,7,29378241,304613273,1024399,154786,304768059,298951279
29378241_154794,CM021106.1,7,29378241,304613273,1024399,154794,304768067,298951287
29378241_180637,CM021106.1,7,29378241,304613273,1024399,180637,304793910,298977130
29378241_180694,CM021106.1,7,29378241,304613273,1024399,180694,304793967,298977187
29381719_208156,CM021106.1,7,29381719,304614016,505168,208156,304822172,299005392
29378241_806589,CM021106.1,7,29378241,304613273,1024399,806589,305419862,299603082
29378241_806681,CM021106.1,7,29378241,304613273,1024399,806681,305419954,299603174
29378241_807863,CM021106.1,7,29378241,304613273,1024399,807863,305421136,299604356
29378241_814923,CM021106.1,7,29378241,304613273,1024399,814923,305428196,299611416
29378241_820366,CM021106.1,7,29378241,304613273,1024399,820366,305433639,299616859
29378241_820415,CM021106.1,7,29378241,304613273,1024399,820415,305433688,299616908
29379412_939986,CM021106.1,7,29379412,304613273,1521912,939986,305553259,299736479
29379412_939998,CM021106.1,7,29379412,304613273,1521912,939998,305553271,299736491
29379412_939999,CM021106.1,7,29379412,304613273,1521912,939999,305553272,299736492
29379412_940005,CM021106.1,7,29379412,304613273,1521912,940005,305553278,299736498
29379412_940058,CM021106.1,7,29379412,304613273,1521912,940058,305553331,299736551
29379412_940104,CM021106.1,7,29379412,304613273,1521912,940104,305553377,299736597
29379412_1129103,CM021106.1,7,29379412,304613273,1521912,1129103,305742376,299925596
29379412_1131401,CM021106.1,7,29379412,304613273,1521912,1131401,305744674,299927894
29380749_121389,CM021106.1,7,29380749,316267263,5170960,121389,316388652,310571872
29380749_121436,CM021106.1,7,29380749,316267263,5170960,121436,316388699,310571919
29379382_125336,CM021106.1,7,29379382,316271405,2003256,125336,316396741,310579961
29379382_138594,CM021106.1,7,29379382,316271405,2003256,138594,316409999,310593219
29379382_187995,CM021106.1,7,29379382,316271405,2003256,187995,316459400,310642620
29378834_192667,CM021106.1,7,29378834,316267266,1518293,192667,316459933,310643153
29378834_192729,CM021106.1,7,29378834,316267266,1518293,192729,316459995,310643215
29378834_192759,CM021106.1,7,29378834,316267266,1518293,192759,316460025,310643245
29378834_192819,CM021106.1,7,29378834,316267266,1518293,192819,316460085,310643305
29379536_242490,CM021106.1,7,29379536,316267267,704217,242490,316509757,310692977
29379536_242568,CM021106.1,7,29379536,316267267,704217,242568,316509835,310693055
29379536_242704,CM021106.1,7,29379536,316267267,704217,242704,316509971,310693191
29379536_243622,CM021106.1,7,29379536,316267267,704217,243622,316510889,310694109
29379536_243661,CM021106.1,7,29379536,316267267,704217,243661,316510928,310694148
29379536_243694,CM021106.1,7,29379536,316267267,704217,243694,316510961,310694181
29381783_501709,CM021106.1,7,29381783,316268744,3441174,501709,316770453,310953673
29381783_503284,CM021106.1,7,29381783,316268744,3441174,503284,316772028,310955248
29381783_503340,CM021106.1,7,29381783,316268744,3441174,503340,316772084,310955304
29381783_503378,CM021106.1,7,29381783,316268744,3441174,503378,316772122,310955342
29377886_516961,CM021106.1,7,29377886,316267264,1426779,516961,316784225,310967445
29381783_628242,CM021106.1,7,29381783,316268744,3441174,628242,316896986,311080206
29381783_628272,CM021106.1,7,29381783,316268744,3441174,628272,316897016,311080236
29379382_651376,CM021106.1,7,29379382,316271405,2003256,651376,316922781,311106001
29379382_651432,CM021106.1,7,29379382,316271405,2003256,651432,316922837,311106057
29379382_651467,CM021106.1,7,29379382,316271405,2003256,651467,316922872,311106092
29379382_651530,CM021106.1,7,29379382,316271405,2003256,651530,316922935,311106155
29379382_651531,CM021106.1,7,29379382,316271405,2003256,651531,316922936,311106156
29379382_651532,CM021106.1,7,29379382,316271405,2003256,651532,316922937,311106157
29379382_653990,CM021106.1,7,29379382,316271405,2003256,653990,316925395,311108615
29379382_683434,CM021106.1,7,29379382,316271405,2003256,683434,316954839,311138059
29379382_684585,CM021106.1,7,29379382,316271405,2003256,684585,316955990,311139210
29381783_698304,CM021106.1,7,29381783,316268744,3441174,698304,316967048,311150268
29381783_699460,CM021106.1,7,29381783,316268744,3441174,699460,316968204,311151424
29379382_719570,CM021106.1,7,29379382,316271405,2003256,719570,316990975,311174195
29379382_1012221,CM021106.1,7,29379382,316271405,2003256,1012221,317283626,311466846
29379382_1012270,CM021106.1,7,29379382,316271405,2003256,1012270,317283675,311466895
29379170_1287304,CM021106.1,7,29379170,316269808,1415086,1287304,317557112,311740332
29379170_1287329,CM021106.1,7,29379170,316269808,1415086,1287329,317557137,311740357
29379170_1287356,CM021106.1,7,29379170,316269808,1415086,1287356,317557164,311740384
29379170_1287399,CM021106.1,7,29379170,316269808,1415086,1287399,317557207,311740427
29379170_1287423,CM021106.1,7,29379170,316269808,1415086,1287423,317557231,311740451
29379170_1287472,CM021106.1,7,29379170,316269808,1415086,1287472,317557280,311740500
29379170_1287477,CM021106.1,7,29379170,316269808,1415086,1287477,317557285,311740505
29380749_1303305,CM021106.1,7,29380749,316267263,5170960,1303305,317570568,311753788
29380749_1303329,CM021106.1,7,29380749,316267263,5170960,1303329,317570592,311753812
29380749_1303362,CM021106.1,7,29380749,316267263,5170960,1303362,317570625,311753845
29378347_1359450,CM021106.1,7,29378347,316270124,3441873,1359450,317629574,311812794
29379382_1468021,CM021106.1,7,29379382,316271405,2003256,1468021,317739426,311922646
29379382_1468044,CM021106.1,7,29379382,316271405,2003256,1468044,317739449,311922669
29379382_1468046,CM021106.1,7,29379382,316271405,2003256,1468046,317739451,311922671
29379382_1468163,CM021106.1,7,29379382,316271405,2003256,1468163,317739568,311922788
29379382_1489389,CM021106.1,7,29379382,316271405,2003256,1489389,317760794,311944014
29379382_1489425,CM021106.1,7,29379382,316271405,2003256,1489425,317760830,311944050
29379382_1489442,CM021106.1,7,29379382,316271405,2003256,1489442,317760847,311944067
29379382_1489446,CM021106.1,7,29379382,316271405,2003256,1489446,317760851,311944071
29379382_1523420,CM021106.1,7,29379382,316271405,2003256,1523420,317794825,311978045
29379382_1523485,CM021106.1,7,29379382,316271405,2003256,1523485,317794890,311978110
29379382_1523496,CM021106.1,7,29379382,316271405,2003256,1523496,317794901,311978121
29379382_1523529,CM021106.1,7,29379382,316271405,2003256,1523529,317794934,311978154
29379382_1523559,CM021106.1,7,29379382,316271405,2003256,1523559,317794964,311978184
29379382_1523630,CM021106.1,7,29379382,316271405,2003256,1523630,317795035,311978255
29379382_1523707,CM021106.1,7,29379382,316271405,2003256,1523707,317795112,311978332
29379382_1523769,CM021106.1,7,29379382,316271405,2003256,1523769,317795174,311978394
29379382_1523846,CM021106.1,7,29379382,316271405,2003256,1523846,317795251,311978471
29379382_1523853,CM021106.1,7,29379382,316271405,2003256,1523853,317795258,311978478
29379382_1523886,CM021106.1,7,29379382,316271405,2003256,1523886,317795291,311978511
29379382_1523939,CM021106.1,7,29379382,316271405,2003256,1523939,317795344,311978564
29379382_1633564,CM021106.1,7,29379382,316271405,2003256,1633564,317904969,312088189
29379382_1633655,CM021106.1,7,29379382,316271405,2003256,1633655,317905060,312088280
29379382_1633695,CM021106.1,7,29379382,316271405,2003256,1633695,317905100,312088320
29379382_1638499,CM021106.1,7,29379382,316271405,2003256,1638499,317909904,312093124
29379382_1638515,CM021106.1,7,29379382,316271405,2003256,1638515,317909920,312093140
29379382_1638624,CM021106.1,7,29379382,316271405,2003256,1638624,317910029,312093249
29379382_1638632,CM021106.1,7,29379382,316271405,2003256,1638632,317910037,312093257
29379382_1638636,CM021106.1,7,29379382,316271405,2003256,1638636,317910041,312093261
29379382_1638637,CM021106.1,7,29379382,316271405,2003256,1638637,317910042,312093262
29380679_1648040,CM021106.1,7,29380679,316267267,1985707,1648040,317915307,312098527
29380679_1648057,CM021106.1,7,29380679,316267267,1985707,1648057,317915324,312098544
29380679_1648062,CM021106.1,7,29380679,316267267,1985707,1648062,317915329,312098549
29380679_1648081,CM021106.1,7,29380679,316267267,1985707,1648081,317915348,312098568
29379382_1740573,CM021106.1,7,29379382,316271405,2003256,1740573,318011978,312195198
29379382_1763835,CM021106.1,7,29379382,316271405,2003256,1763835,318035240,312218460
29379382_1764158,CM021106.1,7,29379382,316271405,2003256,1764158,318035563,312218783
29379382_1764188,CM021106.1,7,29379382,316271405,2003256,1764188,318035593,312218813
29381783_2193575,CM021106.1,7,29381783,316268744,3441174,2193575,318462319,312645539
29381783_2193581,CM021106.1,7,29381783,316268744,3441174,2193581,318462325,312645545
29381783_2193588,CM021106.1,7,29381783,316268744,3441174,2193588,318462332,312645552
29381783_2193591,CM021106.1,7,29381783,316268744,3441174,2193591,318462335,312645555
29381783_2193630,CM021106.1,7,29381783,316268744,3441174,2193630,318462374,312645594
29381783_2193632,CM021106.1,7,29381783,316268744,3441174,2193632,318462376,312645596
29381783_2193712,CM021106.1,7,29381783,316268744,3441174,2193712,318462456,312645676
29381783_2193713,CM021106.1,7,29381783,316268744,3441174,2193713,318462457,312645677
29380749_2288922,CM021106.1,7,29380749,316267263,5170960,2288922,318556185,312739405
29381274_2335961,CM021106.1,7,29381274,316269135,3020064,2335961,318605096,312788316
29381274_2336402,CM021106.1,7,29381274,316269135,3020064,2336402,318605537,312788757
29381274_2339994,CM021106.1,7,29381274,316269135,3020064,2339994,318609129,312792349
29381274_2340017,CM021106.1,7,29381274,316269135,3020064,2340017,318609152,312792372
29378917_2345181,CM021106.1,7,29378917,316267267,5347003,2345181,318612448,312795668
29378917_2345781,CM021106.1,7,29378917,316267267,5347003,2345781,318613048,312796268
29381274_2368582,CM021106.1,7,29381274,316269135,3020064,2368582,318637717,312820937
29381274_2368633,CM021106.1,7,29381274,316269135,3020064,2368633,318637768,312820988
29381274_2390059,CM021106.1,7,29381274,316269135,3020064,2390059,318659194,312842414
29378347_2446761,CM021106.1,7,29378347,316270124,3441873,2446761,318716885,312900105
29378917_2471562,CM021106.1,7,29378917,316267267,5347003,2471562,318738829,312922049
29378917_2471582,CM021106.1,7,29378917,316267267,5347003,2471582,318738849,312922069
29378347_2490962,CM021106.1,7,29378347,316270124,3441873,2490962,318761086,312944306
29380749_2624530,CM021106.1,7,29380749,316267263,5170960,2624530,318891793,313075013
29380749_2624536,CM021106.1,7,29380749,316267263,5170960,2624536,318891799,313075019
29380749_2624581,CM021106.1,7,29380749,316267263,5170960,2624581,318891844,313075064
29378917_2665178,CM021106.1,7,29378917,316267267,5347003,2665178,318932445,313115665
29378917_2666476,CM021106.1,7,29378917,316267267,5347003,2666476,318933743,313116963
29381783_2675990,CM021106.1,7,29381783,316268744,3441174,2675990,318944734,313127954
29381783_2676008,CM021106.1,7,29381783,316268744,3441174,2676008,318944752,313127972
29381783_2676015,CM021106.1,7,29381783,316268744,3441174,2676015,318944759,313127979
29381783_2676022,CM021106.1,7,29381783,316268744,3441174,2676022,318944766,313127986
29381783_2676063,CM021106.1,7,29381783,316268744,3441174,2676063,318944807,313128027
29381783_2676072,CM021106.1,7,29381783,316268744,3441174,2676072,318944816,313128036
29381783_2676121,CM021106.1,7,29381783,316268744,3441174,2676121,318944865,313128085
29381783_2676128,CM021106.1,7,29381783,316268744,3441174,2676128,318944872,313128092
29381783_2676170,CM021106.1,7,29381783,316268744,3441174,2676170,318944914,313128134
29381783_2676172,CM021106.1,7,29381783,316268744,3441174,2676172,318944916,313128136
29381783_2676192,CM021106.1,7,29381783,316268744,3441174,2676192,318944936,313128156
29381783_2676193,CM021106.1,7,29381783,316268744,3441174,2676193,318944937,313128157
29381783_2676196,CM021106.1,7,29381783,316268744,3441174,2676196,318944940,313128160
29381783_2676199,CM021106.1,7,29381783,316268744,3441174,2676199,318944943,313128163
29380749_2778149,CM021106.1,7,29380749,316267263,5170960,2778149,319045412,313228632
29380749_2778192,CM021106.1,7,29380749,316267263,5170960,2778192,319045455,313228675
29380749_2839661,CM021106.1,7,29380749,316267263,5170960,2839661,319106924,313290144
29380749_2839668,CM021106.1,7,29380749,316267263,5170960,2839668,319106931,313290151
29380749_2839755,CM021106.1,7,29380749,316267263,5170960,2839755,319107018,313290238
29380749_2839768,CM021106.1,7,29380749,316267263,5170960,2839768,319107031,313290251
29381783_3109120,CM021106.1,7,29381783,316268744,3441174,3109120,319377864,313561084
29381783_3109281,CM021106.1,7,29381783,316268744,3441174,3109281,319378025,313561245
29381783_3109315,CM021106.1,7,29381783,316268744,3441174,3109315,319378059,313561279
29378917_4594739,CM021106.1,7,29378917,316267267,5347003,4594739,320862006,315045226
29382155_162033,CM021106.1,7,29382155,348514330,175242,162033,348676363,342859583
29382155_162067,CM021106.1,7,29382155,348514330,175242,162067,348676397,342859617
29382155_162089,CM021106.1,7,29382155,348514330,175242,162089,348676419,342859639
29352514_3898,CM021106.1,7,29352514,392927838,413680,3898,392931736,387114956
29381721_90955,CM021106.1,7,29381721,392919055,1700992,90955,393010010,387193230
29381721_91380,CM021106.1,7,29381721,392919055,1700992,91380,393010435,387193655
29361529_92461,CM021106.1,7,29361529,392927980,149782,92461,393020441,387203661
29381721_114169,CM021106.1,7,29381721,392919055,1700992,114169,393033224,387216444
29380212_144474,CM021106.1,7,29380212,392901962,4342509,144474,393046436,387229656
29378091_202336,CM021106.1,7,29378091,392901961,1093539,202336,393104297,387287517
29377689_206590,CM021106.1,7,29377689,392901960,895929,206590,393108550,387291770
29377487_252730,CM021106.1,7,29377487,392901961,2167595,252730,393154691,387337911
29377487_252761,CM021106.1,7,29377487,392901961,2167595,252761,393154722,387337942
29377487_252862,CM021106.1,7,29377487,392901961,2167595,252862,393154823,387338043
29377487_252924,CM021106.1,7,29377487,392901961,2167595,252924,393154885,387338105
29377487_252939,CM021106.1,7,29377487,392901961,2167595,252939,393154900,387338120
29352514_235373,CM021106.1,7,29352514,392927838,413680,235373,393163211,387346431
29352514_235389,CM021106.1,7,29352514,392927838,413680,235389,393163227,387346447
29352514_235400,CM021106.1,7,29352514,392927838,413680,235400,393163238,387346458
29380212_348362,CM021106.1,7,29380212,392901962,4342509,348362,393250324,387433544
29380212_460548,CM021106.1,7,29380212,392901962,4342509,460548,393362510,387545730
29380212_460609,CM021106.1,7,29380212,392901962,4342509,460609,393362571,387545791
29380212_461068,CM021106.1,7,29380212,392901962,4342509,461068,393363030,387546250
29380327_487946,CM021106.1,7,29380327,392901961,2326840,487946,393389907,387573127
29380327_517384,CM021106.1,7,29380327,392901961,2326840,517384,393419345,387602565
29377689_524187,CM021106.1,7,29377689,392901960,895929,524187,393426147,387609367
29377689_524270,CM021106.1,7,29377689,392901960,895929,524270,393426230,387609450
29380212_524785,CM021106.1,7,29380212,392901962,4342509,524785,393426747,387609967
29377689_526161,CM021106.1,7,29377689,392901960,895929,526161,393428121,387611341
29377689_526660,CM021106.1,7,29377689,392901960,895929,526660,393428620,387611840
29378199_522488,CM021106.1,7,29378199,392925516,6981222,522488,393448004,387631224
29378199_522508,CM021106.1,7,29378199,392925516,6981222,522508,393448024,387631244
29378199_522565,CM021106.1,7,29378199,392925516,6981222,522565,393448081,387631301
29378199_522632,CM021106.1,7,29378199,392925516,6981222,522632,393448148,387631368
29380212_583788,CM021106.1,7,29380212,392901962,4342509,583788,393485750,387668970
29380212_583837,CM021106.1,7,29380212,392901962,4342509,583837,393485799,387669019
29378388_691601,CM021106.1,7,29378388,392901961,2048271,691601,393593562,387776782
29377437_694697,CM021106.1,7,29377437,392927207,8327229,694697,393621904,387805124
29380327_748382,CM021106.1,7,29380327,392901961,2326840,748382,393650343,387833563
29380327_755054,CM021106.1,7,29380327,392901961,2326840,755054,393657015,387840235
29380327_755108,CM021106.1,7,29380327,392901961,2326840,755108,393657069,387840289
29380327_755327,CM021106.1,7,29380327,392901961,2326840,755327,393657288,387840508
29380327_755355,CM021106.1,7,29380327,392901961,2326840,755355,393657316,387840536
29381721_837235,CM021106.1,7,29381721,392919055,1700992,837235,393756290,387939510
29381721_902165,CM021106.1,7,29381721,392919055,1700992,902165,393821220,388004440
29381721_902247,CM021106.1,7,29381721,392919055,1700992,902247,393821302,388004522
29381721_902324,CM021106.1,7,29381721,392919055,1700992,902324,393821379,388004599
29382502_983567,CM021106.1,7,29382502,392901957,2607874,983567,393885524,388068744
29382502_983603,CM021106.1,7,29382502,392901957,2607874,983603,393885560,388068780
29382502_983609,CM021106.1,7,29382502,392901957,2607874,983609,393885566,388068786
29378091_1029218,CM021106.1,7,29378091,392901961,1093539,1029218,393931179,388114399
29378091_1029920,CM021106.1,7,29378091,392901961,1093539,1029920,393931881,388115101
29378199_1021392,CM021106.1,7,29378199,392925516,6981222,1021392,393946908,388130128
29378199_1021465,CM021106.1,7,29378199,392925516,6981222,1021465,393946981,388130201
29378199_1021480,CM021106.1,7,29378199,392925516,6981222,1021480,393946996,388130216
29378199_1021567,CM021106.1,7,29378199,392925516,6981222,1021567,393947083,388130303
29378199_1031102,CM021106.1,7,29378199,392925516,6981222,1031102,393956618,388139838
29378199_1075445,CM021106.1,7,29378199,392925516,6981222,1075445,394000961,388184181
29378199_1075545,CM021106.1,7,29378199,392925516,6981222,1075545,394001061,388184281
29378199_1105787,CM021106.1,7,29378199,392925516,6981222,1105787,394031303,388214523
29378199_1106447,CM021106.1,7,29378199,392925516,6981222,1106447,394031963,388215183
29378199_1106490,CM021106.1,7,29378199,392925516,6981222,1106490,394032006,388215226
29378199_1106595,CM021106.1,7,29378199,392925516,6981222,1106595,394032111,388215331
29377547_1155033,CM021106.1,7,29377547,392901959,2131224,1155033,394056992,388240212
29377659_1343052,CM021106.1,7,29377659,392901960,2873202,1343052,394245012,388428232
29378388_1404502,CM021106.1,7,29378388,392901961,2048271,1404502,394306463,388489683
29378388_1472013,CM021106.1,7,29378388,392901961,2048271,1472013,394373974,388557194
29377659_1475259,CM021106.1,7,29377659,392901960,2873202,1475259,394377219,388560439
29377659_1499607,CM021106.1,7,29377659,392901960,2873202,1499607,394401567,388584787
29377659_1499617,CM021106.1,7,29377659,392901960,2873202,1499617,394401577,388584797
29377659_1499639,CM021106.1,7,29377659,392901960,2873202,1499639,394401599,388584819
29377659_1499664,CM021106.1,7,29377659,392901960,2873202,1499664,394401624,388584844
29377659_1499682,CM021106.1,7,29377659,392901960,2873202,1499682,394401642,388584862
29377659_1556450,CM021106.1,7,29377659,392901960,2873202,1556450,394458410,388641630
29378388_1825860,CM021106.1,7,29378388,392901961,2048271,1825860,394727821,388911041
29377547_1896264,CM021106.1,7,29377547,392901959,2131224,1896264,394798223,388981443
29378388_1966921,CM021106.1,7,29378388,392901961,2048271,1966921,394868882,389052102
29378388_1967000,CM021106.1,7,29378388,392901961,2048271,1967000,394868961,389052181
29378201_2389835,CM021106.1,7,29378201,392901960,6226970,2389835,395291795,389475015
29377659_2585244,CM021106.1,7,29377659,392901960,2873202,2585244,395487204,389670424
29377659_2585465,CM021106.1,7,29377659,392901960,2873202,2585465,395487425,389670645
29378199_2622177,CM021106.1,7,29378199,392925516,6981222,2622177,395547693,389730913
29378199_2626365,CM021106.1,7,29378199,392925516,6981222,2626365,395551881,389735101
29377659_2813450,CM021106.1,7,29377659,392901960,2873202,2813450,395715410,389898630
29377659_2813570,CM021106.1,7,29377659,392901960,2873202,2813570,395715530,389898750
29378201_2845203,CM021106.1,7,29378201,392901960,6226970,2845203,395747163,389930383
29377437_3028136,CM021106.1,7,29377437,392927207,8327229,3028136,395955343,390138563
29378199_3199711,CM021106.1,7,29378199,392925516,6981222,3199711,396125227,390308447
29377437_3271361,CM021106.1,7,29377437,392927207,8327229,3271361,396198568,390381788
29380212_3322691,CM021106.1,7,29380212,392901962,4342509,3322691,396224653,390407873
29380212_3377880,CM021106.1,7,29380212,392901962,4342509,3377880,396279842,390463062
29380212_3377968,CM021106.1,7,29380212,392901962,4342509,3377968,396279930,390463150
29380212_3419027,CM021106.1,7,29380212,392901962,4342509,3419027,396320989,390504209
29380212_3419110,CM021106.1,7,29380212,392901962,4342509,3419110,396321072,390504292
29380212_3419120,CM021106.1,7,29380212,392901962,4342509,3419120,396321082,390504302
29380212_3419124,CM021106.1,7,29380212,392901962,4342509,3419124,396321086,390504306
29380212_3419152,CM021106.1,7,29380212,392901962,4342509,3419152,396321114,390504334
29380212_3419166,CM021106.1,7,29380212,392901962,4342509,3419166,396321128,390504348
29380212_3419217,CM021106.1,7,29380212,392901962,4342509,3419217,396321179,390504399
29380212_3419257,CM021106.1,7,29380212,392901962,4342509,3419257,396321219,390504439
29380212_3419268,CM021106.1,7,29380212,392901962,4342509,3419268,396321230,390504450
29380212_3419269,CM021106.1,7,29380212,392901962,4342509,3419269,396321231,390504451
29380212_3419273,CM021106.1,7,29380212,392901962,4342509,3419273,396321235,390504455
29380212_3419277,CM021106.1,7,29380212,392901962,4342509,3419277,396321239,390504459
29380212_3419297,CM021106.1,7,29380212,392901962,4342509,3419297,396321259,390504479
29380212_3419300,CM021106.1,7,29380212,392901962,4342509,3419300,396321262,390504482
29380212_3419315,CM021106.1,7,29380212,392901962,4342509,3419315,396321277,390504497
29380212_3419325,CM021106.1,7,29380212,392901962,4342509,3419325,396321287,390504507
29380212_3419362,CM021106.1,7,29380212,392901962,4342509,3419362,396321324,390504544
29380212_3419380,CM021106.1,7,29380212,392901962,4342509,3419380,396321342,390504562
29380212_3419417,CM021106.1,7,29380212,392901962,4342509,3419417,396321379,390504599
29380212_3419427,CM021106.1,7,29380212,392901962,4342509,3419427,396321389,390504609
29380212_3419430,CM021106.1,7,29380212,392901962,4342509,3419430,396321392,390504612
29380212_3511053,CM021106.1,7,29380212,392901962,4342509,3511053,396413015,390596235
29380212_3511096,CM021106.1,7,29380212,392901962,4342509,3511096,396413058,390596278
29380212_3511164,CM021106.1,7,29380212,392901962,4342509,3511164,396413126,390596346
29380212_3511174,CM021106.1,7,29380212,392901962,4342509,3511174,396413136,390596356
29380212_3511251,CM021106.1,7,29380212,392901962,4342509,3511251,396413213,390596433
29380212_3534688,CM021106.1,7,29380212,392901962,4342509,3534688,396436650,390619870
29380212_3534700,CM021106.1,7,29380212,392901962,4342509,3534700,396436662,390619882
29380212_3534704,CM021106.1,7,29380212,392901962,4342509,3534704,396436666,390619886
29380212_3534729,CM021106.1,7,29380212,392901962,4342509,3534729,396436691,390619911
29380212_3534742,CM021106.1,7,29380212,392901962,4342509,3534742,396436704,390619924
29380212_3534747,CM021106.1,7,29380212,392901962,4342509,3534747,396436709,390619929
29380212_3534798,CM021106.1,7,29380212,392901962,4342509,3534798,396436760,390619980
29380212_3534800,CM021106.1,7,29380212,392901962,4342509,3534800,396436762,390619982
29380212_3534811,CM021106.1,7,29380212,392901962,4342509,3534811,396436773,390619993
29380212_3534819,CM021106.1,7,29380212,392901962,4342509,3534819,396436781,390620001
29380212_3534832,CM021106.1,7,29380212,392901962,4342509,3534832,396436794,390620014
29380212_3534857,CM021106.1,7,29380212,392901962,4342509,3534857,396436819,390620039
29380212_3534867,CM021106.1,7,29380212,392901962,4342509,3534867,396436829,390620049
29380212_3534876,CM021106.1,7,29380212,392901962,4342509,3534876,396436838,390620058
29380212_3534878,CM021106.1,7,29380212,392901962,4342509,3534878,396436840,390620060
29380212_3534883,CM021106.1,7,29380212,392901962,4342509,3534883,396436845,390620065
29380212_3534900,CM021106.1,7,29380212,392901962,4342509,3534900,396436862,390620082
29380212_3534902,CM021106.1,7,29380212,392901962,4342509,3534902,396436864,390620084
29380212_3534906,CM021106.1,7,29380212,392901962,4342509,3534906,396436868,390620088
29380212_3534908,CM021106.1,7,29380212,392901962,4342509,3534908,396436870,390620090
29380212_3534933,CM021106.1,7,29380212,392901962,4342509,3534933,396436895,390620115
29380212_3534945,CM021106.1,7,29380212,392901962,4342509,3534945,396436907,390620127
29380212_3536170,CM021106.1,7,29380212,392901962,4342509,3536170,396438132,390621352
29378199_3773779,CM021106.1,7,29378199,392925516,6981222,3773779,396699295,390882515
29380212_3917277,CM021106.1,7,29380212,392901962,4342509,3917277,396819239,391002459
29380212_3917293,CM021106.1,7,29380212,392901962,4342509,3917293,396819255,391002475
29378199_4264910,CM021106.1,7,29378199,392925516,6981222,4264910,397190426,391373646
29378199_4264990,CM021106.1,7,29378199,392925516,6981222,4264990,397190506,391373726
29378199_4265010,CM021106.1,7,29378199,392925516,6981222,4265010,397190526,391373746
29378199_4296297,CM021106.1,7,29378199,392925516,6981222,4296297,397221813,391405033
29378199_4298062,CM021106.1,7,29378199,392925516,6981222,4298062,397223578,391406798
29378199_4298115,CM021106.1,7,29378199,392925516,6981222,4298115,397223631,391406851
29378199_4298649,CM021106.1,7,29378199,392925516,6981222,4298649,397224165,391407385
29359568_2253,CM021106.1,7,29359568,398408284,640985,2253,398410537,392593757
29344647_5113,CM021106.1,7,29344647,398408281,16377,5113,398413394,392596614
29344647_5129,CM021106.1,7,29344647,398408281,16377,5129,398413410,392596630
29344647_5309,CM021106.1,7,29344647,398408281,16377,5309,398413590,392596810
29344647_5310,CM021106.1,7,29344647,398408281,16377,5310,398413591,392596811
29344647_5316,CM021106.1,7,29344647,398408281,16377,5316,398413597,392596817
29377047_31338,CM021106.1,7,29377047,398408284,1756787,31338,398439622,392622842
29378326_32686,CM021106.1,7,29378326,398408278,1727618,32686,398440964,392624184
29378326_32699,CM021106.1,7,29378326,398408278,1727618,32699,398440977,392624197
29378326_32705,CM021106.1,7,29378326,398408278,1727618,32705,398440983,392624203
29378326_32725,CM021106.1,7,29378326,398408278,1727618,32725,398441003,392624223
29377047_50322,CM021106.1,7,29377047,398408284,1756787,50322,398458606,392641826
29377047_50488,CM021106.1,7,29377047,398408284,1756787,50488,398458772,392641992
29378326_55787,CM021106.1,7,29378326,398408278,1727618,55787,398464065,392647285
29377386_157868,CM021106.1,7,29377386,398408281,2060957,157868,398566149,392749369
29377386_157871,CM021106.1,7,29377386,398408281,2060957,157871,398566152,392749372
29377386_157982,CM021106.1,7,29377386,398408281,2060957,157982,398566263,392749483
29359568_180761,CM021106.1,7,29359568,398408284,640985,180761,398589045,392772265
29359568_180763,CM021106.1,7,29359568,398408284,640985,180763,398589047,392772267
29359568_180802,CM021106.1,7,29359568,398408284,640985,180802,398589086,392772306
29377386_183384,CM021106.1,7,29377386,398408281,2060957,183384,398591665,392774885
29377386_183386,CM021106.1,7,29377386,398408281,2060957,183386,398591667,392774887
29377386_183387,CM021106.1,7,29377386,398408281,2060957,183387,398591668,392774888
29377386_183517,CM021106.1,7,29377386,398408281,2060957,183517,398591798,392775018
29359568_186514,CM021106.1,7,29359568,398408284,640985,186514,398594798,392778018
29359568_186538,CM021106.1,7,29359568,398408284,640985,186538,398594822,392778042
29359568_186542,CM021106.1,7,29359568,398408284,640985,186542,398594826,392778046
29359568_186611,CM021106.1,7,29359568,398408284,640985,186611,398594895,392778115
29359568_189482,CM021106.1,7,29359568,398408284,640985,189482,398597766,392780986
29359568_189646,CM021106.1,7,29359568,398408284,640985,189646,398597930,392781150
29359568_190669,CM021106.1,7,29359568,398408284,640985,190669,398598953,392782173
29359568_190813,CM021106.1,7,29359568,398408284,640985,190813,398599097,392782317
29359568_190846,CM021106.1,7,29359568,398408284,640985,190846,398599130,392782350
29359568_190945,CM021106.1,7,29359568,398408284,640985,190945,398599229,392782449
29359568_191023,CM021106.1,7,29359568,398408284,640985,191023,398599307,392782527
29380886_209973,CM021106.1,7,29380886,398408284,1052636,209973,398618257,392801477
29377241_261404,CM021106.1,7,29377241,398413419,3601729,261404,398674823,392858043
29379328_324819,CM021106.1,7,29379328,398408284,3114344,324819,398733103,392916323
29378326_325348,CM021106.1,7,29378326,398408278,1727618,325348,398733626,392916846
29381014_331515,CM021106.1,7,29381014,398408283,4776103,331515,398739798,392923018
29381958_378921,CM021106.1,7,29381958,398408283,3770458,378921,398787204,392970424
29381958_378977,CM021106.1,7,29381958,398408283,3770458,378977,398787260,392970480
29381958_378996,CM021106.1,7,29381958,398408283,3770458,378996,398787279,392970499
29381958_379150,CM021106.1,7,29381958,398408283,3770458,379150,398787433,392970653
29381958_379185,CM021106.1,7,29381958,398408283,3770458,379185,398787468,392970688
29378048_378535,CM021106.1,7,29378048,398414085,4501629,378535,398792620,392975840
29378048_378589,CM021106.1,7,29378048,398414085,4501629,378589,398792674,392975894
29378048_378605,CM021106.1,7,29378048,398414085,4501629,378605,398792690,392975910
29378048_378606,CM021106.1,7,29378048,398414085,4501629,378606,398792691,392975911
29378048_378638,CM021106.1,7,29378048,398414085,4501629,378638,398792723,392975943
29378048_378642,CM021106.1,7,29378048,398414085,4501629,378642,398792727,392975947
29378048_378663,CM021106.1,7,29378048,398414085,4501629,378663,398792748,392975968
29378048_378670,CM021106.1,7,29378048,398414085,4501629,378670,398792755,392975975
29378048_378722,CM021106.1,7,29378048,398414085,4501629,378722,398792807,392976027
29378048_378724,CM021106.1,7,29378048,398414085,4501629,378724,398792809,392976029
29378048_378731,CM021106.1,7,29378048,398414085,4501629,378731,398792816,392976036
29378048_378953,CM021106.1,7,29378048,398414085,4501629,378953,398793038,392976258
29378048_378961,CM021106.1,7,29378048,398414085,4501629,378961,398793046,392976266
29378048_379009,CM021106.1,7,29378048,398414085,4501629,379009,398793094,392976314
29378048_379062,CM021106.1,7,29378048,398414085,4501629,379062,398793147,392976367
29378048_380897,CM021106.1,7,29378048,398414085,4501629,380897,398794982,392978202
29378048_380940,CM021106.1,7,29378048,398414085,4501629,380940,398795025,392978245
29378048_383000,CM021106.1,7,29378048,398414085,4501629,383000,398797085,392980305
29377437_5892923,CM021106.1,7,29377437,392927207,8327229,5892923,398820130,393003350
29380886_459855,CM021106.1,7,29380886,398408284,1052636,459855,398868139,393051359
29380886_459948,CM021106.1,7,29380886,398408284,1052636,459948,398868232,393051452
29378694_485098,CM021106.1,7,29378694,398408284,2333380,485098,398893382,393076602
29378694_485145,CM021106.1,7,29378694,398408284,2333380,485145,398893429,393076649
29379623_487626,CM021106.1,7,29379623,398414037,1691486,487626,398901663,393084883
29378303_521996,CM021106.1,7,29378303,398408283,3173116,521996,398930279,393113499
29381509_525880,CM021106.1,7,29381509,398414787,637007,525880,398940667,393123887
29378326_539274,CM021106.1,7,29378326,398408278,1727618,539274,398947552,393130772
29378326_539293,CM021106.1,7,29378326,398408278,1727618,539293,398947571,393130791
29378326_540698,CM021106.1,7,29378326,398408278,1727618,540698,398948976,393132196
29378326_540772,CM021106.1,7,29378326,398408278,1727618,540772,398949050,393132270
29378303_546706,CM021106.1,7,29378303,398408283,3173116,546706,398954989,393138209
29378303_546755,CM021106.1,7,29378303,398408283,3173116,546755,398955038,393138258
29378303_546774,CM021106.1,7,29378303,398408283,3173116,546774,398955057,393138277
29380418_577729,CM021106.1,7,29380418,398408284,4896804,577729,398986013,393169233
29378249_606953,CM021106.1,7,29378249,398408283,1116718,606953,399015236,393198456
29378249_607010,CM021106.1,7,29378249,398408283,1116718,607010,399015293,393198513
29378249_612236,CM021106.1,7,29378249,398408283,1116718,612236,399020519,393203739
29378249_612309,CM021106.1,7,29378249,398408283,1116718,612309,399020592,393203812
29378249_612318,CM021106.1,7,29378249,398408283,1116718,612318,399020601,393203821
29380260_698995,CM021106.1,7,29380260,398408284,1222690,698995,399107279,393290499
29380260_699001,CM021106.1,7,29380260,398408284,1222690,699001,399107285,393290505
29380260_699010,CM021106.1,7,29380260,398408284,1222690,699010,399107294,393290514
29380260_699086,CM021106.1,7,29380260,398408284,1222690,699086,399107370,393290590
29378364_757673,CM021106.1,7,29378364,398408278,2679286,757673,399165951,393349171
29380886_773918,CM021106.1,7,29380886,398408284,1052636,773918,399182202,393365422
29378364_778821,CM021106.1,7,29378364,398408278,2679286,778821,399187099,393370319
29380886_816354,CM021106.1,7,29380886,398408284,1052636,816354,399224638,393407858
29380886_816406,CM021106.1,7,29380886,398408284,1052636,816406,399224690,393407910
29380886_816770,CM021106.1,7,29380886,398408284,1052636,816770,399225054,393408274
29380886_816804,CM021106.1,7,29380886,398408284,1052636,816804,399225088,393408308
29380886_816856,CM021106.1,7,29380886,398408284,1052636,816856,399225140,393408360
29380886_816875,CM021106.1,7,29380886,398408284,1052636,816875,399225159,393408379
29377047_896131,CM021106.1,7,29377047,398408284,1756787,896131,399304415,393487635
29378303_904551,CM021106.1,7,29378303,398408283,3173116,904551,399312834,393496054
29378303_907132,CM021106.1,7,29378303,398408283,3173116,907132,399315415,393498635
29377047_907197,CM021106.1,7,29377047,398408284,1756787,907197,399315481,393498701
29377047_907259,CM021106.1,7,29377047,398408284,1756787,907259,399315543,393498763
29377047_907266,CM021106.1,7,29377047,398408284,1756787,907266,399315550,393498770
29377047_907280,CM021106.1,7,29377047,398408284,1756787,907280,399315564,393498784
29377047_907304,CM021106.1,7,29377047,398408284,1756787,907304,399315588,393498808
29377047_907313,CM021106.1,7,29377047,398408284,1756787,907313,399315597,393498817
29377047_907338,CM021106.1,7,29377047,398408284,1756787,907338,399315622,393498842
29377047_907340,CM021106.1,7,29377047,398408284,1756787,907340,399315624,393498844
29377047_907383,CM021106.1,7,29377047,398408284,1756787,907383,399315667,393498887
29378199_6400494,CM021106.1,7,29378199,392925516,6981222,6400494,399326010,393509230
29378694_927006,CM021106.1,7,29378694,398408284,2333380,927006,399335290,393518510
29378694_927041,CM021106.1,7,29378694,398408284,2333380,927041,399335325,393518545
29378694_927049,CM021106.1,7,29378694,398408284,2333380,927049,399335333,393518553
29378694_927078,CM021106.1,7,29378694,398408284,2333380,927078,399335362,393518582
29378694_927079,CM021106.1,7,29378694,398408284,2333380,927079,399335363,393518583
29378199_6425604,CM021106.1,7,29378199,392925516,6981222,6425604,399351120,393534340
29378199_6425653,CM021106.1,7,29378199,392925516,6981222,6425653,399351169,393534389
29378199_6425711,CM021106.1,7,29378199,392925516,6981222,6425711,399351227,393534447
29380886_946294,CM021106.1,7,29380886,398408284,1052636,946294,399354578,393537798
29380886_946657,CM021106.1,7,29380886,398408284,1052636,946657,399354941,393538161
29380886_946840,CM021106.1,7,29380886,398408284,1052636,946840,399355124,393538344
29380886_948202,CM021106.1,7,29380886,398408284,1052636,948202,399356486,393539706
29380886_948467,CM021106.1,7,29380886,398408284,1052636,948467,399356751,393539971
29380886_948478,CM021106.1,7,29380886,398408284,1052636,948478,399356762,393539982
29380886_948520,CM021106.1,7,29380886,398408284,1052636,948520,399356804,393540024
29380886_948561,CM021106.1,7,29380886,398408284,1052636,948561,399356845,393540065
29377241_964470,CM021106.1,7,29377241,398413419,3601729,964470,399377889,393561109
29377241_964471,CM021106.1,7,29377241,398413419,3601729,964471,399377890,393561110
29379070_968977,CM021106.1,7,29379070,398414387,1374165,968977,399383364,393566584
29379070_972504,CM021106.1,7,29379070,398414387,1374165,972504,399386891,393570111
29379070_972588,CM021106.1,7,29379070,398414387,1374165,972588,399386975,393570195
29379070_972668,CM021106.1,7,29379070,398414387,1374165,972668,399387055,393570275
29379070_975107,CM021106.1,7,29379070,398414387,1374165,975107,399389494,393572714
29379070_975517,CM021106.1,7,29379070,398414387,1374165,975517,399389904,393573124
29379070_1013856,CM021106.1,7,29379070,398414387,1374165,1013856,399428243,393611463
29378048_1025541,CM021106.1,7,29378048,398414085,4501629,1025541,399439626,393622846
29377241_1063618,CM021106.1,7,29377241,398413419,3601729,1063618,399477037,393660257
29377241_1063854,CM021106.1,7,29377241,398413419,3601729,1063854,399477273,393660493
29382349_1134580,CM021106.1,7,29382349,398413916,1298639,1134580,399548496,393731716
29377462_1150776,CM021106.1,7,29377462,398408284,5548089,1150776,399559060,393742280
29377462_1150795,CM021106.1,7,29377462,398408284,5548089,1150795,399559079,393742299
29377462_1150808,CM021106.1,7,29377462,398408284,5548089,1150808,399559092,393742312
29377462_1150821,CM021106.1,7,29377462,398408284,5548089,1150821,399559105,393742325
29378048_1199530,CM021106.1,7,29378048,398414085,4501629,1199530,399613615,393796835
29378303_1212645,CM021106.1,7,29378303,398408283,3173116,1212645,399620928,393804148
29378303_1219584,CM021106.1,7,29378303,398408283,3173116,1219584,399627867,393811087
29378115_1263389,CM021106.1,7,29378115,398408284,1899983,1263389,399671673,393854893
29378115_1263472,CM021106.1,7,29378115,398408284,1899983,1263472,399671756,393854976
29378115_1263506,CM021106.1,7,29378115,398408284,1899983,1263506,399671790,393855010
29378364_1533113,CM021106.1,7,29378364,398408278,2679286,1533113,399941391,394124611
29377047_1544517,CM021106.1,7,29377047,398408284,1756787,1544517,399952801,394136021
29378364_1548425,CM021106.1,7,29378364,398408278,2679286,1548425,399956703,394139923
29377047_1594675,CM021106.1,7,29377047,398408284,1756787,1594675,400002959,394186179
29377437_7159361,CM021106.1,7,29377437,392927207,8327229,7159361,400086568,394269788
29377437_7159367,CM021106.1,7,29377437,392927207,8327229,7159367,400086574,394269794
29377437_7159569,CM021106.1,7,29377437,392927207,8327229,7159569,400086776,394269996
29380418_1806008,CM021106.1,7,29380418,398408284,4896804,1806008,400214292,394397512
29380680_1826023,CM021106.1,7,29380680,398408282,1962178,1826023,400234305,394417525
29378303_1866725,CM021106.1,7,29378303,398408283,3173116,1866725,400275008,394458228
29378303_1866735,CM021106.1,7,29378303,398408283,3173116,1866735,400275018,394458238
29378303_1866809,CM021106.1,7,29378303,398408283,3173116,1866809,400275092,394458312
29378303_1866831,CM021106.1,7,29378303,398408283,3173116,1866831,400275114,394458334
29381382_2180539,CM021106.1,7,29381382,398408284,3167061,2180539,400588823,394772043
29381382_2180595,CM021106.1,7,29381382,398408284,3167061,2180595,400588879,394772099
29381382_2180695,CM021106.1,7,29381382,398408284,3167061,2180695,400588979,394772199
29377241_2214290,CM021106.1,7,29377241,398413419,3601729,2214290,400627709,394810929
29378303_2358459,CM021106.1,7,29378303,398408283,3173116,2358459,400766742,394949962
29378303_2358472,CM021106.1,7,29378303,398408283,3173116,2358472,400766755,394949975
29381369_2371186,CM021106.1,7,29381369,398408284,4894627,2371186,400779470,394962690
29381369_2373918,CM021106.1,7,29381369,398408284,4894627,2373918,400782202,394965422
29381369_2374198,CM021106.1,7,29381369,398408284,4894627,2374198,400782482,394965702
29378364_2581075,CM021106.1,7,29378364,398408278,2679286,2581075,400989353,395172573
29378364_2581091,CM021106.1,7,29378364,398408278,2679286,2581091,400989369,395172589
29378364_2581130,CM021106.1,7,29378364,398408278,2679286,2581130,400989408,395172628
29381369_2679135,CM021106.1,7,29381369,398408284,4894627,2679135,401087419,395270639
29381369_2688539,CM021106.1,7,29381369,398408284,4894627,2688539,401096823,395280043
29381369_2688907,CM021106.1,7,29381369,398408284,4894627,2688907,401097191,395280411
29381014_2744850,CM021106.1,7,29381014,398408283,4776103,2744850,401153133,395336353
29381014_2744864,CM021106.1,7,29381014,398408283,4776103,2744864,401153147,395336367
29379328_2791338,CM021106.1,7,29379328,398408284,3114344,2791338,401199622,395382842
29381369_3216133,CM021106.1,7,29381369,398408284,4894627,3216133,401624417,395807637
29381369_3217232,CM021106.1,7,29381369,398408284,4894627,3217232,401625516,395808736
29381369_3217299,CM021106.1,7,29381369,398408284,4894627,3217299,401625583,395808803
29381369_3224374,CM021106.1,7,29381369,398408284,4894627,3224374,401632658,395815878
29381369_3224400,CM021106.1,7,29381369,398408284,4894627,3224400,401632684,395815904
29381369_3224439,CM021106.1,7,29381369,398408284,4894627,3224439,401632723,395815943
29381958_3715367,CM021106.1,7,29381958,398408283,3770458,3715367,402123650,396306870
29377462_3836171,CM021106.1,7,29377462,398408284,5548089,3836171,402244455,396427675
29377462_3836218,CM021106.1,7,29377462,398408284,5548089,3836218,402244502,396427722
29377462_3963009,CM021106.1,7,29377462,398408284,5548089,3963009,402371293,396554513
29377462_3963113,CM021106.1,7,29377462,398408284,5548089,3963113,402371397,396554617
29377462_4275453,CM021106.1,7,29377462,398408284,5548089,4275453,402683737,396866957
29378048_4462914,CM021106.1,7,29378048,398414085,4501629,4462914,402876999,397060219
29378048_4462915,CM021106.1,7,29378048,398414085,4501629,4462915,402877000,397060220
29381369_4728776,CM021106.1,7,29381369,398408284,4894627,4728776,403137060,397320280
29381369_4728820,CM021106.1,7,29381369,398408284,4894627,4728820,403137104,397320324
29381369_4728876,CM021106.1,7,29381369,398408284,4894627,4728876,403137160,397320380
29381369_4729260,CM021106.1,7,29381369,398408284,4894627,4729260,403137544,397320764
29351763_4322,CM021106.1,7,29351763,411065458,44252,4322,411069780,405253000
29378841_984,CM021106.1,7,29378841,418211013,6228913,984,418211997,412395217
29378841_1081,CM021106.1,7,29378841,418211013,6228913,1081,418212094,412395314
29378841_1089,CM021106.1,7,29378841,418211013,6228913,1089,418212102,412395322
29378841_1109,CM021106.1,7,29378841,418211013,6228913,1109,418212122,412395342
29378841_1118,CM021106.1,7,29378841,418211013,6228913,1118,418212131,412395351
29380659_12826,CM021106.1,7,29380659,418210487,697814,12826,418223313,412406533
29377959_31949,CM021106.1,7,29377959,418212611,2571413,31949,418244560,412427780
29378706_32243,CM021106.1,7,29378706,418213220,606374,32243,418245463,412428683
29378706_43936,CM021106.1,7,29378706,418213220,606374,43936,418257156,412440376
29381213_69419,CM021106.1,7,29381213,418212855,444160,69419,418282274,412465494
29378706_74528,CM021106.1,7,29378706,418213220,606374,74528,418287748,412470968
29378706_74550,CM021106.1,7,29378706,418213220,606374,74550,418287770,412470990
29378706_74613,CM021106.1,7,29378706,418213220,606374,74613,418287833,412471053
29381213_146005,CM021106.1,7,29381213,418212855,444160,146005,418358860,412542080
29381213_146007,CM021106.1,7,29381213,418212855,444160,146007,418358862,412542082
29381213_146105,CM021106.1,7,29381213,418212855,444160,146105,418358960,412542180
29347763_162117,CM021106.1,7,29347763,418211224,658236,162117,418373341,412556561
29347763_162163,CM021106.1,7,29347763,418211224,658236,162163,418373387,412556607
29377263_231502,CM021106.1,7,29377263,418206244,806910,231502,418437746,412620966
29382309_238926,CM021106.1,7,29382309,418211239,1392226,238926,418450165,412633385
29382309_238936,CM021106.1,7,29382309,418211239,1392226,238936,418450175,412633395
29382309_249536,CM021106.1,7,29382309,418211239,1392226,249536,418460775,412643995
29381751_278243,CM021106.1,7,29381751,418206933,4094763,278243,418485176,412668396
29381751_278259,CM021106.1,7,29381751,418206933,4094763,278259,418485192,412668412
29381751_278628,CM021106.1,7,29381751,418206933,4094763,278628,418485561,412668781
29381751_278733,CM021106.1,7,29381751,418206933,4094763,278733,418485666,412668886
29377777_283883,CM021106.1,7,29377777,418213506,1505262,283883,418497389,412680609
29377777_283975,CM021106.1,7,29377777,418213506,1505262,283975,418497481,412680701
29381751_297185,CM021106.1,7,29381751,418206933,4094763,297185,418504118,412687338
29381751_298436,CM021106.1,7,29381751,418206933,4094763,298436,418505369,412688589
29381751_308505,CM021106.1,7,29381751,418206933,4094763,308505,418515438,412698658
29381751_308520,CM021106.1,7,29381751,418206933,4094763,308520,418515453,412698673
29382309_309867,CM021106.1,7,29382309,418211239,1392226,309867,418521106,412704326
29382113_350458,CM021106.1,7,29382113,418212077,487916,350458,418562535,412745755
29378354_358268,CM021106.1,7,29378354,418211608,631684,358268,418569876,412753096
29378354_358279,CM021106.1,7,29378354,418211608,631684,358279,418569887,412753107
29347763_362156,CM021106.1,7,29347763,418211224,658236,362156,418573380,412756600
29381213_375756,CM021106.1,7,29381213,418212855,444160,375756,418588611,412771831
29381213_375813,CM021106.1,7,29381213,418212855,444160,375813,418588668,412771888
29381213_375821,CM021106.1,7,29381213,418212855,444160,375821,418588676,412771896
29381213_375834,CM021106.1,7,29381213,418212855,444160,375834,418588689,412771909
29381213_375836,CM021106.1,7,29381213,418212855,444160,375836,418588691,412771911
29381213_375895,CM021106.1,7,29381213,418212855,444160,375895,418588750,412771970
29381213_375902,CM021106.1,7,29381213,418212855,444160,375902,418588757,412771977
29381213_375907,CM021106.1,7,29381213,418212855,444160,375907,418588762,412771982
29378354_378083,CM021106.1,7,29378354,418211608,631684,378083,418589691,412772911
29377248_379505,CM021106.1,7,29377248,418211092,3812296,379505,418590597,412773817
29377248_379544,CM021106.1,7,29377248,418211092,3812296,379544,418590636,412773856
29377248_379583,CM021106.1,7,29377248,418211092,3812296,379583,418590675,412773895
29377248_379651,CM021106.1,7,29377248,418211092,3812296,379651,418590743,412773963
29350629_394624,CM021106.1,7,29350629,418212564,1067573,394624,418607188,412790408
29350629_394969,CM021106.1,7,29350629,418212564,1067573,394969,418607533,412790753
29378354_415751,CM021106.1,7,29378354,418211608,631684,415751,418627359,412810579
29378354_415791,CM021106.1,7,29378354,418211608,631684,415791,418627399,412810619
29347763_427550,CM021106.1,7,29347763,418211224,658236,427550,418638774,412821994
29347763_427551,CM021106.1,7,29347763,418211224,658236,427551,418638775,412821995
29347763_427731,CM021106.1,7,29347763,418211224,658236,427731,418638955,412822175
29350629_441805,CM021106.1,7,29350629,418212564,1067573,441805,418654369,412837589
29350629_443566,CM021106.1,7,29350629,418212564,1067573,443566,418656130,412839350
29379734_481399,CM021106.1,7,29379734,418206249,5896190,481399,418687648,412870868
29379734_481454,CM021106.1,7,29379734,418206249,5896190,481454,418687703,412870923
29379734_481531,CM021106.1,7,29379734,418206249,5896190,481531,418687780,412871000
29378986_480440,CM021106.1,7,29378986,418212434,1977277,480440,418692874,412876094
29378986_480504,CM021106.1,7,29378986,418212434,1977277,480504,418692938,412876158
29347763_485876,CM021106.1,7,29347763,418211224,658236,485876,418697100,412880320
29347763_485895,CM021106.1,7,29347763,418211224,658236,485895,418697119,412880339
29347763_486065,CM021106.1,7,29347763,418211224,658236,486065,418697289,412880509
29377777_484131,CM021106.1,7,29377777,418213506,1505262,484131,418697637,412880857
29378354_486737,CM021106.1,7,29378354,418211608,631684,486737,418698345,412881565
29378354_486800,CM021106.1,7,29378354,418211608,631684,486800,418698408,412881628
29377777_491597,CM021106.1,7,29377777,418213506,1505262,491597,418705103,412888323
29377777_491651,CM021106.1,7,29377777,418213506,1505262,491651,418705157,412888377
29377248_513853,CM021106.1,7,29377248,418211092,3812296,513853,418724945,412908165
29377248_513854,CM021106.1,7,29377248,418211092,3812296,513854,418724946,412908166
29377248_513926,CM021106.1,7,29377248,418211092,3812296,513926,418725018,412908238
29377248_513933,CM021106.1,7,29377248,418211092,3812296,513933,418725025,412908245
29381751_540600,CM021106.1,7,29381751,418206933,4094763,540600,418747533,412930753
29381751_541012,CM021106.1,7,29381751,418206933,4094763,541012,418747945,412931165
29381751_541026,CM021106.1,7,29381751,418206933,4094763,541026,418747959,412931179
29378354_543465,CM021106.1,7,29378354,418211608,631684,543465,418755073,412938293
29378354_543466,CM021106.1,7,29378354,418211608,631684,543466,418755074,412938294
29381751_556652,CM021106.1,7,29381751,418206933,4094763,556652,418763585,412946805
29382309_552928,CM021106.1,7,29382309,418211239,1392226,552928,418764167,412947387
29382309_555920,CM021106.1,7,29382309,418211239,1392226,555920,418767159,412950379
29382309_579625,CM021106.1,7,29382309,418211239,1392226,579625,418790864,412974084
29382309_579670,CM021106.1,7,29382309,418211239,1392226,579670,418790909,412974129
29382309_579948,CM021106.1,7,29382309,418211239,1392226,579948,418791187,412974407
29378706_583836,CM021106.1,7,29378706,418213220,606374,583836,418797056,412980276
29378706_583847,CM021106.1,7,29378706,418213220,606374,583847,418797067,412980287
29378819_684269,CM021106.1,7,29378819,418211534,2977348,684269,418895803,413079023
29381301_783154,CM021106.1,7,29381301,418210581,2551157,783154,418993735,413176955
29381301_783174,CM021106.1,7,29381301,418210581,2551157,783174,418993755,413176975
29381939_804970,CM021106.1,7,29381939,418211154,4312434,804970,419016124,413199344
29378986_904775,CM021106.1,7,29378986,418212434,1977277,904775,419117209,413300429
29378986_909816,CM021106.1,7,29378986,418212434,1977277,909816,419122250,413305470
29368928_934146,CM021106.1,7,29368928,418206246,1049437,934146,419140392,413323612
29368928_934157,CM021106.1,7,29368928,418206246,1049437,934157,419140403,413323623
29368928_934158,CM021106.1,7,29368928,418206246,1049437,934158,419140404,413323624
29368928_934194,CM021106.1,7,29368928,418206246,1049437,934194,419140440,413323660
29378819_937061,CM021106.1,7,29378819,418211534,2977348,937061,419148595,413331815
29378819_937091,CM021106.1,7,29378819,418211534,2977348,937091,419148625,413331845
29378819_937093,CM021106.1,7,29378819,418211534,2977348,937093,419148627,413331847
29377789_1000975,CM021106.1,7,29377789,418211300,2511077,1000975,419212275,413395495
29377789_1001013,CM021106.1,7,29377789,418211300,2511077,1001013,419212313,413395533
29378986_1005242,CM021106.1,7,29378986,418212434,1977277,1005242,419217676,413400896
29378986_1005273,CM021106.1,7,29378986,418212434,1977277,1005273,419217707,413400927
29378986_1024152,CM021106.1,7,29378986,418212434,1977277,1024152,419236586,413419806
29378986_1024238,CM021106.1,7,29378986,418212434,1977277,1024238,419236672,413419892
29377248_1026013,CM021106.1,7,29377248,418211092,3812296,1026013,419237105,413420325
29378819_1133124,CM021106.1,7,29378819,418211534,2977348,1133124,419344658,413527878
29378819_1159205,CM021106.1,7,29378819,418211534,2977348,1159205,419370739,413553959
29378819_1159284,CM021106.1,7,29378819,418211534,2977348,1159284,419370818,413554038
29378993_1188939,CM021106.1,7,29378993,418211592,2405720,1188939,419400531,413583751
29378819_1194366,CM021106.1,7,29378819,418211534,2977348,1194366,419405900,413589120
29378819_1248664,CM021106.1,7,29378819,418211534,2977348,1248664,419460198,413643418
29378819_1343416,CM021106.1,7,29378819,418211534,2977348,1343416,419554950,413738170
29377248_1378845,CM021106.1,7,29377248,418211092,3812296,1378845,419589937,413773157
29377959_1396486,CM021106.1,7,29377959,418212611,2571413,1396486,419609097,413792317
29377959_1398017,CM021106.1,7,29377959,418212611,2571413,1398017,419610628,413793848
29377959_1398025,CM021106.1,7,29377959,418212611,2571413,1398025,419610636,413793856
29377959_1398047,CM021106.1,7,29377959,418212611,2571413,1398047,419610658,413793878
29377959_1398049,CM021106.1,7,29377959,418212611,2571413,1398049,419610660,413793880
29377959_1398050,CM021106.1,7,29377959,418212611,2571413,1398050,419610661,413793881
29377959_1413604,CM021106.1,7,29377959,418212611,2571413,1413604,419626215,413809435
29377959_1414348,CM021106.1,7,29377959,418212611,2571413,1414348,419626959,413810179
29381301_1515303,CM021106.1,7,29381301,418210581,2551157,1515303,419725884,413909104
29381301_1515382,CM021106.1,7,29381301,418210581,2551157,1515382,419725963,413909183
29381939_1532463,CM021106.1,7,29381939,418211154,4312434,1532463,419743617,413926837
29377248_1608779,CM021106.1,7,29377248,418211092,3812296,1608779,419819871,414003091
29377248_1608845,CM021106.1,7,29377248,418211092,3812296,1608845,419819937,414003157
29378819_1616129,CM021106.1,7,29378819,418211534,2977348,1616129,419827663,414010883
29377248_1626635,CM021106.1,7,29377248,418211092,3812296,1626635,419837727,414020947
29377248_1910441,CM021106.1,7,29377248,418211092,3812296,1910441,420121533,414304753
29377248_1932734,CM021106.1,7,29377248,418211092,3812296,1932734,420143826,414327046
29378986_1937235,CM021106.1,7,29378986,418212434,1977277,1937235,420149669,414332889
29378986_1937291,CM021106.1,7,29378986,418212434,1977277,1937291,420149725,414332945
29378078_1959712,CM021106.1,7,29378078,418206248,8756363,1959712,420165960,414349180
29378078_1959859,CM021106.1,7,29378078,418206248,8756363,1959859,420166107,414349327
29381939_1988181,CM021106.1,7,29381939,418211154,4312434,1988181,420199335,414382555
29381939_1988204,CM021106.1,7,29381939,418211154,4312434,1988204,420199358,414382578
29381939_1988208,CM021106.1,7,29381939,418211154,4312434,1988208,420199362,414382582
29381939_1988223,CM021106.1,7,29381939,418211154,4312434,1988223,420199377,414382597
29381939_1988235,CM021106.1,7,29381939,418211154,4312434,1988235,420199389,414382609
29381939_1988306,CM021106.1,7,29381939,418211154,4312434,1988306,420199460,414382680
29379753_2080147,CM021106.1,7,29379753,418206247,4912825,2080147,420286394,414469614
29379753_2080728,CM021106.1,7,29379753,418206247,4912825,2080728,420286975,414470195
29379753_2092755,CM021106.1,7,29379753,418206247,4912825,2092755,420299002,414482222
29379753_2101056,CM021106.1,7,29379753,418206247,4912825,2101056,420307303,414490523
29379734_2117880,CM021106.1,7,29379734,418206249,5896190,2117880,420324129,414507349
29378819_2195274,CM021106.1,7,29378819,418211534,2977348,2195274,420406808,414590028
29377959_2215350,CM021106.1,7,29377959,418212611,2571413,2215350,420427961,414611181
29377248_2319427,CM021106.1,7,29377248,418211092,3812296,2319427,420530519,414713739
29378819_2475445,CM021106.1,7,29378819,418211534,2977348,2475445,420686979,414870199
29379753_2494427,CM021106.1,7,29379753,418206247,4912825,2494427,420700674,414883894
29379753_2516151,CM021106.1,7,29379753,418206247,4912825,2516151,420722398,414905618
29379753_2516157,CM021106.1,7,29379753,418206247,4912825,2516157,420722404,414905624
29379753_2516516,CM021106.1,7,29379753,418206247,4912825,2516516,420722763,414905983
29378819_2525805,CM021106.1,7,29378819,418211534,2977348,2525805,420737339,414920559
29379753_2564727,CM021106.1,7,29379753,418206247,4912825,2564727,420770974,414954194
29379753_2564757,CM021106.1,7,29379753,418206247,4912825,2564757,420771004,414954224
29379753_2591453,CM021106.1,7,29379753,418206247,4912825,2591453,420797700,414980920
29378819_2640800,CM021106.1,7,29378819,418211534,2977348,2640800,420852334,415035554
29377248_2853716,CM021106.1,7,29377248,418211092,3812296,2853716,421064808,415248028
29377248_2853870,CM021106.1,7,29377248,418211092,3812296,2853870,421064962,415248182
29377248_2853905,CM021106.1,7,29377248,418211092,3812296,2853905,421064997,415248217
29381751_2945621,CM021106.1,7,29381751,418206933,4094763,2945621,421152554,415335774
29381751_2945650,CM021106.1,7,29381751,418206933,4094763,2945650,421152583,415335803
29381751_2945653,CM021106.1,7,29381751,418206933,4094763,2945653,421152586,415335806
29379694_3417290,CM021106.1,7,29379694,418206247,4819889,3417290,421623537,415806757
29379694_3420180,CM021106.1,7,29379694,418206247,4819889,3420180,421626427,415809647
29379753_3764241,CM021106.1,7,29379753,418206247,4912825,3764241,421970488,416153708
29379753_3764304,CM021106.1,7,29379753,418206247,4912825,3764304,421970551,416153771
29379753_3764389,CM021106.1,7,29379753,418206247,4912825,3764389,421970636,416153856
29379753_3850629,CM021106.1,7,29379753,418206247,4912825,3850629,422056876,416240096
29379753_3850713,CM021106.1,7,29379753,418206247,4912825,3850713,422056960,416240180
29379753_3850762,CM021106.1,7,29379753,418206247,4912825,3850762,422057009,416240229
29379753_3850775,CM021106.1,7,29379753,418206247,4912825,3850775,422057022,416240242
29379753_3850796,CM021106.1,7,29379753,418206247,4912825,3850796,422057043,416240263
29379694_4009624,CM021106.1,7,29379694,418206247,4819889,4009624,422215871,416399091
29379753_4134477,CM021106.1,7,29379753,418206247,4912825,4134477,422340724,416523944
29379753_4134544,CM021106.1,7,29379753,418206247,4912825,4134544,422340791,416524011
29379753_4353547,CM021106.1,7,29379753,418206247,4912825,4353547,422559794,416743014
29379753_4353699,CM021106.1,7,29379753,418206247,4912825,4353699,422559946,416743166
29379753_4353712,CM021106.1,7,29379753,418206247,4912825,4353712,422559959,416743179
29378078_4420156,CM021106.1,7,29378078,418206248,8756363,4420156,422626404,416809624
29379753_4632741,CM021106.1,7,29379753,418206247,4912825,4632741,422838988,417022208
29379753_4638106,CM021106.1,7,29379753,418206247,4912825,4638106,422844353,417027573
29378078_4657027,CM021106.1,7,29378078,418206248,8756363,4657027,422863275,417046495
29378078_4657125,CM021106.1,7,29378078,418206248,8756363,4657125,422863373,417046593
29378078_4657170,CM021106.1,7,29378078,418206248,8756363,4657170,422863418,417046638
29378078_4657273,CM021106.1,7,29378078,418206248,8756363,4657273,422863521,417046741
29378078_4658329,CM021106.1,7,29378078,418206248,8756363,4658329,422864577,417047797
29379753_4750208,CM021106.1,7,29379753,418206247,4912825,4750208,422956455,417139675
29379753_4754700,CM021106.1,7,29379753,418206247,4912825,4754700,422960947,417144167
29379753_4756311,CM021106.1,7,29379753,418206247,4912825,4756311,422962558,417145778
29379753_4757070,CM021106.1,7,29379753,418206247,4912825,4757070,422963317,417146537
29379753_4757100,CM021106.1,7,29379753,418206247,4912825,4757100,422963347,417146567
29379753_4757124,CM021106.1,7,29379753,418206247,4912825,4757124,422963371,417146591
29378841_5282705,CM021106.1,7,29378841,418211013,6228913,5282705,423493718,417676938
29378078_5502637,CM021106.1,7,29378078,418206248,8756363,5502637,423708885,417892105
29378078_6138885,CM021106.1,7,29378078,418206248,8756363,6138885,424345133,418528353
29370959_2270,CM021106.1,7,29370959,424593568,86154,2270,424595838,418779058
29370959_2403,CM021106.1,7,29370959,424593568,86154,2403,424595971,418779191
29378078_7801424,CM021106.1,7,29378078,418206248,8756363,7801424,426007672,420190892
29377543_17818,CM021106.1,7,29377543,426173943,3377054,17818,426191761,420374981
29379222_29458,CM021106.1,7,29379222,426174721,528436,29458,426204179,420387399
29379222_29480,CM021106.1,7,29379222,426174721,528436,29480,426204201,420387421
29379222_29494,CM021106.1,7,29379222,426174721,528436,29494,426204215,420387435
29379222_29496,CM021106.1,7,29379222,426174721,528436,29496,426204217,420387437
29379222_29542,CM021106.1,7,29379222,426174721,528436,29542,426204263,420387483
29380724_48045,CM021106.1,7,29380724,426169426,3925866,48045,426217471,420400691
29380470_104859,CM021106.1,7,29380470,426175146,1786465,104859,426280005,420463225
29382259_123667,CM021106.1,7,29382259,426177846,977593,123667,426301513,420484733
29382259_123668,CM021106.1,7,29382259,426177846,977593,123668,426301514,420484734
29382259_123734,CM021106.1,7,29382259,426177846,977593,123734,426301580,420484800
29382259_123741,CM021106.1,7,29382259,426177846,977593,123741,426301587,420484807
29381578_133627,CM021106.1,7,29381578,426170630,326987,133627,426304257,420487477
29381578_133705,CM021106.1,7,29381578,426170630,326987,133705,426304335,420487555
29381578_134103,CM021106.1,7,29381578,426170630,326987,134103,426304733,420487953
29377543_139099,CM021106.1,7,29377543,426173943,3377054,139099,426313042,420496262
29381578_256788,CM021106.1,7,29381578,426170630,326987,256788,426427418,420610638
29381578_256790,CM021106.1,7,29381578,426170630,326987,256790,426427420,420610640
29381578_256822,CM021106.1,7,29381578,426170630,326987,256822,426427452,420610672
29381578_256838,CM021106.1,7,29381578,426170630,326987,256838,426427468,420610688
29381578_256894,CM021106.1,7,29381578,426170630,326987,256894,426427524,420610744
29381578_256985,CM021106.1,7,29381578,426170630,326987,256985,426427615,420610835
29381578_256992,CM021106.1,7,29381578,426170630,326987,256992,426427622,420610842
29378758_341684,CM021106.1,7,29378758,426174988,1625467,341684,426516672,420699892
29378758_341703,CM021106.1,7,29378758,426174988,1625467,341703,426516691,420699911
29377274_343415,CM021106.1,7,29377274,426174177,2888574,343415,426517592,420700812
29379570_388708,CM021106.1,7,29379570,426169420,3204790,388708,426558128,420741348
29382259_394532,CM021106.1,7,29382259,426177846,977593,394532,426572378,420755598
29380410_423739,CM021106.1,7,29380410,426170479,1107583,423739,426594218,420777438
29380410_423847,CM021106.1,7,29380410,426170479,1107583,423847,426594326,420777546
29380410_423893,CM021106.1,7,29380410,426170479,1107583,423893,426594372,420777592
29380410_424007,CM021106.1,7,29380410,426170479,1107583,424007,426594486,420777706
29380410_430070,CM021106.1,7,29380410,426170479,1107583,430070,426600549,420783769
29378868_484606,CM021106.1,7,29378868,426174360,3196743,484606,426658966,420842186
29378868_484649,CM021106.1,7,29378868,426174360,3196743,484649,426659009,420842229
29378868_498444,CM021106.1,7,29378868,426174360,3196743,498444,426672804,420856024
29378868_498459,CM021106.1,7,29378868,426174360,3196743,498459,426672819,420856039
29378868_498469,CM021106.1,7,29378868,426174360,3196743,498469,426672829,420856049
29378868_606686,CM021106.1,7,29378868,426174360,3196743,606686,426781046,420964266
29378868_629621,CM021106.1,7,29378868,426174360,3196743,629621,426803981,420987201
29380470_654691,CM021106.1,7,29380470,426175146,1786465,654691,426829837,421013057
29378868_695564,CM021106.1,7,29378868,426174360,3196743,695564,426869924,421053144
29380724_888688,CM021106.1,7,29380724,426169426,3925866,888688,427058114,421241334
29380724_888697,CM021106.1,7,29380724,426169426,3925866,888697,427058123,421241343
29380724_888744,CM021106.1,7,29380724,426169426,3925866,888744,427058170,421241390
29380724_888746,CM021106.1,7,29380724,426169426,3925866,888746,427058172,421241392
29380724_888765,CM021106.1,7,29380724,426169426,3925866,888765,427058191,421241411
29380724_888797,CM021106.1,7,29380724,426169426,3925866,888797,427058223,421241443
29380724_888805,CM021106.1,7,29380724,426169426,3925866,888805,427058231,421241451
29380724_888809,CM021106.1,7,29380724,426169426,3925866,888809,427058235,421241455
29377319_902250,CM021106.1,7,29377319,426176736,1759954,902250,427078986,421262206
29379813_1104707,CM021106.1,7,29379813,426174775,3667066,1104707,427279482,421462702
29377543_1112749,CM021106.1,7,29377543,426173943,3377054,1112749,427286692,421469912
29377543_1112776,CM021106.1,7,29377543,426173943,3377054,1112776,427286719,421469939
29377543_1112788,CM021106.1,7,29377543,426173943,3377054,1112788,427286731,421469951
29377543_1123638,CM021106.1,7,29377543,426173943,3377054,1123638,427297581,421480801
29377543_1123660,CM021106.1,7,29377543,426173943,3377054,1123660,427297603,421480823
29377543_1123684,CM021106.1,7,29377543,426173943,3377054,1123684,427297627,421480847
29377274_1150691,CM021106.1,7,29377274,426174177,2888574,1150691,427324868,421508088
29378618_1157993,CM021106.1,7,29378618,426169710,1699635,1157993,427327703,421510923
29377543_1176724,CM021106.1,7,29377543,426173943,3377054,1176724,427350667,421533887
29380724_1354404,CM021106.1,7,29380724,426169426,3925866,1354404,427523830,421707050
29378868_1360713,CM021106.1,7,29378868,426174360,3196743,1360713,427535073,421718293
29378758_1466280,CM021106.1,7,29378758,426174988,1625467,1466280,427641268,421824488
29378758_1466285,CM021106.1,7,29378758,426174988,1625467,1466285,427641273,421824493
29378758_1466309,CM021106.1,7,29378758,426174988,1625467,1466309,427641297,421824517
29378758_1466315,CM021106.1,7,29378758,426174988,1625467,1466315,427641303,421824523
29378758_1466317,CM021106.1,7,29378758,426174988,1625467,1466317,427641305,421824525
29378758_1466383,CM021106.1,7,29378758,426174988,1625467,1466383,427641371,421824591
29378758_1466386,CM021106.1,7,29378758,426174988,1625467,1466386,427641374,421824594
29378758_1466413,CM021106.1,7,29378758,426174988,1625467,1466413,427641401,421824621
29378758_1466431,CM021106.1,7,29378758,426174988,1625467,1466431,427641419,421824639
29378758_1466455,CM021106.1,7,29378758,426174988,1625467,1466455,427641443,421824663
29377274_1504439,CM021106.1,7,29377274,426174177,2888574,1504439,427678616,421861836
29377274_1504493,CM021106.1,7,29377274,426174177,2888574,1504493,427678670,421861890
29377274_1505765,CM021106.1,7,29377274,426174177,2888574,1505765,427679942,421863162
29377274_1505812,CM021106.1,7,29377274,426174177,2888574,1505812,427679989,421863209
29377274_1583636,CM021106.1,7,29377274,426174177,2888574,1583636,427757813,421941033
29377274_1583675,CM021106.1,7,29377274,426174177,2888574,1583675,427757852,421941072
29377274_1586232,CM021106.1,7,29377274,426174177,2888574,1586232,427760409,421943629
29377274_1586426,CM021106.1,7,29377274,426174177,2888574,1586426,427760603,421943823
29377274_1586446,CM021106.1,7,29377274,426174177,2888574,1586446,427760623,421943843
29377274_1586454,CM021106.1,7,29377274,426174177,2888574,1586454,427760631,421943851
29379813_1693736,CM021106.1,7,29379813,426174775,3667066,1693736,427868511,422051731
29378868_1748410,CM021106.1,7,29378868,426174360,3196743,1748410,427922770,422105990
29377274_1754928,CM021106.1,7,29377274,426174177,2888574,1754928,427929105,422112325
29377274_1755078,CM021106.1,7,29377274,426174177,2888574,1755078,427929255,422112475
29377274_1755088,CM021106.1,7,29377274,426174177,2888574,1755088,427929265,422112485
29377274_1755152,CM021106.1,7,29377274,426174177,2888574,1755152,427929329,422112549
29379570_1802204,CM021106.1,7,29379570,426169420,3204790,1802204,427971624,422154844
29379570_1802247,CM021106.1,7,29379570,426169420,3204790,1802247,427971667,422154887
29379570_1802274,CM021106.1,7,29379570,426169420,3204790,1802274,427971694,422154914
29379570_1831060,CM021106.1,7,29379570,426169420,3204790,1831060,428000480,422183700
29379570_1831196,CM021106.1,7,29379570,426169420,3204790,1831196,428000616,422183836
29379570_1831214,CM021106.1,7,29379570,426169420,3204790,1831214,428000634,422183854
29379570_1831252,CM021106.1,7,29379570,426169420,3204790,1831252,428000672,422183892
29379570_1842055,CM021106.1,7,29379570,426169420,3204790,1842055,428011475,422194695
29379570_1842056,CM021106.1,7,29379570,426169420,3204790,1842056,428011476,422194696
29379570_1842067,CM021106.1,7,29379570,426169420,3204790,1842067,428011487,422194707
29379570_1963621,CM021106.1,7,29379570,426169420,3204790,1963621,428133041,422316261
29377274_2131541,CM021106.1,7,29377274,426174177,2888574,2131541,428305718,422488938
29377274_2131587,CM021106.1,7,29377274,426174177,2888574,2131587,428305764,422488984
29377274_2149883,CM021106.1,7,29377274,426174177,2888574,2149883,428324060,422507280
29377274_2154063,CM021106.1,7,29377274,426174177,2888574,2154063,428328240,422511460
29377274_2154616,CM021106.1,7,29377274,426174177,2888574,2154616,428328793,422512013
29377274_2178792,CM021106.1,7,29377274,426174177,2888574,2178792,428352969,422536189
29377274_2178901,CM021106.1,7,29377274,426174177,2888574,2178901,428353078,422536298
29377274_2178955,CM021106.1,7,29377274,426174177,2888574,2178955,428353132,422536352
29377274_2178970,CM021106.1,7,29377274,426174177,2888574,2178970,428353147,422536367
29379813_2186814,CM021106.1,7,29379813,426174775,3667066,2186814,428361589,422544809
29379813_2186823,CM021106.1,7,29379813,426174775,3667066,2186823,428361598,422544818
29379813_2186926,CM021106.1,7,29379813,426174775,3667066,2186926,428361701,422544921
29379813_2186936,CM021106.1,7,29379813,426174775,3667066,2186936,428361711,422544931
29378868_2233422,CM021106.1,7,29378868,426174360,3196743,2233422,428407782,422591002
29378868_2233491,CM021106.1,7,29378868,426174360,3196743,2233491,428407851,422591071
29378868_2245982,CM021106.1,7,29378868,426174360,3196743,2245982,428420342,422603562
29377274_2275200,CM021106.1,7,29377274,426174177,2888574,2275200,428449377,422632597
29377274_2275243,CM021106.1,7,29377274,426174177,2888574,2275243,428449420,422632640
29377274_2289289,CM021106.1,7,29377274,426174177,2888574,2289289,428463466,422646686
29377543_2491709,CM021106.1,7,29377543,426173943,3377054,2491709,428665652,422848872
29377543_2491905,CM021106.1,7,29377543,426173943,3377054,2491905,428665848,422849068
29377543_2491985,CM021106.1,7,29377543,426173943,3377054,2491985,428665928,422849148
29377274_2615998,CM021106.1,7,29377274,426174177,2888574,2615998,428790175,422973395
29377274_2616047,CM021106.1,7,29377274,426174177,2888574,2616047,428790224,422973444
29377274_2616049,CM021106.1,7,29377274,426174177,2888574,2616049,428790226,422973446
29377274_2631419,CM021106.1,7,29377274,426174177,2888574,2631419,428805596,422988816
29377274_2631460,CM021106.1,7,29377274,426174177,2888574,2631460,428805637,422988857
29377590_3003236,CM021106.1,7,29377590,426174326,7983986,3003236,429177562,423360782
29378868_3005382,CM021106.1,7,29378868,426174360,3196743,3005382,429179742,423362962
29378868_3005752,CM021106.1,7,29378868,426174360,3196743,3005752,429180112,423363332
29378868_3006675,CM021106.1,7,29378868,426174360,3196743,3006675,429181035,423364255
29377590_3169225,CM021106.1,7,29377590,426174326,7983986,3169225,429343551,423526771
29377590_3182316,CM021106.1,7,29377590,426174326,7983986,3182316,429356642,423539862
29377590_3191740,CM021106.1,7,29377590,426174326,7983986,3191740,429366066,423549286
29377590_4708290,CM021106.1,7,29377590,426174326,7983986,4708290,430882616,425065836
29377590_4916668,CM021106.1,7,29377590,426174326,7983986,4916668,431090994,425274214
29377590_5900548,CM021106.1,7,29377590,426174326,7983986,5900548,432074874,426258094
29377590_5900613,CM021106.1,7,29377590,426174326,7983986,5900613,432074939,426258159
29377590_6561850,CM021106.1,7,29377590,426174326,7983986,6561850,432736176,426919396
29377590_6561885,CM021106.1,7,29377590,426174326,7983986,6561885,432736211,426919431
29377590_6561908,CM021106.1,7,29377590,426174326,7983986,6561908,432736234,426919454
29377590_6614047,CM021106.1,7,29377590,426174326,7983986,6614047,432788373,426971593
29377590_6614970,CM021106.1,7,29377590,426174326,7983986,6614970,432789296,426972516
29377590_6615029,CM021106.1,7,29377590,426174326,7983986,6615029,432789355,426972575
29377590_6615039,CM021106.1,7,29377590,426174326,7983986,6615039,432789365,426972585
29380844_294749,CM021106.1,7,29380844,450864111,3576743,294749,451158860,445342080
29380844_294764,CM021106.1,7,29380844,450864111,3576743,294764,451158875,445342095
29380844_294799,CM021106.1,7,29380844,450864111,3576743,294799,451158910,445342130
29381378_300335,CM021106.1,7,29381378,450864112,1603348,300335,451164447,445347667
29381546_343820,CM021106.1,7,29381546,450864111,470888,343820,451207931,445391151
29381546_383187,CM021106.1,7,29381546,450864111,470888,383187,451247298,445430518
29381378_383645,CM021106.1,7,29381378,450864112,1603348,383645,451247757,445430977
29381378_383755,CM021106.1,7,29381378,450864112,1603348,383755,451247867,445431087
29381378_495037,CM021106.1,7,29381378,450864112,1603348,495037,451359149,445542369
29378502_514226,CM021106.1,7,29378502,450864111,1681162,514226,451378337,445561557
29381378_583744,CM021106.1,7,29381378,450864112,1603348,583744,451447856,445631076
29381378_586545,CM021106.1,7,29381378,450864112,1603348,586545,451450657,445633877
29381219_665481,CM021106.1,7,29381219,450866054,1316867,665481,451531535,445714755
29377366_767315,CM021106.1,7,29377366,450865388,1456134,767315,451632703,445815923
29377366_767325,CM021106.1,7,29377366,450865388,1456134,767325,451632713,445815933
29377366_767370,CM021106.1,7,29377366,450865388,1456134,767370,451632758,445815978
29381378_926587,CM021106.1,7,29381378,450864112,1603348,926587,451790699,445973919
29381378_1355636,CM021106.1,7,29381378,450864112,1603348,1355636,452219748,446402968
29380844_1454211,CM021106.1,7,29380844,450864111,3576743,1454211,452318322,446501542
29380844_2942479,CM021106.1,7,29380844,450864111,3576743,2942479,453806590,447989810
29380844_2942507,CM021106.1,7,29380844,450864111,3576743,2942507,453806618,447989838
29380844_3214196,CM021106.1,7,29380844,450864111,3576743,3214196,454078307,448261527
29378884_45920,CM021106.1,7,29378884,455236025,1883190,45920,455281945,449465165
29378884_45959,CM021106.1,7,29378884,455236025,1883190,45959,455281984,449465204
29378884_89782,CM021106.1,7,29378884,455236025,1883190,89782,455325807,449509027
29378884_89838,CM021106.1,7,29378884,455236025,1883190,89838,455325863,449509083
29378884_89859,CM021106.1,7,29378884,455236025,1883190,89859,455325884,449509104
29378884_89861,CM021106.1,7,29378884,455236025,1883190,89861,455325886,449509106
29378884_90194,CM021106.1,7,29378884,455236025,1883190,90194,455326219,449509439
29378884_116022,CM021106.1,7,29378884,455236025,1883190,116022,455352047,449535267
29378884_259419,CM021106.1,7,29378884,455236025,1883190,259419,455495444,449678664
29382496_6532,CM021106.1,7,29382496,472756090,964161,6532,472762622,466945842
29198703_795,CM021106.1,7,29198703,498903379,9208,795,498904174,493087394
29355586_39188,CM021106.1,7,29355586,526320657,53919,39188,526359845,520543065
29355586_39195,CM021106.1,7,29355586,526320657,53919,39195,526359852,520543072
29355586_39197,CM021106.1,7,29355586,526320657,53919,39197,526359854,520543074
29355586_39220,CM021106.1,7,29355586,526320657,53919,39220,526359877,520543097
29355586_39448,CM021106.1,7,29355586,526320657,53919,39448,526360105,520543325
29355586_39452,CM021106.1,7,29355586,526320657,53919,39452,526360109,520543329
29260056_4699,CM021106.1,7,29260056,532492326,9998,4699,532497025,526680245
29260056_4712,CM021106.1,7,29260056,532492326,9998,4712,532497038,526680258
29381991_385488,CM021106.1,7,29381991,535012962,984604,385488,535398450,529581670
29336437_43498,CM021106.1,7,29336437,553192468,517435,43498,553235966,547419186
29336437_46362,CM021106.1,7,29336437,553192468,517435,46362,553238830,547422050
29377339_208112,CM021106.1,7,29377339,553192470,857388,208112,553400582,547583802
29377339_208131,CM021106.1,7,29377339,553192470,857388,208131,553400601,547583821
29381084_441043,CM021106.1,7,29381084,555498708,448473,441043,555939751,550122971
29355697_111234,CM021106.1,7,29355697,560037151,745744,111234,560148385,554331605
29378749_308394,CM021106.1,7,29378749,562543923,1020773,308394,562852317,557035537
29380814_354611,CM021106.1,7,29380814,586736545,676942,354611,587091156,581274376
29378644_495160,CM021106.1,7,29378644,586736545,757372,495160,587231705,581414925
29378644_495168,CM021106.1,7,29378644,586736545,757372,495168,587231713,581414933
29378644_495227,CM021106.1,7,29378644,586736545,757372,495227,587231772,581414992
29378644_495364,CM021106.1,7,29378644,586736545,757372,495364,587231909,581415129
29378644_495938,CM021106.1,7,29378644,586736545,757372,495938,587232483,581415703
29378644_495949,CM021106.1,7,29378644,586736545,757372,495949,587232494,581415714
29380217_1120030,CM021106.1,7,29380217,586736541,7325470,1120030,587856571,582039791
29380217_1521091,CM021106.1,7,29380217,586736541,7325470,1521091,588257632,582440852
29380217_1521152,CM021106.1,7,29380217,586736541,7325470,1521152,588257693,582440913
29380217_1521155,CM021106.1,7,29380217,586736541,7325470,1521155,588257696,582440916
29380217_1521201,CM021106.1,7,29380217,586736541,7325470,1521201,588257742,582440962
29380217_1521207,CM021106.1,7,29380217,586736541,7325470,1521207,588257748,582440968
29380217_1821098,CM021106.1,7,29380217,586736541,7325470,1821098,588557639,582740859
29380217_1821643,CM021106.1,7,29380217,586736541,7325470,1821643,588558184,582741404
29380217_1848674,CM021106.1,7,29380217,586736541,7325470,1848674,588585215,582768435
29380217_1848783,CM021106.1,7,29380217,586736541,7325470,1848783,588585324,582768544
29380217_1848845,CM021106.1,7,29380217,586736541,7325470,1848845,588585386,582768606
29382294_1854276,CM021106.1,7,29382294,586736543,3160761,1854276,588590819,582774039
29382294_1854291,CM021106.1,7,29382294,586736543,3160761,1854291,588590834,582774054
29382294_1854333,CM021106.1,7,29382294,586736543,3160761,1854333,588590876,582774096
29382294_1854419,CM021106.1,7,29382294,586736543,3160761,1854419,588590962,582774182
29382294_1854423,CM021106.1,7,29382294,586736543,3160761,1854423,588590966,582774186
29382294_1854491,CM021106.1,7,29382294,586736543,3160761,1854491,588591034,582774254
29380217_2328839,CM021106.1,7,29380217,586736541,7325470,2328839,589065380,583248600
29380217_2328859,CM021106.1,7,29380217,586736541,7325470,2328859,589065400,583248620
29380217_2328884,CM021106.1,7,29380217,586736541,7325470,2328884,589065425,583248645
29382294_2460446,CM021106.1,7,29382294,586736543,3160761,2460446,589196989,583380209
29380217_2472257,CM021106.1,7,29380217,586736541,7325470,2472257,589208798,583392018
29380217_2472258,CM021106.1,7,29380217,586736541,7325470,2472258,589208799,583392019
29380217_2472259,CM021106.1,7,29380217,586736541,7325470,2472259,589208800,583392020
29380217_2472339,CM021106.1,7,29380217,586736541,7325470,2472339,589208880,583392100
29382294_2505623,CM021106.1,7,29382294,586736543,3160761,2505623,589242166,583425386
29380217_2649597,CM021106.1,7,29380217,586736541,7325470,2649597,589386138,583569358
29380217_3280314,CM021106.1,7,29380217,586736541,7325470,3280314,590016855,584200075
29380217_3280408,CM021106.1,7,29380217,586736541,7325470,3280408,590016949,584200169
29380217_3280410,CM021106.1,7,29380217,586736541,7325470,3280410,590016951,584200171
29380217_3517440,CM021106.1,7,29380217,586736541,7325470,3517440,590253981,584437201
29380217_3518377,CM021106.1,7,29380217,586736541,7325470,3518377,590254918,584438138
29380217_3518386,CM021106.1,7,29380217,586736541,7325470,3518386,590254927,584438147
29380217_3607297,CM021106.1,7,29380217,586736541,7325470,3607297,590343838,584527058
29380217_3609026,CM021106.1,7,29380217,586736541,7325470,3609026,590345567,584528787
29380217_3609029,CM021106.1,7,29380217,586736541,7325470,3609029,590345570,584528790
29380217_3615349,CM021106.1,7,29380217,586736541,7325470,3615349,590351890,584535110
29380217_3615623,CM021106.1,7,29380217,586736541,7325470,3615623,590352164,584535384
29380217_3615684,CM021106.1,7,29380217,586736541,7325470,3615684,590352225,584535445
29380217_5220773,CM021106.1,7,29380217,586736541,7325470,5220773,591957314,586140534
29380217_5244129,CM021106.1,7,29380217,586736541,7325470,5244129,591980670,586163890
29380217_5244131,CM021106.1,7,29380217,586736541,7325470,5244131,591980672,586163892
29380217_5294291,CM021106.1,7,29380217,586736541,7325470,5294291,592030832,586214052
29380217_5294300,CM021106.1,7,29380217,586736541,7325470,5294300,592030841,586214061
29380217_5294318,CM021106.1,7,29380217,586736541,7325470,5294318,592030859,586214079
29380217_6712587,CM021106.1,7,29380217,586736541,7325470,6712587,593449128,587632348
29380217_6983694,CM021106.1,7,29380217,586736541,7325470,6983694,593720235,587903455
29380217_6983716,CM021106.1,7,29380217,586736541,7325470,6983716,593720257,587903477
29380217_6983767,CM021106.1,7,29380217,586736541,7325470,6983767,593720308,587903528
29380217_6983773,CM021106.1,7,29380217,586736541,7325470,6983773,593720314,587903534
29380217_6983904,CM021106.1,7,29380217,586736541,7325470,6983904,593720445,587903665
29380217_7010236,CM021106.1,7,29380217,586736541,7325470,7010236,593746777,587929997
29380217_7010323,CM021106.1,7,29380217,586736541,7325470,7010323,593746864,587930084
29380217_7216346,CM021106.1,7,29380217,586736541,7325470,7216346,593952887,588136107
29377309_127887,CM021106.1,7,29377309,614954096,843314,127887,615081983,609265203
29377309_277147,CM021106.1,7,29377309,614954096,843314,277147,615231243,609414463
29379772_277926,CM021106.1,7,29379772,614954092,2661628,277926,615232018,609415238
29379772_277993,CM021106.1,7,29379772,614954092,2661628,277993,615232085,609415305
29377309_382906,CM021106.1,7,29377309,614954096,843314,382906,615337002,609520222
29377309_382949,CM021106.1,7,29377309,614954096,843314,382949,615337045,609520265
29377309_383275,CM021106.1,7,29377309,614954096,843314,383275,615337371,609520591
29381212_402710,CM021106.1,7,29381212,614954095,1335967,402710,615356805,609540025
29381212_402721,CM021106.1,7,29381212,614954095,1335967,402721,615356816,609540036
29381212_402724,CM021106.1,7,29381212,614954095,1335967,402724,615356819,609540039
29381212_402731,CM021106.1,7,29381212,614954095,1335967,402731,615356826,609540046
29381212_402732,CM021106.1,7,29381212,614954095,1335967,402732,615356827,609540047
29381212_402737,CM021106.1,7,29381212,614954095,1335967,402737,615356832,609540052
29381212_402744,CM021106.1,7,29381212,614954095,1335967,402744,615356839,609540059
29381212_402748,CM021106.1,7,29381212,614954095,1335967,402748,615356843,609540063
29381212_402753,CM021106.1,7,29381212,614954095,1335967,402753,615356848,609540068
29381212_458389,CM021106.1,7,29381212,614954095,1335967,458389,615412484,609595704
29381212_458448,CM021106.1,7,29381212,614954095,1335967,458448,615412543,609595763
29381212_458504,CM021106.1,7,29381212,614954095,1335967,458504,615412599,609595819
29382415_470058,CM021106.1,7,29382415,614954086,2470896,470058,615424144,609607364
29380523_476650,CM021106.1,7,29380523,614954095,5134109,476650,615430745,609613965
29380523_476658,CM021106.1,7,29380523,614954095,5134109,476658,615430753,609613973
29381212_502921,CM021106.1,7,29381212,614954095,1335967,502921,615457016,609640236
29382415_509699,CM021106.1,7,29382415,614954086,2470896,509699,615463785,609647005
29382415_509740,CM021106.1,7,29382415,614954086,2470896,509740,615463826,609647046
29381212_528274,CM021106.1,7,29381212,614954095,1335967,528274,615482369,609665589
29381212_528306,CM021106.1,7,29381212,614954095,1335967,528306,615482401,609665621
29381212_528330,CM021106.1,7,29381212,614954095,1335967,528330,615482425,609665645
29381212_528409,CM021106.1,7,29381212,614954095,1335967,528409,615482504,609665724
29377309_556748,CM021106.1,7,29377309,614954096,843314,556748,615510844,609694064
29377309_558177,CM021106.1,7,29377309,614954096,843314,558177,615512273,609695493
29377309_594056,CM021106.1,7,29377309,614954096,843314,594056,615548152,609731372
29377309_594083,CM021106.1,7,29377309,614954096,843314,594083,615548179,609731399
29377309_618588,CM021106.1,7,29377309,614954096,843314,618588,615572684,609755904
29377309_618675,CM021106.1,7,29377309,614954096,843314,618675,615572771,609755991
29381212_620225,CM021106.1,7,29381212,614954095,1335967,620225,615574320,609757540
29381212_620330,CM021106.1,7,29381212,614954095,1335967,620330,615574425,609757645
29381212_633074,CM021106.1,7,29381212,614954095,1335967,633074,615587169,609770389
29381212_633078,CM021106.1,7,29381212,614954095,1335967,633078,615587173,609770393
29380523_748836,CM021106.1,7,29380523,614954095,5134109,748836,615702931,609886151
29377679_792671,CM021106.1,7,29377679,614954097,1496080,792671,615746768,609929988
29377679_792696,CM021106.1,7,29377679,614954097,1496080,792696,615746793,609930013
29380523_1006253,CM021106.1,7,29380523,614954095,5134109,1006253,615960348,610143568
29380523_1006354,CM021106.1,7,29380523,614954095,5134109,1006354,615960449,610143669
29377583_1285669,CM021106.1,7,29377583,614954097,3168520,1285669,616239766,610422986
29377583_1287464,CM021106.1,7,29377583,614954097,3168520,1287464,616241561,610424781
29377583_1287494,CM021106.1,7,29377583,614954097,3168520,1287494,616241591,610424811
29377583_1303119,CM021106.1,7,29377583,614954097,3168520,1303119,616257216,610440436
29377583_1303181,CM021106.1,7,29377583,614954097,3168520,1303181,616257278,610440498
29377583_1303192,CM021106.1,7,29377583,614954097,3168520,1303192,616257289,610440509
29377583_1303193,CM021106.1,7,29377583,614954097,3168520,1303193,616257290,610440510
29382028_1299578,CM021106.1,7,29382028,614965730,2360459,1299578,616265308,610448528
29377583_1352114,CM021106.1,7,29377583,614954097,3168520,1352114,616306211,610489431
29377583_1352122,CM021106.1,7,29377583,614954097,3168520,1352122,616306219,610489439
29377583_1352172,CM021106.1,7,29377583,614954097,3168520,1352172,616306269,610489489
29382028_1749678,CM021106.1,7,29382028,614965730,2360459,1749678,616715408,610898628
29382028_1854309,CM021106.1,7,29382028,614965730,2360459,1854309,616820039,611003259
29382028_1854333,CM021106.1,7,29382028,614965730,2360459,1854333,616820063,611003283
29382028_1854405,CM021106.1,7,29382028,614965730,2360459,1854405,616820135,611003355
29382028_1854451,CM021106.1,7,29382028,614965730,2360459,1854451,616820181,611003401
29377583_2096336,CM021106.1,7,29377583,614954097,3168520,2096336,617050433,611233653
29377583_2096364,CM021106.1,7,29377583,614954097,3168520,2096364,617050461,611233681
29377583_2096366,CM021106.1,7,29377583,614954097,3168520,2096366,617050463,611233683
29377583_2096489,CM021106.1,7,29377583,614954097,3168520,2096489,617050586,611233806
29377603_2107774,CM021106.1,7,29377603,614965213,2520148,2107774,617072987,611256207
29378472_2224321,CM021106.1,7,29378472,614966485,4674920,2224321,617190806,611374026
29378472_2224341,CM021106.1,7,29378472,614966485,4674920,2224341,617190826,611374046
29378472_2224402,CM021106.1,7,29378472,614966485,4674920,2224402,617190887,611374107
29378472_2224432,CM021106.1,7,29378472,614966485,4674920,2224432,617190917,611374137
29378472_2224702,CM021106.1,7,29378472,614966485,4674920,2224702,617191187,611374407
29382028_2286465,CM021106.1,7,29382028,614965730,2360459,2286465,617252195,611435415
29378472_2614711,CM021106.1,7,29378472,614966485,4674920,2614711,617581196,611764416
29381584_2744794,CM021106.1,7,29381584,614965386,8305142,2744794,617710180,611893400
29378472_2790661,CM021106.1,7,29378472,614966485,4674920,2790661,617757146,611940366
29378472_2906956,CM021106.1,7,29378472,614966485,4674920,2906956,617873441,612056661
29380523_3011434,CM021106.1,7,29380523,614954095,5134109,3011434,617965529,612148749
29377382_3035091,CM021106.1,7,29377382,614954095,4728113,3035091,617989186,612172406
29377382_3035124,CM021106.1,7,29377382,614954095,4728113,3035124,617989219,612172439
29377382_3035131,CM021106.1,7,29377382,614954095,4728113,3035131,617989226,612172446
29377382_3035207,CM021106.1,7,29377382,614954095,4728113,3035207,617989302,612172522
29377583_3085944,CM021106.1,7,29377583,614954097,3168520,3085944,618040041,612223261
29377583_3086074,CM021106.1,7,29377583,614954097,3168520,3086074,618040171,612223391
29377382_3104516,CM021106.1,7,29377382,614954095,4728113,3104516,618058611,612241831
29377382_3104534,CM021106.1,7,29377382,614954095,4728113,3104534,618058629,612241849
29377382_3104583,CM021106.1,7,29377382,614954095,4728113,3104583,618058678,612241898
29377382_3104645,CM021106.1,7,29377382,614954095,4728113,3104645,618058740,612241960
29377583_3116802,CM021106.1,7,29377583,614954097,3168520,3116802,618070899,612254119
29377583_3118210,CM021106.1,7,29377583,614954097,3168520,3118210,618072307,612255527
29377583_3119059,CM021106.1,7,29377583,614954097,3168520,3119059,618073156,612256376
29377583_3119098,CM021106.1,7,29377583,614954097,3168520,3119098,618073195,612256415
29378472_3107117,CM021106.1,7,29378472,614966485,4674920,3107117,618073602,612256822
29381869_3133445,CM021106.1,7,29381869,614965485,3776916,3133445,618098930,612282150
29381869_3133553,CM021106.1,7,29381869,614965485,3776916,3133553,618099038,612282258
29381869_3133562,CM021106.1,7,29381869,614965485,3776916,3133562,618099047,612282267
29378472_3491885,CM021106.1,7,29378472,614966485,4674920,3491885,618458370,612641590
29377382_3823470,CM021106.1,7,29377382,614954095,4728113,3823470,618777565,612960785
29377382_3823522,CM021106.1,7,29377382,614954095,4728113,3823522,618777617,612960837
29377382_3823572,CM021106.1,7,29377382,614954095,4728113,3823572,618777667,612960887
29377382_3823620,CM021106.1,7,29377382,614954095,4728113,3823620,618777715,612960935
29377382_3823647,CM021106.1,7,29377382,614954095,4728113,3823647,618777742,612960962
29377382_3919987,CM021106.1,7,29377382,614954095,4728113,3919987,618874082,613057302
29377382_3920051,CM021106.1,7,29377382,614954095,4728113,3920051,618874146,613057366
29377382_3920069,CM021106.1,7,29377382,614954095,4728113,3920069,618874164,613057384
29377382_3920186,CM021106.1,7,29377382,614954095,4728113,3920186,618874281,613057501
29377382_3920236,CM021106.1,7,29377382,614954095,4728113,3920236,618874331,613057551
29380523_4316566,CM021106.1,7,29380523,614954095,5134109,4316566,619270661,613453881
29377382_4501069,CM021106.1,7,29377382,614954095,4728113,4501069,619455164,613638384
29377382_4501315,CM021106.1,7,29377382,614954095,4728113,4501315,619455410,613638630
29380523_4927961,CM021106.1,7,29380523,614954095,5134109,4927961,619882056,614065276
29380523_4927980,CM021106.1,7,29380523,614954095,5134109,4927980,619882075,614065295
29380523_4927993,CM021106.1,7,29380523,614954095,5134109,4927993,619882088,614065308
29380523_4928075,CM021106.1,7,29380523,614954095,5134109,4928075,619882170,614065390
29381584_6657818,CM021106.1,7,29381584,614965386,8305142,6657818,621623204,615806424
29381584_6906917,CM021106.1,7,29381584,614965386,8305142,6906917,621872303,616055523
29381584_6973304,CM021106.1,7,29381584,614965386,8305142,6973304,621938690,616121910
29380180_178722,CM021106.1,7,29380180,628556484,179235,178722,628735206,622918426
29380180_178728,CM021106.1,7,29380180,628556484,179235,178728,628735212,622918432
29380180_178779,CM021106.1,7,29380180,628556484,179235,178779,628735263,622918483
29346338_238957,CM021106.1,7,29346338,633808971,343072,238957,634047928,628231148
29346338_238991,CM021106.1,7,29346338,633808971,343072,238991,634047962,628231182
29346338_238996,CM021106.1,7,29346338,633808971,343072,238996,634047967,628231187
29346338_239052,CM021106.1,7,29346338,633808971,343072,239052,634048023,628231243
29346338_292470,CM021106.1,7,29346338,633808971,343072,292470,634101441,628284661
29346338_292478,CM021106.1,7,29346338,633808971,343072,292478,634101449,628284669
29346338_292568,CM021106.1,7,29346338,633808971,343072,292568,634101539,628284759
29346338_292595,CM021106.1,7,29346338,633808971,343072,292595,634101566,628284786
29346338_292596,CM021106.1,7,29346338,633808971,343072,292596,634101567,628284787
29378000_292427,CM021106.1,7,29378000,633809301,681196,292427,634101728,628284948
29380383_303488,CM021106.1,7,29380383,633808972,1173753,303488,634112460,628295680
29380383_303501,CM021106.1,7,29380383,633808972,1173753,303501,634112473,628295693
29377694_386713,CM021106.1,7,29377694,633808975,389329,386713,634195688,628378908
29377694_386772,CM021106.1,7,29377694,633808975,389329,386772,634195747,628378967
29377694_386788,CM021106.1,7,29377694,633808975,389329,386788,634195763,628378983
29380383_602091,CM021106.1,7,29380383,633808972,1173753,602091,634411063,628594283
29378790_844970,CM021106.1,7,29378790,633808970,2760815,844970,634653940,628837160
29380383_1059658,CM021106.1,7,29380383,633808972,1173753,1059658,634868630,629051850
29381340_25549,CM021106.1,7,29381340,645704782,595604,25549,645730331,639913551
29381678_46083,CM021106.1,7,29381678,645703634,658201,46083,645749717,639932937
29381678_46096,CM021106.1,7,29381678,645703634,658201,46096,645749730,639932950
29381678_48170,CM021106.1,7,29381678,645703634,658201,48170,645751804,639935024
29381678_48263,CM021106.1,7,29381678,645703634,658201,48263,645751897,639935117
29381678_49391,CM021106.1,7,29381678,645703634,658201,49391,645753025,639936245
29378929_74218,CM021106.1,7,29378929,645696723,2469244,74218,645770941,639954161
29378929_74238,CM021106.1,7,29378929,645696723,2469244,74238,645770961,639954181
29379180_77177,CM021106.1,7,29379180,645697323,1033632,77177,645774500,639957720
29381178_72910,CM021106.1,7,29381178,645702704,73715,72910,645775614,639958834
29378929_227857,CM021106.1,7,29378929,645696723,2469244,227857,645924580,640107800
29380268_348692,CM021106.1,7,29380268,645704473,1441863,348692,646053165,640236385
29380850_416180,CM021106.1,7,29380850,645705661,738074,416180,646121841,640305061
29380293_435235,CM021106.1,7,29380293,645705930,831009,435235,646141165,640324385
29380293_435258,CM021106.1,7,29380293,645705930,831009,435258,646141188,640324408
29380293_450569,CM021106.1,7,29380293,645705930,831009,450569,646156499,640339719
29380293_450595,CM021106.1,7,29380293,645705930,831009,450595,646156525,640339745
29378174_495306,CM021106.1,7,29378174,645702602,5463768,495306,646197908,640381128
29378174_495309,CM021106.1,7,29378174,645702602,5463768,495309,646197911,640381131
29378174_495369,CM021106.1,7,29378174,645702602,5463768,495369,646197971,640381191
29378174_496076,CM021106.1,7,29378174,645702602,5463768,496076,646198678,640381898
29378174_496097,CM021106.1,7,29378174,645702602,5463768,496097,646198699,640381919
29377508_594224,CM021106.1,7,29377508,645703370,3629839,594224,646297594,640480814
29377508_594266,CM021106.1,7,29377508,645703370,3629839,594266,646297636,640480856
29377508_594272,CM021106.1,7,29377508,645703370,3629839,594272,646297642,640480862
29377508_594315,CM021106.1,7,29377508,645703370,3629839,594315,646297685,640480905
29377508_604340,CM021106.1,7,29377508,645703370,3629839,604340,646307710,640490930
29377508_604354,CM021106.1,7,29377508,645703370,3629839,604354,646307724,640490944
29378174_617663,CM021106.1,7,29378174,645702602,5463768,617663,646320265,640503485
29377508_625676,CM021106.1,7,29377508,645703370,3629839,625676,646329046,640512266
29377508_625725,CM021106.1,7,29377508,645703370,3629839,625725,646329095,640512315
29377508_625766,CM021106.1,7,29377508,645703370,3629839,625766,646329136,640512356
29378174_643418,CM021106.1,7,29378174,645702602,5463768,643418,646346020,640529240
29378174_643420,CM021106.1,7,29378174,645702602,5463768,643420,646346022,640529242
29378174_645616,CM021106.1,7,29378174,645702602,5463768,645616,646348218,640531438
29378174_645677,CM021106.1,7,29378174,645702602,5463768,645677,646348279,640531499
29378174_645720,CM021106.1,7,29378174,645702602,5463768,645720,646348322,640531542
29378174_645722,CM021106.1,7,29378174,645702602,5463768,645722,646348324,640531544
29378174_645777,CM021106.1,7,29378174,645702602,5463768,645777,646348379,640531599
29378174_645873,CM021106.1,7,29378174,645702602,5463768,645873,646348475,640531695
29378174_645891,CM021106.1,7,29378174,645702602,5463768,645891,646348493,640531713
29379681_676173,CM021106.1,7,29379681,645696726,4855777,676173,646372899,640556119
29379681_676249,CM021106.1,7,29379681,645696726,4855777,676249,646372975,640556195
29379681_708329,CM021106.1,7,29379681,645696726,4855777,708329,646405055,640588275
29378174_707660,CM021106.1,7,29378174,645702602,5463768,707660,646410262,640593482
29379169_725486,CM021106.1,7,29379169,645702468,2360197,725486,646427954,640611174
29378174_735000,CM021106.1,7,29378174,645702602,5463768,735000,646437602,640620822
29378174_735036,CM021106.1,7,29378174,645702602,5463768,735036,646437638,640620858
29379681_741532,CM021106.1,7,29379681,645696726,4855777,741532,646438258,640621478
29381436_806301,CM021106.1,7,29381436,645702948,8192762,806301,646509249,640692469
29378174_825113,CM021106.1,7,29378174,645702602,5463768,825113,646527715,640710935
29377428_856154,CM021106.1,7,29377428,645704146,1941695,856154,646560300,640743520
29377428_856269,CM021106.1,7,29377428,645704146,1941695,856269,646560415,640743635
29377428_856270,CM021106.1,7,29377428,645704146,1941695,856270,646560416,640743636
29377428_856303,CM021106.1,7,29377428,645704146,1941695,856303,646560449,640743669
29377428_856333,CM021106.1,7,29377428,645704146,1941695,856333,646560479,640743699
29381551_872703,CM021106.1,7,29381551,645698509,1500342,872703,646571212,640754432
29381551_874370,CM021106.1,7,29381551,645698509,1500342,874370,646572879,640756099
29381551_874480,CM021106.1,7,29381551,645698509,1500342,874480,646572989,640756209
29377051_938826,CM021106.1,7,29377051,645703580,2216149,938826,646642406,640825626
29377051_938833,CM021106.1,7,29377051,645703580,2216149,938833,646642413,640825633
29377051_938850,CM021106.1,7,29377051,645703580,2216149,938850,646642430,640825650
29377051_959749,CM021106.1,7,29377051,645703580,2216149,959749,646663329,640846549
29377051_959761,CM021106.1,7,29377051,645703580,2216149,959761,646663341,640846561
29377051_959794,CM021106.1,7,29377051,645703580,2216149,959794,646663374,640846594
29377051_959806,CM021106.1,7,29377051,645703580,2216149,959806,646663386,640846606
29377051_959810,CM021106.1,7,29377051,645703580,2216149,959810,646663390,640846610
29377051_959873,CM021106.1,7,29377051,645703580,2216149,959873,646663453,640846673
29377051_959952,CM021106.1,7,29377051,645703580,2216149,959952,646663532,640846752
29377051_959960,CM021106.1,7,29377051,645703580,2216149,959960,646663540,640846760
29377051_959971,CM021106.1,7,29377051,645703580,2216149,959971,646663551,640846771
29377051_959984,CM021106.1,7,29377051,645703580,2216149,959984,646663564,640846784
29377051_959988,CM021106.1,7,29377051,645703580,2216149,959988,646663568,640846788
29377051_959991,CM021106.1,7,29377051,645703580,2216149,959991,646663571,640846791
29377051_960010,CM021106.1,7,29377051,645703580,2216149,960010,646663590,640846810
29377051_960022,CM021106.1,7,29377051,645703580,2216149,960022,646663602,640846822
29378174_963837,CM021106.1,7,29378174,645702602,5463768,963837,646666439,640849659
29378174_963849,CM021106.1,7,29378174,645702602,5463768,963849,646666451,640849671
29378174_965404,CM021106.1,7,29378174,645702602,5463768,965404,646668006,640851226
29381551_994392,CM021106.1,7,29381551,645698509,1500342,994392,646692901,640876121
29381551_995925,CM021106.1,7,29381551,645698509,1500342,995925,646694434,640877654
29381551_996002,CM021106.1,7,29381551,645698509,1500342,996002,646694511,640877731
29378120_1153977,CM021106.1,7,29378120,645696726,3807996,1153977,646850703,641033923
29377508_1349805,CM021106.1,7,29377508,645703370,3629839,1349805,647053175,641236395
29377508_1350200,CM021106.1,7,29377508,645703370,3629839,1350200,647053570,641236790
29377508_1350412,CM021106.1,7,29377508,645703370,3629839,1350412,647053782,641237002
29377508_1355624,CM021106.1,7,29377508,645703370,3629839,1355624,647058994,641242214
29377508_1357027,CM021106.1,7,29377508,645703370,3629839,1357027,647060397,641243617
29377508_1357029,CM021106.1,7,29377508,645703370,3629839,1357029,647060399,641243619
29378438_1393563,CM021106.1,7,29378438,645702260,2752036,1393563,647095823,641279043
29378438_1393576,CM021106.1,7,29378438,645702260,2752036,1393576,647095836,641279056
29378174_1413944,CM021106.1,7,29378174,645702602,5463768,1413944,647116546,641299766
29378174_1419080,CM021106.1,7,29378174,645702602,5463768,1419080,647121682,641304902
29378174_1435824,CM021106.1,7,29378174,645702602,5463768,1435824,647138426,641321646
29378174_1435949,CM021106.1,7,29378174,645702602,5463768,1435949,647138551,641321771
29377428_1435836,CM021106.1,7,29377428,645704146,1941695,1435836,647139982,641323202
29378438_1519108,CM021106.1,7,29378438,645702260,2752036,1519108,647221368,641404588
29378174_1580169,CM021106.1,7,29378174,645702602,5463768,1580169,647282771,641465991
29378174_1580201,CM021106.1,7,29378174,645702602,5463768,1580201,647282803,641466023
29378174_1580202,CM021106.1,7,29378174,645702602,5463768,1580202,647282804,641466024
29378174_1580208,CM021106.1,7,29378174,645702602,5463768,1580208,647282810,641466030
29378174_1580253,CM021106.1,7,29378174,645702602,5463768,1580253,647282855,641466075
29378174_1580283,CM021106.1,7,29378174,645702602,5463768,1580283,647282885,641466105
29378174_1580292,CM021106.1,7,29378174,645702602,5463768,1580292,647282894,641466114
29378174_1582917,CM021106.1,7,29378174,645702602,5463768,1582917,647285519,641468739
29378174_1582928,CM021106.1,7,29378174,645702602,5463768,1582928,647285530,641468750
29378174_1582940,CM021106.1,7,29378174,645702602,5463768,1582940,647285542,641468762
29378174_1582957,CM021106.1,7,29378174,645702602,5463768,1582957,647285559,641468779
29378174_1582963,CM021106.1,7,29378174,645702602,5463768,1582963,647285565,641468785
29378174_1582980,CM021106.1,7,29378174,645702602,5463768,1582980,647285582,641468802
29378174_1583014,CM021106.1,7,29378174,645702602,5463768,1583014,647285616,641468836
29378174_1583015,CM021106.1,7,29378174,645702602,5463768,1583015,647285617,641468837
29378174_1583044,CM021106.1,7,29378174,645702602,5463768,1583044,647285646,641468866
29378174_1583062,CM021106.1,7,29378174,645702602,5463768,1583062,647285664,641468884
29378174_1583066,CM021106.1,7,29378174,645702602,5463768,1583066,647285668,641468888
29377508_1614016,CM021106.1,7,29377508,645703370,3629839,1614016,647317386,641500606
29377508_1637102,CM021106.1,7,29377508,645703370,3629839,1637102,647340472,641523692
29377051_1791556,CM021106.1,7,29377051,645703580,2216149,1791556,647495136,641678356
29378174_1832704,CM021106.1,7,29378174,645702602,5463768,1832704,647535306,641718526
29378174_1832763,CM021106.1,7,29378174,645702602,5463768,1832763,647535365,641718585
29379169_1853284,CM021106.1,7,29379169,645702468,2360197,1853284,647555752,641738972
29379169_1853857,CM021106.1,7,29379169,645702468,2360197,1853857,647556325,641739545
29378438_1867223,CM021106.1,7,29378438,645702260,2752036,1867223,647569483,641752703
29378174_1934681,CM021106.1,7,29378174,645702602,5463768,1934681,647637283,641820503
29378174_1934872,CM021106.1,7,29378174,645702602,5463768,1934872,647637474,641820694
29378174_1934873,CM021106.1,7,29378174,645702602,5463768,1934873,647637475,641820695
29378174_1934915,CM021106.1,7,29378174,645702602,5463768,1934915,647637517,641820737
29377508_1936845,CM021106.1,7,29377508,645703370,3629839,1936845,647640215,641823435
29377508_1936892,CM021106.1,7,29377508,645703370,3629839,1936892,647640262,641823482
29379681_2010435,CM021106.1,7,29379681,645696726,4855777,2010435,647707161,641890381
29379681_2010445,CM021106.1,7,29379681,645696726,4855777,2010445,647707171,641890391
29379169_2190741,CM021106.1,7,29379169,645702468,2360197,2190741,647893209,642076429
29379169_2191556,CM021106.1,7,29379169,645702468,2360197,2191556,647894024,642077244
29379681_2215386,CM021106.1,7,29379681,645696726,4855777,2215386,647912112,642095332
29379681_2215472,CM021106.1,7,29379681,645696726,4855777,2215472,647912198,642095418
29379681_2215473,CM021106.1,7,29379681,645696726,4855777,2215473,647912199,642095419
29379681_2215492,CM021106.1,7,29379681,645696726,4855777,2215492,647912218,642095438
29379681_2215534,CM021106.1,7,29379681,645696726,4855777,2215534,647912260,642095480
29379681_2215644,CM021106.1,7,29379681,645696726,4855777,2215644,647912370,642095590
29378174_2211183,CM021106.1,7,29378174,645702602,5463768,2211183,647913785,642097005
29378174_2211532,CM021106.1,7,29378174,645702602,5463768,2211532,647914134,642097354
29378174_2234625,CM021106.1,7,29378174,645702602,5463768,2234625,647937227,642120447
29379169_2358747,CM021106.1,7,29379169,645702468,2360197,2358747,648061215,642244435
29379169_2358769,CM021106.1,7,29379169,645702468,2360197,2358769,648061237,642244457
29379681_2685582,CM021106.1,7,29379681,645696726,4855777,2685582,648382308,642565528
29379681_2685613,CM021106.1,7,29379681,645696726,4855777,2685613,648382339,642565559
29379681_2685634,CM021106.1,7,29379681,645696726,4855777,2685634,648382360,642565580
29378174_2701025,CM021106.1,7,29378174,645702602,5463768,2701025,648403627,642586847
29378174_2701056,CM021106.1,7,29378174,645702602,5463768,2701056,648403658,642586878
29378174_2701234,CM021106.1,7,29378174,645702602,5463768,2701234,648403836,642587056
29378174_2720767,CM021106.1,7,29378174,645702602,5463768,2720767,648423369,642606589
29378174_2720806,CM021106.1,7,29378174,645702602,5463768,2720806,648423408,642606628
29378174_2720877,CM021106.1,7,29378174,645702602,5463768,2720877,648423479,642606699
29378174_2721543,CM021106.1,7,29378174,645702602,5463768,2721543,648424145,642607365
29378174_2731189,CM021106.1,7,29378174,645702602,5463768,2731189,648433791,642617011
29378174_2731227,CM021106.1,7,29378174,645702602,5463768,2731227,648433829,642617049
29378174_2826265,CM021106.1,7,29378174,645702602,5463768,2826265,648528867,642712087
29378174_3104056,CM021106.1,7,29378174,645702602,5463768,3104056,648806658,642989878
29378174_3104186,CM021106.1,7,29378174,645702602,5463768,3104186,648806788,642990008
29378174_3104270,CM021106.1,7,29378174,645702602,5463768,3104270,648806872,642990092
29378174_3104296,CM021106.1,7,29378174,645702602,5463768,3104296,648806898,642990118
29378174_3104336,CM021106.1,7,29378174,645702602,5463768,3104336,648806938,642990158
29377508_3210823,CM021106.1,7,29377508,645703370,3629839,3210823,648914193,643097413
29377508_3210841,CM021106.1,7,29377508,645703370,3629839,3210841,648914211,643097431
29377508_3210884,CM021106.1,7,29377508,645703370,3629839,3210884,648914254,643097474
29379681_3501842,CM021106.1,7,29379681,645696726,4855777,3501842,649198568,643381788
29378120_3594411,CM021106.1,7,29378120,645696726,3807996,3594411,649291137,643474357
29379681_4149639,CM021106.1,7,29379681,645696726,4855777,4149639,649846365,644029585
29381436_4280169,CM021106.1,7,29381436,645702948,8192762,4280169,649983117,644166337
29379681_4546291,CM021106.1,7,29379681,645696726,4855777,4546291,650243017,644426237
29378174_5316242,CM021106.1,7,29378174,645702602,5463768,5316242,651018844,645202064
29344301_1909,CM021106.1,7,29344301,656881256,5281,1909,656883165,651066385
29344301_1914,CM021106.1,7,29344301,656881256,5281,1914,656883170,651066390
29344301_1918,CM021106.1,7,29344301,656881256,5281,1918,656883174,651066394
29344301_1933,CM021106.1,7,29344301,656881256,5281,1933,656883189,651066409
29344301_1937,CM021106.1,7,29344301,656881256,5281,1937,656883193,651066413
29344301_1938,CM021106.1,7,29344301,656881256,5281,1938,656883194,651066414
29344301_1949,CM021106.1,7,29344301,656881256,5281,1949,656883205,651066425
29344301_1965,CM021106.1,7,29344301,656881256,5281,1965,656883221,651066441
29344301_1985,CM021106.1,7,29344301,656881256,5281,1985,656883241,651066461
29341790_61536,CM021107.1,8,29341790,14488330,243595,61536,14549866,9539249
29341790_61582,CM021107.1,8,29341790,14488330,243595,61582,14549912,9539295
29377981_48824,CM021107.1,8,29377981,27822562,2099978,48824,27871386,22860769
29378570_79194,CM021107.1,8,29378570,27822562,993559,79194,27901756,22891139
29378570_79213,CM021107.1,8,29378570,27822562,993559,79213,27901775,22891158
29378570_79260,CM021107.1,8,29378570,27822562,993559,79260,27901822,22891205
29377365_119693,CM021107.1,8,29377365,27822562,1902301,119693,27942255,22931638
29377365_119784,CM021107.1,8,29377365,27822562,1902301,119784,27942346,22931729
29377365_119821,CM021107.1,8,29377365,27822562,1902301,119821,27942383,22931766
29378570_176691,CM021107.1,8,29378570,27822562,993559,176691,27999253,22988636
29378570_176740,CM021107.1,8,29378570,27822562,993559,176740,27999302,22988685
29378570_176786,CM021107.1,8,29378570,27822562,993559,176786,27999348,22988731
29378570_176804,CM021107.1,8,29378570,27822562,993559,176804,27999366,22988749
29377981_208993,CM021107.1,8,29377981,27822562,2099978,208993,28031555,23020938
29377981_257686,CM021107.1,8,29377981,27822562,2099978,257686,28080248,23069631
29377981_257689,CM021107.1,8,29377981,27822562,2099978,257689,28080251,23069634
29377981_257729,CM021107.1,8,29377981,27822562,2099978,257729,28080291,23069674
29377981_257764,CM021107.1,8,29377981,27822562,2099978,257764,28080326,23069709
29377981_257824,CM021107.1,8,29377981,27822562,2099978,257824,28080386,23069769
29377365_345556,CM021107.1,8,29377365,27822562,1902301,345556,28168118,23157501
29378570_345900,CM021107.1,8,29378570,27822562,993559,345900,28168462,23157845
29378570_346101,CM021107.1,8,29378570,27822562,993559,346101,28168663,23158046
29377365_354352,CM021107.1,8,29377365,27822562,1902301,354352,28176914,23166297
29377365_354378,CM021107.1,8,29377365,27822562,1902301,354378,28176940,23166323
29378570_597031,CM021107.1,8,29378570,27822562,993559,597031,28419593,23408976
29378570_597055,CM021107.1,8,29378570,27822562,993559,597055,28419617,23409000
29378570_597088,CM021107.1,8,29378570,27822562,993559,597088,28419650,23409033
29377981_933306,CM021107.1,8,29377981,27822562,2099978,933306,28755868,23745251
29377981_987226,CM021107.1,8,29377981,27822562,2099978,987226,28809788,23799171
29377981_1148053,CM021107.1,8,29377981,27822562,2099978,1148053,28970615,23959998
29377981_1372971,CM021107.1,8,29377981,27822562,2099978,1372971,29195533,24184916
29377981_1676477,CM021107.1,8,29377981,27822562,2099978,1676477,29499039,24488422
29377981_1676516,CM021107.1,8,29377981,27822562,2099978,1676516,29499078,24488461
29377981_1775690,CM021107.1,8,29377981,27822562,2099978,1775690,29598252,24587635
29359213_4398,CM021107.1,8,29359213,38579678,15845,4398,38584076,33573459
29359213_4441,CM021107.1,8,29359213,38579678,15845,4441,38584119,33573502
29359213_4447,CM021107.1,8,29359213,38579678,15845,4447,38584125,33573508
29359213_4458,CM021107.1,8,29359213,38579678,15845,4458,38584136,33573519
29359213_4684,CM021107.1,8,29359213,38579678,15845,4684,38584362,33573745
29359213_4736,CM021107.1,8,29359213,38579678,15845,4736,38584414,33573797
29380186_353573,CM021107.1,8,29380186,38575688,389001,353573,38929261,33918644
29380186_353626,CM021107.1,8,29380186,38575688,389001,353626,38929314,33918697
29377352_16726,CM021107.1,8,29377352,50161157,1035241,16726,50177883,45167266
29377352_16729,CM021107.1,8,29377352,50161157,1035241,16729,50177886,45167269
29377352_16756,CM021107.1,8,29377352,50161157,1035241,16756,50177913,45167296
29377352_18350,CM021107.1,8,29377352,50161157,1035241,18350,50179507,45168890
29377352_24575,CM021107.1,8,29377352,50161157,1035241,24575,50185732,45175115
29377352_40952,CM021107.1,8,29377352,50161157,1035241,40952,50202109,45191492
29382035_301580,CM021107.1,8,29382035,50160341,2054134,301580,50461921,45451304
29382035_526349,CM021107.1,8,29382035,50160341,2054134,526349,50686690,45676073
29382035_526387,CM021107.1,8,29382035,50160341,2054134,526387,50686728,45676111
29382035_526393,CM021107.1,8,29382035,50160341,2054134,526393,50686734,45676117
29382035_526396,CM021107.1,8,29382035,50160341,2054134,526396,50686737,45676120
29382035_526402,CM021107.1,8,29382035,50160341,2054134,526402,50686743,45676126
29382035_526420,CM021107.1,8,29382035,50160341,2054134,526420,50686761,45676144
29382035_526426,CM021107.1,8,29382035,50160341,2054134,526426,50686767,45676150
29382035_526432,CM021107.1,8,29382035,50160341,2054134,526432,50686773,45676156
29378866_878411,CM021107.1,8,29378866,50160341,1008124,878411,51038752,46028135
29378866_879885,CM021107.1,8,29378866,50160341,1008124,879885,51040226,46029609
29378866_881388,CM021107.1,8,29378866,50160341,1008124,881388,51041729,46031112
29378866_881393,CM021107.1,8,29378866,50160341,1008124,881393,51041734,46031117
29378866_881404,CM021107.1,8,29378866,50160341,1008124,881404,51041745,46031128
29378866_881432,CM021107.1,8,29378866,50160341,1008124,881432,51041773,46031156
29378866_881494,CM021107.1,8,29378866,50160341,1008124,881494,51041835,46031218
29378866_881502,CM021107.1,8,29378866,50160341,1008124,881502,51041843,46031226
29378866_881523,CM021107.1,8,29378866,50160341,1008124,881523,51041864,46031247
29378866_881529,CM021107.1,8,29378866,50160341,1008124,881529,51041870,46031253
29378866_881540,CM021107.1,8,29378866,50160341,1008124,881540,51041881,46031264
29378866_881541,CM021107.1,8,29378866,50160341,1008124,881541,51041882,46031265
29378866_881558,CM021107.1,8,29378866,50160341,1008124,881558,51041899,46031282
29378866_881598,CM021107.1,8,29378866,50160341,1008124,881598,51041939,46031322
29378866_881615,CM021107.1,8,29378866,50160341,1008124,881615,51041956,46031339
29378866_881648,CM021107.1,8,29378866,50160341,1008124,881648,51041989,46031372
29378866_881654,CM021107.1,8,29378866,50160341,1008124,881654,51041995,46031378
29378866_881663,CM021107.1,8,29378866,50160341,1008124,881663,51042004,46031387
29382035_1483065,CM021107.1,8,29382035,50160341,2054134,1483065,51643406,46632789
29378242_1529811,CM021107.1,8,29378242,50160343,3914229,1529811,51690154,46679537
29378785_1567846,CM021107.1,8,29378785,50160340,2565183,1567846,51728186,46717569
29378785_1567984,CM021107.1,8,29378785,50160340,2565183,1567984,51728324,46717707
29378785_1568103,CM021107.1,8,29378785,50160340,2565183,1568103,51728443,46717826
29378242_1908546,CM021107.1,8,29378242,50160343,3914229,1908546,52068889,47058272
29378242_1995142,CM021107.1,8,29378242,50160343,3914229,1995142,52155485,47144868
29378242_2179607,CM021107.1,8,29378242,50160343,3914229,2179607,52339950,47329333
29382045_3609111,CM021107.1,8,29382045,50161025,4872396,3609111,53770136,48759519
29382045_3651544,CM021107.1,8,29382045,50161025,4872396,3651544,53812569,48801952
29382045_3653269,CM021107.1,8,29382045,50161025,4872396,3653269,53814294,48803677
29377132_5127865,CM021107.1,8,29377132,50160340,7536815,5127865,55288205,50277588
29377132_5127960,CM021107.1,8,29377132,50160340,7536815,5127960,55288300,50277683
29377132_5127979,CM021107.1,8,29377132,50160340,7536815,5127979,55288319,50277702
29377132_5128033,CM021107.1,8,29377132,50160340,7536815,5128033,55288373,50277756
29377132_6595377,CM021107.1,8,29377132,50160340,7536815,6595377,56755717,51745100
29377132_6974300,CM021107.1,8,29377132,50160340,7536815,6974300,57134640,52124023
29377132_6978323,CM021107.1,8,29377132,50160340,7536815,6978323,57138663,52128046
29377132_6978376,CM021107.1,8,29377132,50160340,7536815,6978376,57138716,52128099
29377132_6980567,CM021107.1,8,29377132,50160340,7536815,6980567,57140907,52130290
29377132_7153512,CM021107.1,8,29377132,50160340,7536815,7153512,57313852,52303235
29377132_7153605,CM021107.1,8,29377132,50160340,7536815,7153605,57313945,52303328
29377132_7424688,CM021107.1,8,29377132,50160340,7536815,7424688,57585028,52574411
29377132_7452845,CM021107.1,8,29377132,50160340,7536815,7452845,57613185,52602568
29379327_104293,CM021107.1,8,29379327,62841864,175932,104293,62946157,57935540
29379337_598890,CM021107.1,8,29379337,62840922,4257242,598890,63439812,58429195
29382080_1156901,CM021107.1,8,29382080,62840202,3231347,1156901,63997103,58986486
29382080_1159172,CM021107.1,8,29382080,62840202,3231347,1159172,63999374,58988757
29382080_1159180,CM021107.1,8,29382080,62840202,3231347,1159180,63999382,58988765
29382080_1300146,CM021107.1,8,29382080,62840202,3231347,1300146,64140348,59129731
29382080_1300151,CM021107.1,8,29382080,62840202,3231347,1300151,64140353,59129736
29382080_1300215,CM021107.1,8,29382080,62840202,3231347,1300215,64140417,59129800
29382080_1474510,CM021107.1,8,29382080,62840202,3231347,1474510,64314712,59304095
29382080_1499491,CM021107.1,8,29382080,62840202,3231347,1499491,64339693,59329076
29382080_2685537,CM021107.1,8,29382080,62840202,3231347,2685537,65525739,60515122
29382080_2685560,CM021107.1,8,29382080,62840202,3231347,2685560,65525762,60515145
29382080_2685780,CM021107.1,8,29382080,62840202,3231347,2685780,65525982,60515365
29382080_2685793,CM021107.1,8,29382080,62840202,3231347,2685793,65525995,60515378
29379337_3177822,CM021107.1,8,29379337,62840922,4257242,3177822,66018744,61008127
29379337_3205768,CM021107.1,8,29379337,62840922,4257242,3205768,66046690,61036073
29379337_3939505,CM021107.1,8,29379337,62840922,4257242,3939505,66780427,61769810
29379337_3939905,CM021107.1,8,29379337,62840922,4257242,3939905,66780827,61770210
29379337_4212130,CM021107.1,8,29379337,62840922,4257242,4212130,67053052,62042435
29379337_4212242,CM021107.1,8,29379337,62840922,4257242,4212242,67053164,62042547
29379337_4212304,CM021107.1,8,29379337,62840922,4257242,4212304,67053226,62042609
29379337_4214595,CM021107.1,8,29379337,62840922,4257242,4214595,67055517,62044900
29379337_4214596,CM021107.1,8,29379337,62840922,4257242,4214596,67055518,62044901
29379337_4217315,CM021107.1,8,29379337,62840922,4257242,4217315,67058237,62047620
29379337_4217347,CM021107.1,8,29379337,62840922,4257242,4217347,67058269,62047652
29381363_143709,CM021107.1,8,29381363,67913064,372060,143709,68056773,63046156
29381363_143728,CM021107.1,8,29381363,67913064,372060,143728,68056792,63046175
29381363_143740,CM021107.1,8,29381363,67913064,372060,143740,68056804,63046187
29381363_143784,CM021107.1,8,29381363,67913064,372060,143784,68056848,63046231
29381059_77745,CM021107.1,8,29381059,72002966,231959,77745,72080711,67070094
29381059_77763,CM021107.1,8,29381059,72002966,231959,77763,72080729,67070112
29381059_127350,CM021107.1,8,29381059,72002966,231959,127350,72130316,67119699
29381059_127453,CM021107.1,8,29381059,72002966,231959,127453,72130419,67119802
29381059_127497,CM021107.1,8,29381059,72002966,231959,127497,72130463,67119846
1558924_1376,CM021107.1,8,1558924,81775512,7032,1376,81776888,76766271
29380921_5649,CM021107.1,8,29380921,81778510,421496,5649,81784159,76773542
29380921_10324,CM021107.1,8,29380921,81778510,421496,10324,81788834,76778217
29380921_10413,CM021107.1,8,29380921,81778510,421496,10413,81788923,76778306
29378652_294312,CM021107.1,8,29378652,82516802,1352745,294312,82811114,77800497
29378652_294315,CM021107.1,8,29378652,82516802,1352745,294315,82811117,77800500
29378652_529516,CM021107.1,8,29378652,82516802,1352745,529516,83046318,78035701
29378652_529517,CM021107.1,8,29378652,82516802,1352745,529517,83046319,78035702
29378652_856116,CM021107.1,8,29378652,82516802,1352745,856116,83372918,78362301
29376999_956736,CM021107.1,8,29376999,82516803,2539685,956736,83473539,78462922
29379072_1184627,CM021107.1,8,29379072,82516803,11094954,1184627,83701430,78690813
29379072_2628868,CM021107.1,8,29379072,82516803,11094954,2628868,85145671,80135054
29379072_5346771,CM021107.1,8,29379072,82516803,11094954,5346771,87863574,82852957
29379072_5346772,CM021107.1,8,29379072,82516803,11094954,5346772,87863575,82852958
29379072_6382629,CM021107.1,8,29379072,82516803,11094954,6382629,88899432,83888815
29379072_8212699,CM021107.1,8,29379072,82516803,11094954,8212699,90729502,85718885
29379072_8212700,CM021107.1,8,29379072,82516803,11094954,8212700,90729503,85718886
29379072_8212828,CM021107.1,8,29379072,82516803,11094954,8212828,90729631,85719014
29379072_8364698,CM021107.1,8,29379072,82516803,11094954,8364698,90881501,85870884
29379072_8364997,CM021107.1,8,29379072,82516803,11094954,8364997,90881800,85871183
29379072_10794672,CM021107.1,8,29379072,82516803,11094954,10794672,93311475,88300858
29381817_130721,CM021107.1,8,29381817,93637874,351456,130721,93768595,88757978
29381817_130918,CM021107.1,8,29381817,93637874,351456,130918,93768792,88758175
29381817_130945,CM021107.1,8,29381817,93637874,351456,130945,93768819,88758202
29379369_196693,CM021107.1,8,29379369,93637870,377756,196693,93834563,88823946
29377291_314148,CM021107.1,8,29377291,93637874,372031,314148,93952022,88941405
29377291_314202,CM021107.1,8,29377291,93637874,372031,314202,93952076,88941459
29381607_319992,CM021107.1,8,29381607,95384333,331289,319992,95704325,90693708
29381607_320022,CM021107.1,8,29381607,95384333,331289,320022,95704355,90693738
29381607_320124,CM021107.1,8,29381607,95384333,331289,320124,95704457,90693840
29381607_320140,CM021107.1,8,29381607,95384333,331289,320140,95704473,90693856
29381607_320144,CM021107.1,8,29381607,95384333,331289,320144,95704477,90693860
29381607_320146,CM021107.1,8,29381607,95384333,331289,320146,95704479,90693862
29381607_320169,CM021107.1,8,29381607,95384333,331289,320169,95704502,90693885
29345034_6860,CM021107.1,8,29345034,100275433,43287,6860,100282293,95271676
29345034_6889,CM021107.1,8,29345034,100275433,43287,6889,100282322,95271705
29345034_6892,CM021107.1,8,29345034,100275433,43287,6892,100282325,95271708
29379233_66272,CM021107.1,8,29379233,138737250,557811,66272,138803522,133792905
29344882_5243,CM021107.1,8,29344882,186632457,36373,5243,186637700,181627083
29378012_56709,CM021107.1,8,29378012,186633688,138385,56709,186690397,181679780
29381374_232653,CM021107.1,8,29381374,187870031,383786,232653,188102684,183092067
29381374_261793,CM021107.1,8,29381374,187870031,383786,261793,188131824,183121207
29381820_289714,CM021107.1,8,29381820,187870025,854088,289714,188159739,183149122
29381820_289759,CM021107.1,8,29381820,187870025,854088,289759,188159784,183149167
29381820_289785,CM021107.1,8,29381820,187870025,854088,289785,188159810,183149193
29381820_289788,CM021107.1,8,29381820,187870025,854088,289788,188159813,183149196
29381374_327586,CM021107.1,8,29381374,187870031,383786,327586,188197617,183187000
29381621_122518,CM021107.1,8,29381621,202538281,588349,122518,202660799,197650182
29381621_122533,CM021107.1,8,29381621,202538281,588349,122533,202660814,197650197
29381621_122546,CM021107.1,8,29381621,202538281,588349,122546,202660827,197650210
29381621_195408,CM021107.1,8,29381621,202538281,588349,195408,202733689,197723072
29381621_195412,CM021107.1,8,29381621,202538281,588349,195412,202733693,197723076
29381621_266624,CM021107.1,8,29381621,202538281,588349,266624,202804905,197794288
29381621_268283,CM021107.1,8,29381621,202538281,588349,268283,202806564,197795947
29381621_268302,CM021107.1,8,29381621,202538281,588349,268302,202806583,197795966
29381621_268312,CM021107.1,8,29381621,202538281,588349,268312,202806593,197795976
29381621_268314,CM021107.1,8,29381621,202538281,588349,268314,202806595,197795978
29381621_268409,CM021107.1,8,29381621,202538281,588349,268409,202806690,197796073
29381621_326289,CM021107.1,8,29381621,202538281,588349,326289,202864570,197853953
29381621_326368,CM021107.1,8,29381621,202538281,588349,326368,202864649,197854032
29381621_326379,CM021107.1,8,29381621,202538281,588349,326379,202864660,197854043
29381621_326394,CM021107.1,8,29381621,202538281,588349,326394,202864675,197854058
29381621_326404,CM021107.1,8,29381621,202538281,588349,326404,202864685,197854068
29381621_326409,CM021107.1,8,29381621,202538281,588349,326409,202864690,197854073
29381621_326425,CM021107.1,8,29381621,202538281,588349,326425,202864706,197854089
29381621_326426,CM021107.1,8,29381621,202538281,588349,326426,202864707,197854090
29381621_326469,CM021107.1,8,29381621,202538281,588349,326469,202864750,197854133
29381621_326552,CM021107.1,8,29381621,202538281,588349,326552,202864833,197854216
29381621_454044,CM021107.1,8,29381621,202538281,588349,454044,202992325,197981708
29381621_454062,CM021107.1,8,29381621,202538281,588349,454062,202992343,197981726
29380890_650171,CM021107.1,8,29380890,212408973,1897140,650171,213059144,208048527
29380890_650223,CM021107.1,8,29380890,212408973,1897140,650223,213059196,208048579
29380890_650224,CM021107.1,8,29380890,212408973,1897140,650224,213059197,208048580
29380890_650234,CM021107.1,8,29380890,212408973,1897140,650234,213059207,208048590
29380890_650235,CM021107.1,8,29380890,212408973,1897140,650235,213059208,208048591
29380890_650260,CM021107.1,8,29380890,212408973,1897140,650260,213059233,208048616
29380890_650261,CM021107.1,8,29380890,212408973,1897140,650261,213059234,208048617
29380890_650312,CM021107.1,8,29380890,212408973,1897140,650312,213059285,208048668
29380890_650335,CM021107.1,8,29380890,212408973,1897140,650335,213059308,208048691
29358072_897224,CM021107.1,8,29358072,212408979,1533760,897224,213306203,208295586
29358072_897249,CM021107.1,8,29358072,212408979,1533760,897249,213306228,208295611
29358072_897292,CM021107.1,8,29358072,212408979,1533760,897292,213306271,208295654
29358072_921551,CM021107.1,8,29358072,212408979,1533760,921551,213330530,208319913
29358072_1218582,CM021107.1,8,29358072,212408979,1533760,1218582,213627561,208616944
29358072_1252531,CM021107.1,8,29358072,212408979,1533760,1252531,213661510,208650893
29358072_1252559,CM021107.1,8,29358072,212408979,1533760,1252559,213661538,208650921
29381244_1276511,CM021107.1,8,29381244,212408980,3872931,1276511,213685491,208674874
29381244_1276526,CM021107.1,8,29381244,212408980,3872931,1276526,213685506,208674889
29381244_1276530,CM021107.1,8,29381244,212408980,3872931,1276530,213685510,208674893
29381244_1276592,CM021107.1,8,29381244,212408980,3872931,1276592,213685572,208674955
29381244_1276601,CM021107.1,8,29381244,212408980,3872931,1276601,213685581,208674964
29381244_1276607,CM021107.1,8,29381244,212408980,3872931,1276607,213685587,208674970
29381244_1276621,CM021107.1,8,29381244,212408980,3872931,1276621,213685601,208674984
29379231_1342192,CM021107.1,8,29379231,212408980,1453119,1342192,213751172,208740555
29379231_1342461,CM021107.1,8,29379231,212408980,1453119,1342461,213751441,208740824
29381244_1896306,CM021107.1,8,29381244,212408980,3872931,1896306,214305286,209294669
29381244_1896360,CM021107.1,8,29381244,212408980,3872931,1896360,214305340,209294723
29381244_2011613,CM021107.1,8,29381244,212408980,3872931,2011613,214420593,209409976
29381244_2011687,CM021107.1,8,29381244,212408980,3872931,2011687,214420667,209410050
29381244_3685458,CM021107.1,8,29381244,212408980,3872931,3685458,216094438,211083821
29381244_3772947,CM021107.1,8,29381244,212408980,3872931,3772947,216181927,211171310
29380338_79095,CM021107.1,8,29380338,221073179,103239,79095,221152274,216141657
29346135_312,CM021107.1,8,29346135,221162456,132588,312,221162768,216152151
29346135_341,CM021107.1,8,29346135,221162456,132588,341,221162797,216152180
29346135_370,CM021107.1,8,29346135,221162456,132588,370,221162826,216152209
29346135_382,CM021107.1,8,29346135,221162456,132588,382,221162838,216152221
29346135_407,CM021107.1,8,29346135,221162456,132588,407,221162863,216152246
29346135_412,CM021107.1,8,29346135,221162456,132588,412,221162868,216152251
29346135_449,CM021107.1,8,29346135,221162456,132588,449,221162905,216152288
29346135_482,CM021107.1,8,29346135,221162456,132588,482,221162938,216152321
29346135_483,CM021107.1,8,29346135,221162456,132588,483,221162939,216152322
29346135_512,CM021107.1,8,29346135,221162456,132588,512,221162968,216152351
29346135_536,CM021107.1,8,29346135,221162456,132588,536,221162992,216152375
29346135_537,CM021107.1,8,29346135,221162456,132588,537,221162993,216152376
29378057_44761,CM021107.1,8,29378057,221159352,3501453,44761,221204113,216193496
29378057_44763,CM021107.1,8,29378057,221159352,3501453,44763,221204115,216193498
29378057_44772,CM021107.1,8,29378057,221159352,3501453,44772,221204124,216193507
29378057_44799,CM021107.1,8,29378057,221159352,3501453,44799,221204151,216193534
29340883_49038,CM021107.1,8,29340883,221161462,155424,49038,221210500,216199883
29340883_49042,CM021107.1,8,29340883,221161462,155424,49042,221210504,216199887
29340883_49044,CM021107.1,8,29340883,221161462,155424,49044,221210506,216199889
29378057_251618,CM021107.1,8,29378057,221159352,3501453,251618,221410970,216400353
29378057_252394,CM021107.1,8,29378057,221159352,3501453,252394,221411746,216401129
29378057_252401,CM021107.1,8,29378057,221159352,3501453,252401,221411753,216401136
29378057_252840,CM021107.1,8,29378057,221159352,3501453,252840,221412192,216401575
29378057_252845,CM021107.1,8,29378057,221159352,3501453,252845,221412197,216401580
29378057_260207,CM021107.1,8,29378057,221159352,3501453,260207,221419559,216408942
29378057_260270,CM021107.1,8,29378057,221159352,3501453,260270,221419622,216409005
29382087_672685,CM021107.1,8,29382087,221159318,4244169,672685,221832003,216821386
29378057_756411,CM021107.1,8,29378057,221159352,3501453,756411,221915763,216905146
29378057_756434,CM021107.1,8,29378057,221159352,3501453,756434,221915786,216905169
29378057_756442,CM021107.1,8,29378057,221159352,3501453,756442,221915794,216905177
29378057_889664,CM021107.1,8,29378057,221159352,3501453,889664,222049016,217038399
29378057_889710,CM021107.1,8,29378057,221159352,3501453,889710,222049062,217038445
29378057_889728,CM021107.1,8,29378057,221159352,3501453,889728,222049080,217038463
29378057_889796,CM021107.1,8,29378057,221159352,3501453,889796,222049148,217038531
29378057_1196551,CM021107.1,8,29378057,221159352,3501453,1196551,222355903,217345286
29378057_1617023,CM021107.1,8,29378057,221159352,3501453,1617023,222776375,217765758
29378057_1617074,CM021107.1,8,29378057,221159352,3501453,1617074,222776426,217765809
29382450_1618815,CM021107.1,8,29382450,221160327,3984387,1618815,222779142,217768525
29379388_10606,CM021107.1,8,29379388,223125708,536480,10606,223136314,218125697
29382138_24743,CM021107.1,8,29382138,223125702,3065191,24743,223150445,218139828
29382138_24804,CM021107.1,8,29382138,223125702,3065191,24804,223150506,218139889
29382138_24844,CM021107.1,8,29382138,223125702,3065191,24844,223150546,218139929
29382138_24931,CM021107.1,8,29382138,223125702,3065191,24931,223150633,218140016
29377644_95546,CM021107.1,8,29377644,223125707,108269,95546,223221253,218210636
29377644_95548,CM021107.1,8,29377644,223125707,108269,95548,223221255,218210638
29377644_95553,CM021107.1,8,29377644,223125707,108269,95553,223221260,218210643
29377644_95598,CM021107.1,8,29377644,223125707,108269,95598,223221305,218210688
29377644_95614,CM021107.1,8,29377644,223125707,108269,95614,223221321,218210704
29379430_96203,CM021107.1,8,29379430,223125701,3979141,96203,223221904,218211287
29379430_96258,CM021107.1,8,29379430,223125701,3979141,96258,223221959,218211342
29379430_96373,CM021107.1,8,29379430,223125701,3979141,96373,223222074,218211457
29379430_96501,CM021107.1,8,29379430,223125701,3979141,96501,223222202,218211585
29379430_96512,CM021107.1,8,29379430,223125701,3979141,96512,223222213,218211596
29379430_98808,CM021107.1,8,29379430,223125701,3979141,98808,223224509,218213892
29356979_103804,CM021107.1,8,29356979,223127763,104898,103804,223231567,218220950
29356979_103808,CM021107.1,8,29356979,223127763,104898,103808,223231571,218220954
29380901_125770,CM021107.1,8,29380901,223125708,4269271,125770,223251478,218240861
29380901_125780,CM021107.1,8,29380901,223125708,4269271,125780,223251488,218240871
29380901_125792,CM021107.1,8,29380901,223125708,4269271,125792,223251500,218240883
29380901_125817,CM021107.1,8,29380901,223125708,4269271,125817,223251525,218240908
29380901_125865,CM021107.1,8,29380901,223125708,4269271,125865,223251573,218240956
29379051_126928,CM021107.1,8,29379051,223125709,1248227,126928,223252637,218242020
29379051_126972,CM021107.1,8,29379051,223125709,1248227,126972,223252681,218242064
29379051_127132,CM021107.1,8,29379051,223125709,1248227,127132,223252841,218242224
29380901_128742,CM021107.1,8,29380901,223125708,4269271,128742,223254450,218243833
29382284_134435,CM021107.1,8,29382284,223127698,274120,134435,223262133,218251516
29382284_134465,CM021107.1,8,29382284,223127698,274120,134465,223262163,218251546
29381965_167201,CM021107.1,8,29381965,223125708,2735819,167201,223292909,218282292
29381965_167224,CM021107.1,8,29381965,223125708,2735819,167224,223292932,218282315
29381965_167238,CM021107.1,8,29381965,223125708,2735819,167238,223292946,218282329
29381965_167272,CM021107.1,8,29381965,223125708,2735819,167272,223292980,218282363
29381965_167278,CM021107.1,8,29381965,223125708,2735819,167278,223292986,218282369
29377868_179253,CM021107.1,8,29377868,223125706,1126759,179253,223304959,218294342
29377868_179269,CM021107.1,8,29377868,223125706,1126759,179269,223304975,218294358
29377868_179386,CM021107.1,8,29377868,223125706,1126759,179386,223305092,218294475
29377868_179399,CM021107.1,8,29377868,223125706,1126759,179399,223305105,218294488
29380156_185916,CM021107.1,8,29380156,223125708,1159533,185916,223311624,218301007
29378544_188035,CM021107.1,8,29378544,223125707,1120892,188035,223313742,218303125
29379388_219969,CM021107.1,8,29379388,223125708,536480,219969,223345677,218335060
29379388_219978,CM021107.1,8,29379388,223125708,536480,219978,223345686,218335069
29379388_219979,CM021107.1,8,29379388,223125708,536480,219979,223345687,218335070
29379388_219980,CM021107.1,8,29379388,223125708,536480,219980,223345688,218335071
29379388_219981,CM021107.1,8,29379388,223125708,536480,219981,223345689,218335072
29379388_219982,CM021107.1,8,29379388,223125708,536480,219982,223345690,218335073
29379388_219987,CM021107.1,8,29379388,223125708,536480,219987,223345695,218335078
29379388_219992,CM021107.1,8,29379388,223125708,536480,219992,223345700,218335083
29379388_219997,CM021107.1,8,29379388,223125708,536480,219997,223345705,218335088
29379388_220025,CM021107.1,8,29379388,223125708,536480,220025,223345733,218335116
29379388_220045,CM021107.1,8,29379388,223125708,536480,220045,223345753,218335136
29379388_220055,CM021107.1,8,29379388,223125708,536480,220055,223345763,218335146
29379388_220061,CM021107.1,8,29379388,223125708,536480,220061,223345769,218335152
29379388_220063,CM021107.1,8,29379388,223125708,536480,220063,223345771,218335154
29379388_220076,CM021107.1,8,29379388,223125708,536480,220076,223345784,218335167
29379388_220134,CM021107.1,8,29379388,223125708,536480,220134,223345842,218335225
29379388_220136,CM021107.1,8,29379388,223125708,536480,220136,223345844,218335227
29379388_220149,CM021107.1,8,29379388,223125708,536480,220149,223345857,218335240
29379388_220171,CM021107.1,8,29379388,223125708,536480,220171,223345879,218335262
29379388_220181,CM021107.1,8,29379388,223125708,536480,220181,223345889,218335272
29379388_220203,CM021107.1,8,29379388,223125708,536480,220203,223345911,218335294
29379388_220211,CM021107.1,8,29379388,223125708,536480,220211,223345919,218335302
29379388_220221,CM021107.1,8,29379388,223125708,536480,220221,223345929,218335312
29379388_220223,CM021107.1,8,29379388,223125708,536480,220223,223345931,218335314
29380487_222326,CM021107.1,8,29380487,223125708,2273277,222326,223348034,218337417
29380487_222342,CM021107.1,8,29380487,223125708,2273277,222342,223348050,218337433
29380487_222384,CM021107.1,8,29380487,223125708,2273277,222384,223348092,218337475
29380487_222410,CM021107.1,8,29380487,223125708,2273277,222410,223348118,218337501
29378544_261717,CM021107.1,8,29378544,223125707,1120892,261717,223387424,218376807
29382074_266001,CM021107.1,8,29382074,223128562,818795,266001,223394563,218383946
29380156_280251,CM021107.1,8,29380156,223125708,1159533,280251,223405959,218395342
29378716_325571,CM021107.1,8,29378716,223128584,469898,325571,223454155,218443538
29378716_325612,CM021107.1,8,29378716,223128584,469898,325612,223454196,218443579
29378716_325629,CM021107.1,8,29378716,223128584,469898,325629,223454213,218443596
29378716_326294,CM021107.1,8,29378716,223128584,469898,326294,223454878,218444261
29380487_329397,CM021107.1,8,29380487,223125708,2273277,329397,223455105,218444488
29380487_338884,CM021107.1,8,29380487,223125708,2273277,338884,223464592,218453975
29378636_415780,CM021107.1,8,29378636,223125708,4266355,415780,223541488,218530871
29378716_420961,CM021107.1,8,29378716,223128584,469898,420961,223549545,218538928
29378716_421027,CM021107.1,8,29378716,223128584,469898,421027,223549611,218538994
29380628_431181,CM021107.1,8,29380628,223128794,1128705,431181,223559975,218549358
29380628_431285,CM021107.1,8,29380628,223128794,1128705,431285,223560079,218549462
29380628_431699,CM021107.1,8,29380628,223128794,1128705,431699,223560493,218549876
29380628_434211,CM021107.1,8,29380628,223128794,1128705,434211,223563005,218552388
29380628_434266,CM021107.1,8,29380628,223128794,1128705,434266,223563060,218552443
29378484_446125,CM021107.1,8,29378484,223125706,2267550,446125,223571831,218561214
29378484_446575,CM021107.1,8,29378484,223125706,2267550,446575,223572281,218561664
29378484_448691,CM021107.1,8,29378484,223125706,2267550,448691,223574397,218563780
29378484_449299,CM021107.1,8,29378484,223125706,2267550,449299,223575005,218564388
29378484_449350,CM021107.1,8,29378484,223125706,2267550,449350,223575056,218564439
29378484_449354,CM021107.1,8,29378484,223125706,2267550,449354,223575060,218564443
29378484_449365,CM021107.1,8,29378484,223125706,2267550,449365,223575071,218564454
29378484_449366,CM021107.1,8,29378484,223125706,2267550,449366,223575072,218564455
29378484_449373,CM021107.1,8,29378484,223125706,2267550,449373,223575079,218564462
29378484_449376,CM021107.1,8,29378484,223125706,2267550,449376,223575082,218564465
29381105_450998,CM021107.1,8,29381105,223128891,1563845,450998,223579889,218569272
29381105_451234,CM021107.1,8,29381105,223128891,1563845,451234,223580125,218569508
29381105_451260,CM021107.1,8,29381105,223128891,1563845,451260,223580151,218569534
29381905_456073,CM021107.1,8,29381905,223128330,764574,456073,223584403,218573786
29379051_460301,CM021107.1,8,29379051,223125709,1248227,460301,223586010,218575393
29378057_2432704,CM021107.1,8,29378057,221159352,3501453,2432704,223592056,218581439
29378057_2432811,CM021107.1,8,29378057,221159352,3501453,2432811,223592163,218581546
29378057_2432899,CM021107.1,8,29378057,221159352,3501453,2432899,223592251,218581634
29379388_477063,CM021107.1,8,29379388,223125708,536480,477063,223602771,218592154
29379388_477085,CM021107.1,8,29379388,223125708,536480,477085,223602793,218592176
29379695_484480,CM021107.1,8,29379695,223125708,799413,484480,223610188,218599571
29379388_499353,CM021107.1,8,29379388,223125708,536480,499353,223625061,218614444
29379388_499402,CM021107.1,8,29379388,223125708,536480,499402,223625110,218614493
29382450_2475595,CM021107.1,8,29382450,221160327,3984387,2475595,223635922,218625305
29382450_2475700,CM021107.1,8,29382450,221160327,3984387,2475700,223636027,218625410
29382450_2475986,CM021107.1,8,29382450,221160327,3984387,2475986,223636313,218625696
29379051_537585,CM021107.1,8,29379051,223125709,1248227,537585,223663294,218652677
29379051_537591,CM021107.1,8,29379051,223125709,1248227,537591,223663300,218652683
29381105_549945,CM021107.1,8,29381105,223128891,1563845,549945,223678836,218668219
29381105_549953,CM021107.1,8,29381105,223128891,1563845,549953,223678844,218668227
29381105_549957,CM021107.1,8,29381105,223128891,1563845,549957,223678848,218668231
29381105_550162,CM021107.1,8,29381105,223128891,1563845,550162,223679053,218668436
29381105_550227,CM021107.1,8,29381105,223128891,1563845,550227,223679118,218668501
29382450_2527100,CM021107.1,8,29382450,221160327,3984387,2527100,223687427,218676810
29381905_560112,CM021107.1,8,29381905,223128330,764574,560112,223688442,218677825
29381905_560132,CM021107.1,8,29381905,223128330,764574,560132,223688462,218677845
29381905_560202,CM021107.1,8,29381905,223128330,764574,560202,223688532,218677915
29382497_585968,CM021107.1,8,29382497,223125708,1078646,585968,223711676,218701059
29382497_586082,CM021107.1,8,29382497,223125708,1078646,586082,223711790,218701173
29381105_611129,CM021107.1,8,29381105,223128891,1563845,611129,223740020,218729403
29382087_2608431,CM021107.1,8,29382087,221159318,4244169,2608431,223767749,218757132
29378544_653028,CM021107.1,8,29378544,223125707,1120892,653028,223778735,218768118
29382087_2619584,CM021107.1,8,29382087,221159318,4244169,2619584,223778902,218768285
29382087_2619649,CM021107.1,8,29382087,221159318,4244169,2619649,223778967,218768350
29382087_2619793,CM021107.1,8,29382087,221159318,4244169,2619793,223779111,218768494
29382087_2619794,CM021107.1,8,29382087,221159318,4244169,2619794,223779112,218768495
29382087_2619816,CM021107.1,8,29382087,221159318,4244169,2619816,223779134,218768517
29382087_2619827,CM021107.1,8,29382087,221159318,4244169,2619827,223779145,218768528
29380628_663903,CM021107.1,8,29380628,223128794,1128705,663903,223792697,218782080
29381391_722617,CM021107.1,8,29381391,223125706,4177263,722617,223848323,218837706
29381391_722708,CM021107.1,8,29381391,223125706,4177263,722708,223848414,218837797
29378544_742619,CM021107.1,8,29378544,223125707,1120892,742619,223868326,218857709
29381391_767776,CM021107.1,8,29381391,223125706,4177263,767776,223893482,218882865
29379430_786638,CM021107.1,8,29379430,223125701,3979141,786638,223912339,218901722
29379430_787859,CM021107.1,8,29379430,223125701,3979141,787859,223913560,218902943
29379430_787930,CM021107.1,8,29379430,223125701,3979141,787930,223913631,218903014
29379430_788012,CM021107.1,8,29379430,223125701,3979141,788012,223913713,218903096
29379430_829895,CM021107.1,8,29379430,223125701,3979141,829895,223955596,218944979
29379767_944656,CM021107.1,8,29379767,223125707,1686091,944656,224070363,219059746
29378544_954835,CM021107.1,8,29378544,223125707,1120892,954835,224080542,219069925
29378484_1000348,CM021107.1,8,29378484,223125706,2267550,1000348,224126054,219115437
29378484_1000365,CM021107.1,8,29378484,223125706,2267550,1000365,224126071,219115454
29378484_1015177,CM021107.1,8,29378484,223125706,2267550,1015177,224140883,219130266
29378484_1015269,CM021107.1,8,29378484,223125706,2267550,1015269,224140975,219130358
29378484_1017441,CM021107.1,8,29378484,223125706,2267550,1017441,224143147,219132530
29378484_1024705,CM021107.1,8,29378484,223125706,2267550,1024705,224150411,219139794
29378484_1024967,CM021107.1,8,29378484,223125706,2267550,1024967,224150673,219140056
29378484_1025235,CM021107.1,8,29378484,223125706,2267550,1025235,224150941,219140324
29379430_1047283,CM021107.1,8,29379430,223125701,3979141,1047283,224172984,219162367
29379430_1047362,CM021107.1,8,29379430,223125701,3979141,1047362,224173063,219162446
29380156_1055104,CM021107.1,8,29380156,223125708,1159533,1055104,224180812,219170195
29379271_1162121,CM021107.1,8,29379271,223125703,3377596,1162121,224287824,219277207
29378484_1192340,CM021107.1,8,29378484,223125706,2267550,1192340,224318046,219307429
29378484_1192388,CM021107.1,8,29378484,223125706,2267550,1192388,224318094,219307477
29378484_1192420,CM021107.1,8,29378484,223125706,2267550,1192420,224318126,219307509
29378484_1192442,CM021107.1,8,29378484,223125706,2267550,1192442,224318148,219307531
29378484_1192923,CM021107.1,8,29378484,223125706,2267550,1192923,224318629,219308012
29378484_1192936,CM021107.1,8,29378484,223125706,2267550,1192936,224318642,219308025
29378484_1192971,CM021107.1,8,29378484,223125706,2267550,1192971,224318677,219308060
29378057_3167787,CM021107.1,8,29378057,221159352,3501453,3167787,224327139,219316522
29378057_3167827,CM021107.1,8,29378057,221159352,3501453,3167827,224327179,219316562
29378057_3167835,CM021107.1,8,29378057,221159352,3501453,3167835,224327187,219316570
29378057_3167908,CM021107.1,8,29378057,221159352,3501453,3167908,224327260,219316643
29378057_3168767,CM021107.1,8,29378057,221159352,3501453,3168767,224328119,219317502
29378057_3168770,CM021107.1,8,29378057,221159352,3501453,3168770,224328122,219317505
29378057_3168832,CM021107.1,8,29378057,221159352,3501453,3168832,224328184,219317567
29378057_3190956,CM021107.1,8,29378057,221159352,3501453,3190956,224350308,219339691
29378057_3190958,CM021107.1,8,29378057,221159352,3501453,3190958,224350310,219339693
29378057_3190968,CM021107.1,8,29378057,221159352,3501453,3190968,224350320,219339703
29378057_3191018,CM021107.1,8,29378057,221159352,3501453,3191018,224350370,219339753
29378057_3191024,CM021107.1,8,29378057,221159352,3501453,3191024,224350376,219339759
29378057_3191090,CM021107.1,8,29378057,221159352,3501453,3191090,224350442,219339825
29378119_1265878,CM021107.1,8,29378119,223125708,4042768,1265878,224391586,219380969
29378119_1265942,CM021107.1,8,29378119,223125708,4042768,1265942,224391650,219381033
29378119_1266136,CM021107.1,8,29378119,223125708,4042768,1266136,224391844,219381227
29378119_1273524,CM021107.1,8,29378119,223125708,4042768,1273524,224399232,219388615
29378119_1273546,CM021107.1,8,29378119,223125708,4042768,1273546,224399254,219388637
29382087_3242461,CM021107.1,8,29382087,221159318,4244169,3242461,224401779,219391162
29378484_1335055,CM021107.1,8,29378484,223125706,2267550,1335055,224460761,219450144
29377722_1378616,CM021107.1,8,29377722,223125708,1764330,1378616,224504324,219493707
29377722_1378638,CM021107.1,8,29377722,223125708,1764330,1378638,224504346,219493729
29377722_1378686,CM021107.1,8,29377722,223125708,1764330,1378686,224504394,219493777
29377722_1380179,CM021107.1,8,29377722,223125708,1764330,1380179,224505887,219495270
29381965_1385580,CM021107.1,8,29381965,223125708,2735819,1385580,224511288,219500671
29381965_1385582,CM021107.1,8,29381965,223125708,2735819,1385582,224511290,219500673
29381965_1385585,CM021107.1,8,29381965,223125708,2735819,1385585,224511293,219500676
29381965_1385629,CM021107.1,8,29381965,223125708,2735819,1385629,224511337,219500720
29381965_1385702,CM021107.1,8,29381965,223125708,2735819,1385702,224511410,219500793
29381965_1385704,CM021107.1,8,29381965,223125708,2735819,1385704,224511412,219500795
29381965_1385723,CM021107.1,8,29381965,223125708,2735819,1385723,224511431,219500814
29381965_1385733,CM021107.1,8,29381965,223125708,2735819,1385733,224511441,219500824
29378636_1408482,CM021107.1,8,29378636,223125708,4266355,1408482,224534190,219523573
29378636_1408717,CM021107.1,8,29378636,223125708,4266355,1408717,224534425,219523808
29378636_1408840,CM021107.1,8,29378636,223125708,4266355,1408840,224534548,219523931
29380487_1437757,CM021107.1,8,29380487,223125708,2273277,1437757,224563465,219552848
29380487_1437853,CM021107.1,8,29380487,223125708,2273277,1437853,224563561,219552944
29380487_1466585,CM021107.1,8,29380487,223125708,2273277,1466585,224592293,219581676
29378119_1487491,CM021107.1,8,29378119,223125708,4042768,1487491,224613199,219602582
29378119_1487743,CM021107.1,8,29378119,223125708,4042768,1487743,224613451,219602834
29378119_1487809,CM021107.1,8,29378119,223125708,4042768,1487809,224613517,219602900
29378119_1487835,CM021107.1,8,29378119,223125708,4042768,1487835,224613543,219602926
29380487_1501112,CM021107.1,8,29380487,223125708,2273277,1501112,224626820,219616203
29380487_1501503,CM021107.1,8,29380487,223125708,2273277,1501503,224627211,219616594
29378119_1518153,CM021107.1,8,29378119,223125708,4042768,1518153,224643861,219633244
29377203_1540548,CM021107.1,8,29377203,223128371,6408408,1540548,224668919,219658302
29378119_1566056,CM021107.1,8,29378119,223125708,4042768,1566056,224691764,219681147
29378119_1566098,CM021107.1,8,29378119,223125708,4042768,1566098,224691806,219681189
29378119_1567767,CM021107.1,8,29378119,223125708,4042768,1567767,224693475,219682858
29378119_1567775,CM021107.1,8,29378119,223125708,4042768,1567775,224693483,219682866
29378119_1567840,CM021107.1,8,29378119,223125708,4042768,1567840,224693548,219682931
29378119_1567879,CM021107.1,8,29378119,223125708,4042768,1567879,224693587,219682970
29378877_1626167,CM021107.1,8,29378877,223125702,3390325,1626167,224751869,219741252
29380487_1630248,CM021107.1,8,29380487,223125708,2273277,1630248,224755956,219745339
29382450_3642173,CM021107.1,8,29382450,221160327,3984387,3642173,224802500,219791883
29382450_3642220,CM021107.1,8,29382450,221160327,3984387,3642220,224802547,219791930
29381965_1683685,CM021107.1,8,29381965,223125708,2735819,1683685,224809393,219798776
29381965_1683724,CM021107.1,8,29381965,223125708,2735819,1683724,224809432,219798815
29381965_1683790,CM021107.1,8,29381965,223125708,2735819,1683790,224809498,219798881
29381965_1688794,CM021107.1,8,29381965,223125708,2735819,1688794,224814502,219803885
29382450_3665227,CM021107.1,8,29382450,221160327,3984387,3665227,224825554,219814937
29379568_3797934,CM021107.1,8,29379568,221159318,4147167,3797934,224957252,219946635
29379568_3797943,CM021107.1,8,29379568,221159318,4147167,3797943,224957261,219946644
29379568_3797947,CM021107.1,8,29379568,221159318,4147167,3797947,224957265,219946648
29379568_3797955,CM021107.1,8,29379568,221159318,4147167,3797955,224957273,219946656
29379568_3797957,CM021107.1,8,29379568,221159318,4147167,3797957,224957275,219946658
29379568_3798003,CM021107.1,8,29379568,221159318,4147167,3798003,224957321,219946704
29379568_3798123,CM021107.1,8,29379568,221159318,4147167,3798123,224957441,219946824
29379568_3798307,CM021107.1,8,29379568,221159318,4147167,3798307,224957625,219947008
29378484_1839667,CM021107.1,8,29378484,223125706,2267550,1839667,224965373,219954756
29378484_1839685,CM021107.1,8,29378484,223125706,2267550,1839685,224965391,219954774
29378484_1897819,CM021107.1,8,29378484,223125706,2267550,1897819,225023525,220012908
29378484_1898820,CM021107.1,8,29378484,223125706,2267550,1898820,225024526,220013909
29379568_3972417,CM021107.1,8,29379568,221159318,4147167,3972417,225131735,220121118
29380487_2014534,CM021107.1,8,29380487,223125708,2273277,2014534,225140242,220129625
29380487_2014636,CM021107.1,8,29380487,223125708,2273277,2014636,225140344,220129727
29380487_2015221,CM021107.1,8,29380487,223125708,2273277,2015221,225140929,220130312
29380487_2015428,CM021107.1,8,29380487,223125708,2273277,2015428,225141136,220130519
29381965_2281348,CM021107.1,8,29381965,223125708,2735819,2281348,225407056,220396439
29381965_2281420,CM021107.1,8,29381965,223125708,2735819,2281420,225407128,220396511
29381965_2281791,CM021107.1,8,29381965,223125708,2735819,2281791,225407499,220396882
29382316_2410535,CM021107.1,8,29382316,223125706,3949342,2410535,225536241,220525624
29382316_2410559,CM021107.1,8,29382316,223125706,3949342,2410559,225536265,220525648
29378119_2524115,CM021107.1,8,29378119,223125708,4042768,2524115,225649823,220639206
29381247_2604420,CM021107.1,8,29381247,223125708,6229373,2604420,225730128,220719511
29377538_2671802,CM021107.1,8,29377538,223125709,5535163,2671802,225797511,220786894
29377538_2671855,CM021107.1,8,29377538,223125709,5535163,2671855,225797564,220786947
29381594_2690278,CM021107.1,8,29381594,223125708,14915444,2690278,225815986,220805369
29381594_2690303,CM021107.1,8,29381594,223125708,14915444,2690303,225816011,220805394
29378877_2825188,CM021107.1,8,29378877,223125702,3390325,2825188,225950890,220940273
29378877_2825189,CM021107.1,8,29378877,223125702,3390325,2825189,225950891,220940274
29378877_2825631,CM021107.1,8,29378877,223125702,3390325,2825631,225951333,220940716
29378877_2846089,CM021107.1,8,29378877,223125702,3390325,2846089,225971791,220961174
29378877_2846239,CM021107.1,8,29378877,223125702,3390325,2846239,225971941,220961324
29377538_2942882,CM021107.1,8,29377538,223125709,5535163,2942882,226068591,221057974
29378119_2990617,CM021107.1,8,29378119,223125708,4042768,2990617,226116325,221105708
29377538_3250074,CM021107.1,8,29377538,223125709,5535163,3250074,226375783,221365166
29377538_3250115,CM021107.1,8,29377538,223125709,5535163,3250115,226375824,221365207
29378877_3350666,CM021107.1,8,29378877,223125702,3390325,3350666,226476368,221465751
29382316_3697532,CM021107.1,8,29382316,223125706,3949342,3697532,226823238,221812621
29381247_3891722,CM021107.1,8,29381247,223125708,6229373,3891722,227017430,222006813
29380901_4067227,CM021107.1,8,29380901,223125708,4269271,4067227,227192935,222182318
29380901_4067240,CM021107.1,8,29380901,223125708,4269271,4067240,227192948,222182331
29380901_4067308,CM021107.1,8,29380901,223125708,4269271,4067308,227193016,222182399
29380901_4067374,CM021107.1,8,29380901,223125708,4269271,4067374,227193082,222182465
29381247_4071602,CM021107.1,8,29381247,223125708,6229373,4071602,227197310,222186693
29377538_4173149,CM021107.1,8,29377538,223125709,5535163,4173149,227298858,222288241
29377538_4173150,CM021107.1,8,29377538,223125709,5535163,4173150,227298859,222288242
29377538_4173259,CM021107.1,8,29377538,223125709,5535163,4173259,227298968,222288351
29377538_4173280,CM021107.1,8,29377538,223125709,5535163,4173280,227298989,222288372
29377538_4173448,CM021107.1,8,29377538,223125709,5535163,4173448,227299157,222288540
29377538_4173472,CM021107.1,8,29377538,223125709,5535163,4173472,227299181,222288564
29377538_4174052,CM021107.1,8,29377538,223125709,5535163,4174052,227299761,222289144
29377538_4174060,CM021107.1,8,29377538,223125709,5535163,4174060,227299769,222289152
29377538_4174103,CM021107.1,8,29377538,223125709,5535163,4174103,227299812,222289195
29377538_4183098,CM021107.1,8,29377538,223125709,5535163,4183098,227308807,222298190
29377538_4183167,CM021107.1,8,29377538,223125709,5535163,4183167,227308876,222298259
29377538_4184125,CM021107.1,8,29377538,223125709,5535163,4184125,227309834,222299217
29377538_4184153,CM021107.1,8,29377538,223125709,5535163,4184153,227309862,222299245
29377538_4184299,CM021107.1,8,29377538,223125709,5535163,4184299,227310008,222299391
29377538_4184318,CM021107.1,8,29377538,223125709,5535163,4184318,227310027,222299410
29377538_4184322,CM021107.1,8,29377538,223125709,5535163,4184322,227310031,222299414
29377538_4184351,CM021107.1,8,29377538,223125709,5535163,4184351,227310060,222299443
29377538_4184368,CM021107.1,8,29377538,223125709,5535163,4184368,227310077,222299460
29378636_4192289,CM021107.1,8,29378636,223125708,4266355,4192289,227317997,222307380
29378636_4197644,CM021107.1,8,29378636,223125708,4266355,4197644,227323352,222312735
29378636_4197698,CM021107.1,8,29378636,223125708,4266355,4197698,227323406,222312789
29377538_4884803,CM021107.1,8,29377538,223125709,5535163,4884803,228010512,222999895
29377538_4884888,CM021107.1,8,29377538,223125709,5535163,4884888,228010597,222999980
29377538_4908764,CM021107.1,8,29377538,223125709,5535163,4908764,228034473,223023856
29377538_4908832,CM021107.1,8,29377538,223125709,5535163,4908832,228034541,223023924
29381247_4972991,CM021107.1,8,29381247,223125708,6229373,4972991,228098699,223088082
29377538_5294247,CM021107.1,8,29377538,223125709,5535163,5294247,228419956,223409339
29377538_5294365,CM021107.1,8,29377538,223125709,5535163,5294365,228420074,223409457
29377538_5329819,CM021107.1,8,29377538,223125709,5535163,5329819,228455528,223444911
29377538_5329853,CM021107.1,8,29377538,223125709,5535163,5329853,228455562,223444945
29377538_5329862,CM021107.1,8,29377538,223125709,5535163,5329862,228455571,223444954
29377538_5330009,CM021107.1,8,29377538,223125709,5535163,5330009,228455718,223445101
29381594_5404879,CM021107.1,8,29381594,223125708,14915444,5404879,228530587,223519970
29381594_5406912,CM021107.1,8,29381594,223125708,14915444,5406912,228532620,223522003
29377538_5467019,CM021107.1,8,29377538,223125709,5535163,5467019,228592728,223582111
29377538_5467057,CM021107.1,8,29377538,223125709,5535163,5467057,228592766,223582149
29377538_5467062,CM021107.1,8,29377538,223125709,5535163,5467062,228592771,223582154
29377538_5467086,CM021107.1,8,29377538,223125709,5535163,5467086,228592795,223582178
29377538_5467113,CM021107.1,8,29377538,223125709,5535163,5467113,228592822,223582205
29377538_5467114,CM021107.1,8,29377538,223125709,5535163,5467114,228592823,223582206
29377538_5467119,CM021107.1,8,29377538,223125709,5535163,5467119,228592828,223582211
29381247_5506728,CM021107.1,8,29381247,223125708,6229373,5506728,228632436,223621819
29381247_5506740,CM021107.1,8,29381247,223125708,6229373,5506740,228632448,223621831
29381247_5510441,CM021107.1,8,29381247,223125708,6229373,5510441,228636149,223625532
29381247_5510468,CM021107.1,8,29381247,223125708,6229373,5510468,228636176,223625559
29381247_5510478,CM021107.1,8,29381247,223125708,6229373,5510478,228636186,223625569
29381247_5510479,CM021107.1,8,29381247,223125708,6229373,5510479,228636187,223625570
29381594_5700490,CM021107.1,8,29381594,223125708,14915444,5700490,228826198,223815581
29381594_7991397,CM021107.1,8,29381594,223125708,14915444,7991397,231117105,226106488
29381594_9505337,CM021107.1,8,29381594,223125708,14915444,9505337,232631045,227620428
29381594_12312904,CM021107.1,8,29381594,223125708,14915444,12312904,235438612,230427995
29381594_12312953,CM021107.1,8,29381594,223125708,14915444,12312953,235438661,230428044
29381594_12313015,CM021107.1,8,29381594,223125708,14915444,12313015,235438723,230428106
29381594_13987702,CM021107.1,8,29381594,223125708,14915444,13987702,237113410,232102793
29381594_14446896,CM021107.1,8,29381594,223125708,14915444,14446896,237572604,232561987
29381594_14447580,CM021107.1,8,29381594,223125708,14915444,14447580,237573288,232562671
29381594_14451269,CM021107.1,8,29381594,223125708,14915444,14451269,237576977,232566360
29381594_14451342,CM021107.1,8,29381594,223125708,14915444,14451342,237577050,232566433
29381594_14451382,CM021107.1,8,29381594,223125708,14915444,14451382,237577090,232566473
29381594_14451504,CM021107.1,8,29381594,223125708,14915444,14451504,237577212,232566595
29381594_14451565,CM021107.1,8,29381594,223125708,14915444,14451565,237577273,232566656
29381291_2687,CM021107.1,8,29381291,237751518,4727981,2687,237754205,232743588
29380754_17419,CM021107.1,8,29380754,237751525,997854,17419,237768944,232758327
29380754_17455,CM021107.1,8,29380754,237751525,997854,17455,237768980,232758363
29380754_17464,CM021107.1,8,29380754,237751525,997854,17464,237768989,232758372
29377617_29083,CM021107.1,8,29377617,237751526,3666157,29083,237780609,232769992
29377617_29084,CM021107.1,8,29377617,237751526,3666157,29084,237780610,232769993
29377617_29230,CM021107.1,8,29377617,237751526,3666157,29230,237780756,232770139
29377617_29276,CM021107.1,8,29377617,237751526,3666157,29276,237780802,232770185
29373518_31501,CM021107.1,8,29373518,237759537,115463,31501,237791038,232780421
29373518_31503,CM021107.1,8,29373518,237759537,115463,31503,237791040,232780423
29373518_31524,CM021107.1,8,29373518,237759537,115463,31524,237791061,232780444
29373518_31535,CM021107.1,8,29373518,237759537,115463,31535,237791072,232780455
29373518_31536,CM021107.1,8,29373518,237759537,115463,31536,237791073,232780456
29373518_31537,CM021107.1,8,29373518,237759537,115463,31537,237791074,232780457
29373518_31550,CM021107.1,8,29373518,237759537,115463,31550,237791087,232780470
29373518_31559,CM021107.1,8,29373518,237759537,115463,31559,237791096,232780479
29373518_31564,CM021107.1,8,29373518,237759537,115463,31564,237791101,232780484
29373518_31583,CM021107.1,8,29373518,237759537,115463,31583,237791120,232780503
29373518_31612,CM021107.1,8,29373518,237759537,115463,31612,237791149,232780532
29373518_31617,CM021107.1,8,29373518,237759537,115463,31617,237791154,232780537
29373518_31646,CM021107.1,8,29373518,237759537,115463,31646,237791183,232780566
29373518_31657,CM021107.1,8,29373518,237759537,115463,31657,237791194,232780577
29373518_31673,CM021107.1,8,29373518,237759537,115463,31673,237791210,232780593
29373518_31700,CM021107.1,8,29373518,237759537,115463,31700,237791237,232780620
29373518_31708,CM021107.1,8,29373518,237759537,115463,31708,237791245,232780628
29373518_31715,CM021107.1,8,29373518,237759537,115463,31715,237791252,232780635
29373518_31728,CM021107.1,8,29373518,237759537,115463,31728,237791265,232780648
29378186_66108,CM021107.1,8,29378186,237751524,303477,66108,237817632,232807015
29378186_66223,CM021107.1,8,29378186,237751524,303477,66223,237817747,232807130
29381291_68352,CM021107.1,8,29381291,237751518,4727981,68352,237819870,232809253
29381291_68432,CM021107.1,8,29381291,237751518,4727981,68432,237819950,232809333
29381291_68444,CM021107.1,8,29381291,237751518,4727981,68444,237819962,232809345
29381291_68450,CM021107.1,8,29381291,237751518,4727981,68450,237819968,232809351
29381291_68476,CM021107.1,8,29381291,237751518,4727981,68476,237819994,232809377
29381291_68488,CM021107.1,8,29381291,237751518,4727981,68488,237820006,232809389
29381291_68527,CM021107.1,8,29381291,237751518,4727981,68527,237820045,232809428
29381285_64246,CM021107.1,8,29381285,237758104,6886343,64246,237822350,232811733
29381285_64251,CM021107.1,8,29381285,237758104,6886343,64251,237822355,232811738
29381285_64260,CM021107.1,8,29381285,237758104,6886343,64260,237822364,232811747
29381285_64290,CM021107.1,8,29381285,237758104,6886343,64290,237822394,232811777
29379492_71813,CM021107.1,8,29379492,237757518,1174802,71813,237829331,232818714
29379492_84369,CM021107.1,8,29379492,237757518,1174802,84369,237841887,232831270
29379492_87963,CM021107.1,8,29379492,237757518,1174802,87963,237845481,232834864
29379492_90079,CM021107.1,8,29379492,237757518,1174802,90079,237847597,232836980
29379492_104504,CM021107.1,8,29379492,237757518,1174802,104504,237862022,232851405
29379492_104521,CM021107.1,8,29379492,237757518,1174802,104521,237862039,232851422
29379492_104553,CM021107.1,8,29379492,237757518,1174802,104553,237862071,232851454
29379492_104567,CM021107.1,8,29379492,237757518,1174802,104567,237862085,232851468
29379492_104611,CM021107.1,8,29379492,237757518,1174802,104611,237862129,232851512
29379492_104766,CM021107.1,8,29379492,237757518,1174802,104766,237862284,232851667
29379492_104806,CM021107.1,8,29379492,237757518,1174802,104806,237862324,232851707
29379492_108892,CM021107.1,8,29379492,237757518,1174802,108892,237866410,232855793
29379492_108928,CM021107.1,8,29379492,237757518,1174802,108928,237866446,232855829
29381465_114957,CM021107.1,8,29381465,237751523,743930,114957,237866480,232855863
29379492_108965,CM021107.1,8,29379492,237757518,1174802,108965,237866483,232855866
29381465_115003,CM021107.1,8,29381465,237751523,743930,115003,237866526,232855909
29381465_115009,CM021107.1,8,29381465,237751523,743930,115009,237866532,232855915
29379492_109073,CM021107.1,8,29379492,237757518,1174802,109073,237866591,232855974
29379492_109093,CM021107.1,8,29379492,237757518,1174802,109093,237866611,232855994
29379492_109355,CM021107.1,8,29379492,237757518,1174802,109355,237866873,232856256
29379492_109386,CM021107.1,8,29379492,237757518,1174802,109386,237866904,232856287
29379492_109429,CM021107.1,8,29379492,237757518,1174802,109429,237866947,232856330
29381285_163216,CM021107.1,8,29381285,237758104,6886343,163216,237921320,232910703
29350989_173850,CM021107.1,8,29350989,237751526,224612,173850,237925376,232914759
29350508_230421,CM021107.1,8,29350508,237751513,1411108,230421,237981934,232971317
29380737_233898,CM021107.1,8,29380737,237751524,1289716,233898,237985422,232974805
29380737_233918,CM021107.1,8,29380737,237751524,1289716,233918,237985442,232974825
29380737_233968,CM021107.1,8,29380737,237751524,1289716,233968,237985492,232974875
29378862_259339,CM021107.1,8,29378862,237751521,550614,259339,238010860,233000243
29378862_259340,CM021107.1,8,29378862,237751521,550614,259340,238010861,233000244
29378862_259470,CM021107.1,8,29378862,237751521,550614,259470,238010991,233000374
29378862_259487,CM021107.1,8,29378862,237751521,550614,259487,238011008,233000391
29381145_282460,CM021107.1,8,29381145,237757010,6318947,282460,238039470,233028853
29377617_451230,CM021107.1,8,29377617,237751526,3666157,451230,238202756,233192139
29378862_535101,CM021107.1,8,29378862,237751521,550614,535101,238286622,233276005
29377340_543505,CM021107.1,8,29377340,237751525,2042714,543505,238295030,233284413
29377340_543524,CM021107.1,8,29377340,237751525,2042714,543524,238295049,233284432
29377340_543657,CM021107.1,8,29377340,237751525,2042714,543657,238295182,233284565
29377340_543659,CM021107.1,8,29377340,237751525,2042714,543659,238295184,233284567
29377340_543662,CM021107.1,8,29377340,237751525,2042714,543662,238295187,233284570
29377340_543672,CM021107.1,8,29377340,237751525,2042714,543672,238295197,233284580
29377340_543702,CM021107.1,8,29377340,237751525,2042714,543702,238295227,233284610
29377340_543735,CM021107.1,8,29377340,237751525,2042714,543735,238295260,233284643
29350508_557311,CM021107.1,8,29350508,237751513,1411108,557311,238308824,233298207
29380758_568669,CM021107.1,8,29380758,237751526,2419264,568669,238320195,233309578
29377340_570057,CM021107.1,8,29377340,237751525,2042714,570057,238321582,233310965
29377340_570090,CM021107.1,8,29377340,237751525,2042714,570090,238321615,233310998
29377340_570091,CM021107.1,8,29377340,237751525,2042714,570091,238321616,233310999
29377340_570137,CM021107.1,8,29377340,237751525,2042714,570137,238321662,233311045
29377340_570355,CM021107.1,8,29377340,237751525,2042714,570355,238321880,233311263
29377340_570375,CM021107.1,8,29377340,237751525,2042714,570375,238321900,233311283
29377340_570437,CM021107.1,8,29377340,237751525,2042714,570437,238321962,233311345
29350508_628942,CM021107.1,8,29350508,237751513,1411108,628942,238380455,233369838
29350508_629016,CM021107.1,8,29350508,237751513,1411108,629016,238380529,233369912
29377340_629881,CM021107.1,8,29377340,237751525,2042714,629881,238381406,233370789
29377137_636265,CM021107.1,8,29377137,237758594,2463113,636265,238394859,233384242
29377137_640037,CM021107.1,8,29377137,237758594,2463113,640037,238398631,233388014
29381145_644906,CM021107.1,8,29381145,237757010,6318947,644906,238401916,233391299
29377137_728551,CM021107.1,8,29377137,237758594,2463113,728551,238487145,233476528
29382498_802100,CM021107.1,8,29382498,237751523,1141209,802100,238553623,233543006
29382498_802729,CM021107.1,8,29382498,237751523,1141209,802729,238554252,233543635
29381291_851742,CM021107.1,8,29381291,237751518,4727981,851742,238603260,233592643
29378006_853028,CM021107.1,8,29378006,237751519,7871244,853028,238604547,233593930
29378006_853037,CM021107.1,8,29378006,237751519,7871244,853037,238604556,233593939
29378006_853068,CM021107.1,8,29378006,237751519,7871244,853068,238604587,233593970
29382498_911959,CM021107.1,8,29382498,237751523,1141209,911959,238663482,233652865
29382498_912039,CM021107.1,8,29382498,237751523,1141209,912039,238663562,233652945
29381291_984402,CM021107.1,8,29381291,237751518,4727981,984402,238735920,233725303
29381291_984457,CM021107.1,8,29381291,237751518,4727981,984457,238735975,233725358
29350508_1027648,CM021107.1,8,29350508,237751513,1411108,1027648,238779161,233768544
29350508_1027707,CM021107.1,8,29350508,237751513,1411108,1027707,238779220,233768603
29350508_1087734,CM021107.1,8,29350508,237751513,1411108,1087734,238839247,233828630
29350508_1087737,CM021107.1,8,29350508,237751513,1411108,1087737,238839250,233828633
29350508_1087743,CM021107.1,8,29350508,237751513,1411108,1087743,238839256,233828639
29350508_1087744,CM021107.1,8,29350508,237751513,1411108,1087744,238839257,233828640
29350508_1087807,CM021107.1,8,29350508,237751513,1411108,1087807,238839320,233828703
29350508_1087808,CM021107.1,8,29350508,237751513,1411108,1087808,238839321,233828704
29350508_1087830,CM021107.1,8,29350508,237751513,1411108,1087830,238839343,233828726
29350508_1087859,CM021107.1,8,29350508,237751513,1411108,1087859,238839372,233828755
29380398_1103420,CM021107.1,8,29380398,237757408,3236316,1103420,238860828,233850211
29350508_1110565,CM021107.1,8,29350508,237751513,1411108,1110565,238862078,233851461
29350508_1112457,CM021107.1,8,29350508,237751513,1411108,1112457,238863970,233853353
29350508_1180855,CM021107.1,8,29350508,237751513,1411108,1180855,238932368,233921751
29350508_1180859,CM021107.1,8,29350508,237751513,1411108,1180859,238932372,233921755
29379553_1196403,CM021107.1,8,29379553,237753363,2167908,1196403,238949766,233939149
29377137_1495533,CM021107.1,8,29377137,237758594,2463113,1495533,239254127,234243510
29377137_1505056,CM021107.1,8,29377137,237758594,2463113,1505056,239263650,234253033
29381589_1534576,CM021107.1,8,29381589,237751525,3225270,1534576,239286101,234275484
29381589_1534601,CM021107.1,8,29381589,237751525,3225270,1534601,239286126,234275509
29381589_1534631,CM021107.1,8,29381589,237751525,3225270,1534631,239286156,234275539
29381589_1534648,CM021107.1,8,29381589,237751525,3225270,1534648,239286173,234275556
29381589_1534685,CM021107.1,8,29381589,237751525,3225270,1534685,239286210,234275593
29381589_1534710,CM021107.1,8,29381589,237751525,3225270,1534710,239286235,234275618
29381589_1534713,CM021107.1,8,29381589,237751525,3225270,1534713,239286238,234275621
29377617_1590194,CM021107.1,8,29377617,237751526,3666157,1590194,239341720,234331103
29377617_1590215,CM021107.1,8,29377617,237751526,3666157,1590215,239341741,234331124
29377617_1590231,CM021107.1,8,29377617,237751526,3666157,1590231,239341757,234331140
29377617_1590245,CM021107.1,8,29377617,237751526,3666157,1590245,239341771,234331154
29377340_1621332,CM021107.1,8,29377340,237751525,2042714,1621332,239372857,234362240
29377617_1625811,CM021107.1,8,29377617,237751526,3666157,1625811,239377337,234366720
29377617_1625872,CM021107.1,8,29377617,237751526,3666157,1625872,239377398,234366781
29377617_1625916,CM021107.1,8,29377617,237751526,3666157,1625916,239377442,234366825
29381145_1649492,CM021107.1,8,29381145,237757010,6318947,1649492,239406502,234395885
29381145_1651194,CM021107.1,8,29381145,237757010,6318947,1651194,239408204,234397587
29381929_1794620,CM021107.1,8,29381929,237751513,3763839,1794620,239546133,234535516
29380398_1889642,CM021107.1,8,29380398,237757408,3236316,1889642,239647050,234636433
29380398_1890353,CM021107.1,8,29380398,237757408,3236316,1890353,239647761,234637144
29380398_1890376,CM021107.1,8,29380398,237757408,3236316,1890376,239647784,234637167
29380398_1890382,CM021107.1,8,29380398,237757408,3236316,1890382,239647790,234637173
29380398_1890383,CM021107.1,8,29380398,237757408,3236316,1890383,239647791,234637174
29380398_1890385,CM021107.1,8,29380398,237757408,3236316,1890385,239647793,234637176
29380398_1890409,CM021107.1,8,29380398,237757408,3236316,1890409,239647817,234637200
29380398_1890413,CM021107.1,8,29380398,237757408,3236316,1890413,239647821,234637204
29380398_1890414,CM021107.1,8,29380398,237757408,3236316,1890414,239647822,234637205
29380398_1890452,CM021107.1,8,29380398,237757408,3236316,1890452,239647860,234637243
29380398_1890479,CM021107.1,8,29380398,237757408,3236316,1890479,239647887,234637270
29380398_1890480,CM021107.1,8,29380398,237757408,3236316,1890480,239647888,234637271
29380398_1890492,CM021107.1,8,29380398,237757408,3236316,1890492,239647900,234637283
29380398_1890617,CM021107.1,8,29380398,237757408,3236316,1890617,239648025,234637408
29380398_1890645,CM021107.1,8,29380398,237757408,3236316,1890645,239648053,234637436
29380398_1890650,CM021107.1,8,29380398,237757408,3236316,1890650,239648058,234637441
29377137_1899720,CM021107.1,8,29377137,237758594,2463113,1899720,239658314,234647697
29379553_1937196,CM021107.1,8,29379553,237753363,2167908,1937196,239690559,234679942
29379553_1937245,CM021107.1,8,29379553,237753363,2167908,1937245,239690608,234679991
29379553_1937329,CM021107.1,8,29379553,237753363,2167908,1937329,239690692,234680075
29379553_2012754,CM021107.1,8,29379553,237753363,2167908,2012754,239766117,234755500
29379553_2012906,CM021107.1,8,29379553,237753363,2167908,2012906,239766269,234755652
29379553_2012912,CM021107.1,8,29379553,237753363,2167908,2012912,239766275,234755658
29379553_2012916,CM021107.1,8,29379553,237753363,2167908,2012916,239766279,234755662
29379553_2012934,CM021107.1,8,29379553,237753363,2167908,2012934,239766297,234755680
29382049_2038458,CM021107.1,8,29382049,237751526,12753296,2038458,239789984,234779367
29382049_2038483,CM021107.1,8,29382049,237751526,12753296,2038483,239790009,234779392
29382049_2038496,CM021107.1,8,29382049,237751526,12753296,2038496,239790022,234779405
29382049_2038537,CM021107.1,8,29382049,237751526,12753296,2038537,239790063,234779446
29382049_2038547,CM021107.1,8,29382049,237751526,12753296,2038547,239790073,234779456
29382049_2038567,CM021107.1,8,29382049,237751526,12753296,2038567,239790093,234779476
29382049_2038568,CM021107.1,8,29382049,237751526,12753296,2038568,239790094,234779477
29382049_2038575,CM021107.1,8,29382049,237751526,12753296,2038575,239790101,234779484
29377356_2046987,CM021107.1,8,29377356,237757914,2825814,2046987,239804901,234794284
29381589_2122265,CM021107.1,8,29381589,237751525,3225270,2122265,239873790,234863173
29381589_2123655,CM021107.1,8,29381589,237751525,3225270,2123655,239875180,234864563
29381589_2147503,CM021107.1,8,29381589,237751525,3225270,2147503,239899028,234888411
29381589_2147520,CM021107.1,8,29381589,237751525,3225270,2147520,239899045,234888428
29377356_2142354,CM021107.1,8,29377356,237757914,2825814,2142354,239900268,234889651
29377356_2142577,CM021107.1,8,29377356,237757914,2825814,2142577,239900491,234889874
29377356_2142631,CM021107.1,8,29377356,237757914,2825814,2142631,239900545,234889928
29377137_2225547,CM021107.1,8,29377137,237758594,2463113,2225547,239984141,234973524
29379809_2236549,CM021107.1,8,29379809,237751526,2354836,2236549,239988075,234977458
29377137_2237464,CM021107.1,8,29377137,237758594,2463113,2237464,239996058,234985441
29377137_2237476,CM021107.1,8,29377137,237758594,2463113,2237476,239996070,234985453
29377356_2392275,CM021107.1,8,29377356,237757914,2825814,2392275,240150189,235139572
29380758_2408272,CM021107.1,8,29380758,237751526,2419264,2408272,240159798,235149181
29380758_2408276,CM021107.1,8,29380758,237751526,2419264,2408276,240159802,235149185
29367943_7956,CM021107.1,8,29367943,240284118,54063,7956,240292074,235281457
29367943_7962,CM021107.1,8,29367943,240284118,54063,7962,240292080,235281463
29353308_36410,CM021107.1,8,29353308,240283482,268680,36410,240319892,235309275
29353308_36451,CM021107.1,8,29353308,240283482,268680,36451,240319933,235309316
29381497_37202,CM021107.1,8,29381497,240283985,1235217,37202,240321187,235310570
29381497_37209,CM021107.1,8,29381497,240283985,1235217,37209,240321194,235310577
29381497_37351,CM021107.1,8,29381497,240283985,1235217,37351,240321336,235310719
29381497_37845,CM021107.1,8,29381497,240283985,1235217,37845,240321830,235311213
29381497_37879,CM021107.1,8,29381497,240283985,1235217,37879,240321864,235311247
29379989_47536,CM021107.1,8,29379989,240285807,257216,47536,240333343,235322726
29382265_2634795,CM021107.1,8,29382265,237757047,3537404,2634795,240391842,235381225
29381497_155765,CM021107.1,8,29381497,240283985,1235217,155765,240439750,235429133
29380398_2684951,CM021107.1,8,29380398,237757408,3236316,2684951,240442359,235431742
29381929_2721771,CM021107.1,8,29381929,237751513,3763839,2721771,240473284,235462667
29381929_2721779,CM021107.1,8,29381929,237751513,3763839,2721779,240473292,235462675
29381929_2721783,CM021107.1,8,29381929,237751513,3763839,2721783,240473296,235462679
29381929_2721814,CM021107.1,8,29381929,237751513,3763839,2721814,240473327,235462710
29381929_2721854,CM021107.1,8,29381929,237751513,3763839,2721854,240473367,235462750
29381929_2721863,CM021107.1,8,29381929,237751513,3763839,2721863,240473376,235462759
29381929_2721869,CM021107.1,8,29381929,237751513,3763839,2721869,240473382,235462765
29381929_2722051,CM021107.1,8,29381929,237751513,3763839,2722051,240473564,235462947
29381929_2722057,CM021107.1,8,29381929,237751513,3763839,2722057,240473570,235462953
29381929_2722088,CM021107.1,8,29381929,237751513,3763839,2722088,240473601,235462984
29381929_2722118,CM021107.1,8,29381929,237751513,3763839,2722118,240473631,235463014
29381929_2726080,CM021107.1,8,29381929,237751513,3763839,2726080,240477593,235466976
29381929_2726147,CM021107.1,8,29381929,237751513,3763839,2726147,240477660,235467043
29381929_2726225,CM021107.1,8,29381929,237751513,3763839,2726225,240477738,235467121
29381929_2726290,CM021107.1,8,29381929,237751513,3763839,2726290,240477803,235467186
29381929_2726405,CM021107.1,8,29381929,237751513,3763839,2726405,240477918,235467301
29381929_2726512,CM021107.1,8,29381929,237751513,3763839,2726512,240478025,235467408
29381929_2726519,CM021107.1,8,29381929,237751513,3763839,2726519,240478032,235467415
29378934_202105,CM021107.1,8,29378934,240283482,1165486,202105,240485587,235474970
29381497_202467,CM021107.1,8,29381497,240283985,1235217,202467,240486452,235475835
29381497_202514,CM021107.1,8,29381497,240283985,1235217,202514,240486499,235475882
29381497_222631,CM021107.1,8,29381497,240283985,1235217,222631,240506616,235495999
29380600_271133,CM021107.1,8,29380600,240283482,540692,271133,240554615,235543998
29380600_271189,CM021107.1,8,29380600,240283482,540692,271189,240554671,235544054
29380600_271199,CM021107.1,8,29380600,240283482,540692,271199,240554681,235544064
29380600_271211,CM021107.1,8,29380600,240283482,540692,271211,240554693,235544076
29380600_271234,CM021107.1,8,29380600,240283482,540692,271234,240554716,235544099
29378934_281699,CM021107.1,8,29378934,240283482,1165486,281699,240565181,235554564
29378934_281731,CM021107.1,8,29378934,240283482,1165486,281731,240565213,235554596
29381497_294949,CM021107.1,8,29381497,240283985,1235217,294949,240578934,235568317
29381285_2842233,CM021107.1,8,29381285,237758104,6886343,2842233,240600337,235589720
29379440_2889021,CM021107.1,8,29379440,237751525,7468824,2889021,240640546,235629929
29379440_2889031,CM021107.1,8,29379440,237751525,7468824,2889031,240640556,235629939
29379440_2889055,CM021107.1,8,29379440,237751525,7468824,2889055,240640580,235629963
29379440_2889341,CM021107.1,8,29379440,237751525,7468824,2889341,240640866,235630249
29379440_2906957,CM021107.1,8,29379440,237751525,7468824,2906957,240658482,235647865
29379440_2923420,CM021107.1,8,29379440,237751525,7468824,2923420,240674945,235664328
29379440_2923498,CM021107.1,8,29379440,237751525,7468824,2923498,240675023,235664406
29379440_2923523,CM021107.1,8,29379440,237751525,7468824,2923523,240675048,235664431
29377337_477903,CM021107.1,8,29377337,240283482,2510720,477903,240761385,235750768
29377145_616095,CM021107.1,8,29377145,240283482,1235964,616095,240899577,235888960
29377563_628559,CM021107.1,8,29377563,240283482,2064221,628559,240912041,235901424
29377145_641421,CM021107.1,8,29377145,240283482,1235964,641421,240924903,235914286
29382049_3178155,CM021107.1,8,29382049,237751526,12753296,3178155,240929681,235919064
29382049_3178212,CM021107.1,8,29382049,237751526,12753296,3178212,240929738,235919121
29377145_668752,CM021107.1,8,29377145,240283482,1235964,668752,240952234,235941617
29377145_668981,CM021107.1,8,29377145,240283482,1235964,668981,240952463,235941846
29377145_669003,CM021107.1,8,29377145,240283482,1235964,669003,240952485,235941868
29382049_3244733,CM021107.1,8,29382049,237751526,12753296,3244733,240996259,235985642
29382049_3244750,CM021107.1,8,29382049,237751526,12753296,3244750,240996276,235985659
29382049_3244839,CM021107.1,8,29382049,237751526,12753296,3244839,240996365,235985748
29382049_3244847,CM021107.1,8,29382049,237751526,12753296,3244847,240996373,235985756
29381497_732152,CM021107.1,8,29381497,240283985,1235217,732152,241016137,236005520
29382049_3275895,CM021107.1,8,29382049,237751526,12753296,3275895,241027421,236016804
29382049_3275897,CM021107.1,8,29382049,237751526,12753296,3275897,241027423,236016806
29381291_3291206,CM021107.1,8,29381291,237751518,4727981,3291206,241042724,236032107
29381291_3291215,CM021107.1,8,29381291,237751518,4727981,3291215,241042733,236032116
29381291_3291263,CM021107.1,8,29381291,237751518,4727981,3291263,241042781,236032164
29381291_3291265,CM021107.1,8,29381291,237751518,4727981,3291265,241042783,236032166
29381291_3291288,CM021107.1,8,29381291,237751518,4727981,3291288,241042806,236032189
29381291_3291289,CM021107.1,8,29381291,237751518,4727981,3291289,241042807,236032190
29381291_3291318,CM021107.1,8,29381291,237751518,4727981,3291318,241042836,236032219
29381291_3291353,CM021107.1,8,29381291,237751518,4727981,3291353,241042871,236032254
29381291_3291358,CM021107.1,8,29381291,237751518,4727981,3291358,241042876,236032259
29381291_3291369,CM021107.1,8,29381291,237751518,4727981,3291369,241042887,236032270
29380919_776367,CM021107.1,8,29380919,240284251,1589445,776367,241060618,236050001
29380919_776599,CM021107.1,8,29380919,240284251,1589445,776599,241060850,236050233
29378006_3366185,CM021107.1,8,29378006,237751519,7871244,3366185,241117704,236107087
29378006_3366194,CM021107.1,8,29378006,237751519,7871244,3366194,241117713,236107096
29378006_3366298,CM021107.1,8,29378006,237751519,7871244,3366298,241117817,236107200
29378006_3366320,CM021107.1,8,29378006,237751519,7871244,3366320,241117839,236107222
29381291_3392729,CM021107.1,8,29381291,237751518,4727981,3392729,241144247,236133630
29381291_3392825,CM021107.1,8,29381291,237751518,4727981,3392825,241144343,236133726
29381291_3392868,CM021107.1,8,29381291,237751518,4727981,3392868,241144386,236133769
29380919_901462,CM021107.1,8,29380919,240284251,1589445,901462,241185713,236175096
29380919_902597,CM021107.1,8,29380919,240284251,1589445,902597,241186848,236176231
29380919_902612,CM021107.1,8,29380919,240284251,1589445,902612,241186863,236176246
29380919_902614,CM021107.1,8,29380919,240284251,1589445,902614,241186865,236176248
29380919_902618,CM021107.1,8,29380919,240284251,1589445,902618,241186869,236176252
29380919_902625,CM021107.1,8,29380919,240284251,1589445,902625,241186876,236176259
29380919_902628,CM021107.1,8,29380919,240284251,1589445,902628,241186879,236176262
29380919_902629,CM021107.1,8,29380919,240284251,1589445,902629,241186880,236176263
29380919_902630,CM021107.1,8,29380919,240284251,1589445,902630,241186881,236176264
29380919_902649,CM021107.1,8,29380919,240284251,1589445,902649,241186900,236176283
29380919_903626,CM021107.1,8,29380919,240284251,1589445,903626,241187877,236177260
29380919_903627,CM021107.1,8,29380919,240284251,1589445,903627,241187878,236177261
29377337_980872,CM021107.1,8,29377337,240283482,2510720,980872,241264354,236253737
29377337_984753,CM021107.1,8,29377337,240283482,2510720,984753,241268235,236257618
29377337_984775,CM021107.1,8,29377337,240283482,2510720,984775,241268257,236257640
29377337_1196013,CM021107.1,8,29377337,240283482,2510720,1196013,241479495,236468878
29377337_1200393,CM021107.1,8,29377337,240283482,2510720,1200393,241483875,236473258
29381929_3735027,CM021107.1,8,29381929,237751513,3763839,3735027,241486540,236475923
29377563_1207582,CM021107.1,8,29377563,240283482,2064221,1207582,241491064,236480447
29377563_1207610,CM021107.1,8,29377563,240283482,2064221,1207610,241491092,236480475
29381291_3809868,CM021107.1,8,29381291,237751518,4727981,3809868,241561386,236550769
29381291_3809874,CM021107.1,8,29381291,237751518,4727981,3809874,241561392,236550775
29381291_3809993,CM021107.1,8,29381291,237751518,4727981,3809993,241561511,236550894
29381291_3810070,CM021107.1,8,29381291,237751518,4727981,3810070,241561588,236550971
29381291_3836729,CM021107.1,8,29381291,237751518,4727981,3836729,241588247,236577630
29382049_3889675,CM021107.1,8,29382049,237751526,12753296,3889675,241641201,236630584
29382049_3889683,CM021107.1,8,29382049,237751526,12753296,3889683,241641209,236630592
29382049_3889725,CM021107.1,8,29382049,237751526,12753296,3889725,241641251,236630634
29382049_3889736,CM021107.1,8,29382049,237751526,12753296,3889736,241641262,236630645
29382049_3889796,CM021107.1,8,29382049,237751526,12753296,3889796,241641322,236630705
29382049_3889853,CM021107.1,8,29382049,237751526,12753296,3889853,241641379,236630762
29382049_3890178,CM021107.1,8,29382049,237751526,12753296,3890178,241641704,236631087
29382049_3894046,CM021107.1,8,29382049,237751526,12753296,3894046,241645572,236634955
29381291_3953261,CM021107.1,8,29381291,237751518,4727981,3953261,241704779,236694162
29381291_3953277,CM021107.1,8,29381291,237751518,4727981,3953277,241704795,236694178
29377337_1433068,CM021107.1,8,29377337,240283482,2510720,1433068,241716550,236705933
29377337_1433123,CM021107.1,8,29377337,240283482,2510720,1433123,241716605,236705988
29377337_1661762,CM021107.1,8,29377337,240283482,2510720,1661762,241945244,236934627
29377337_1662482,CM021107.1,8,29377337,240283482,2510720,1662482,241945964,236935347
29377337_1662521,CM021107.1,8,29377337,240283482,2510720,1662521,241946003,236935386
29377337_1662585,CM021107.1,8,29377337,240283482,2510720,1662585,241946067,236935450
29381145_4310632,CM021107.1,8,29381145,237757010,6318947,4310632,242067642,237057025
29381145_4310841,CM021107.1,8,29381145,237757010,6318947,4310841,242067851,237057234
29381145_4314719,CM021107.1,8,29381145,237757010,6318947,4314719,242071729,237061112
29381145_4314739,CM021107.1,8,29381145,237757010,6318947,4314739,242071749,237061132
29381145_4318069,CM021107.1,8,29381145,237757010,6318947,4318069,242075079,237064462
29381145_4320550,CM021107.1,8,29381145,237757010,6318947,4320550,242077560,237066943
29381145_4320628,CM021107.1,8,29381145,237757010,6318947,4320628,242077638,237067021
29380355_4412338,CM021107.1,8,29380355,237758143,5942131,4412338,242170481,237159864
29378006_4480623,CM021107.1,8,29378006,237751519,7871244,4480623,242232142,237221525
29378006_4480707,CM021107.1,8,29378006,237751519,7871244,4480707,242232226,237221609
29380355_4490827,CM021107.1,8,29380355,237758143,5942131,4490827,242248970,237238353
29380355_4490868,CM021107.1,8,29380355,237758143,5942131,4490868,242249011,237238394
29380355_4490918,CM021107.1,8,29380355,237758143,5942131,4490918,242249061,237238444
29380355_4629383,CM021107.1,8,29380355,237758143,5942131,4629383,242387526,237376909
29380355_4630418,CM021107.1,8,29380355,237758143,5942131,4630418,242388561,237377944
29380355_4659486,CM021107.1,8,29380355,237758143,5942131,4659486,242417629,237407012
29377337_2138116,CM021107.1,8,29377337,240283482,2510720,2138116,242421598,237410981
29377337_2138146,CM021107.1,8,29377337,240283482,2510720,2138146,242421628,237411011
29377337_2138204,CM021107.1,8,29377337,240283482,2510720,2138204,242421686,237411069
29377337_2138225,CM021107.1,8,29377337,240283482,2510720,2138225,242421707,237411090
29377337_2138227,CM021107.1,8,29377337,240283482,2510720,2138227,242421709,237411092
29377337_2138250,CM021107.1,8,29377337,240283482,2510720,2138250,242421732,237411115
29377337_2138283,CM021107.1,8,29377337,240283482,2510720,2138283,242421765,237411148
29377337_2138340,CM021107.1,8,29377337,240283482,2510720,2138340,242421822,237411205
29380355_4688277,CM021107.1,8,29380355,237758143,5942131,4688277,242446420,237435803
29377337_2176395,CM021107.1,8,29377337,240283482,2510720,2176395,242459877,237449260
29377337_2176436,CM021107.1,8,29377337,240283482,2510720,2176436,242459918,237449301
29377337_2176457,CM021107.1,8,29377337,240283482,2510720,2176457,242459939,237449322
29377337_2176541,CM021107.1,8,29377337,240283482,2510720,2176541,242460023,237449406
29379440_4824566,CM021107.1,8,29379440,237751525,7468824,4824566,242576091,237565474
29379440_4826331,CM021107.1,8,29379440,237751525,7468824,4826331,242577856,237567239
29379440_4826406,CM021107.1,8,29379440,237751525,7468824,4826406,242577931,237567314
29379440_4826937,CM021107.1,8,29379440,237751525,7468824,4826937,242578462,237567845
29379440_4826970,CM021107.1,8,29379440,237751525,7468824,4826970,242578495,237567878
29379440_4890287,CM021107.1,8,29379440,237751525,7468824,4890287,242641812,237631195
29379440_4905779,CM021107.1,8,29379440,237751525,7468824,4905779,242657304,237646687
29379440_4905817,CM021107.1,8,29379440,237751525,7468824,4905817,242657342,237646725
29379440_4914751,CM021107.1,8,29379440,237751525,7468824,4914751,242666276,237655659
29379440_4914882,CM021107.1,8,29379440,237751525,7468824,4914882,242666407,237655790
29379440_4919887,CM021107.1,8,29379440,237751525,7468824,4919887,242671412,237660795
29379440_4919940,CM021107.1,8,29379440,237751525,7468824,4919940,242671465,237660848
29379440_4919965,CM021107.1,8,29379440,237751525,7468824,4919965,242671490,237660873
29377531_4979571,CM021107.1,8,29377531,237758005,5503306,4979571,242737576,237726959
29377531_4979620,CM021107.1,8,29377531,237758005,5503306,4979620,242737625,237727008
29380355_4991902,CM021107.1,8,29380355,237758143,5942131,4991902,242750045,237739428
29377337_2491240,CM021107.1,8,29377337,240283482,2510720,2491240,242774722,237764105
29378006_5104255,CM021107.1,8,29378006,237751519,7871244,5104255,242855774,237845157
29378006_5104543,CM021107.1,8,29378006,237751519,7871244,5104543,242856062,237845445
29378006_5104591,CM021107.1,8,29378006,237751519,7871244,5104591,242856110,237845493
29378006_5104627,CM021107.1,8,29378006,237751519,7871244,5104627,242856146,237845529
29378006_5104634,CM021107.1,8,29378006,237751519,7871244,5104634,242856153,237845536
29378006_5104769,CM021107.1,8,29378006,237751519,7871244,5104769,242856288,237845671
29378006_5104826,CM021107.1,8,29378006,237751519,7871244,5104826,242856345,237845728
29380355_5525068,CM021107.1,8,29380355,237758143,5942131,5525068,243283211,238272594
29380355_5525146,CM021107.1,8,29380355,237758143,5942131,5525146,243283289,238272672
29380355_5533671,CM021107.1,8,29380355,237758143,5942131,5533671,243291814,238281197
29380355_5533728,CM021107.1,8,29380355,237758143,5942131,5533728,243291871,238281254
29379440_5818784,CM021107.1,8,29379440,237751525,7468824,5818784,243570309,238559692
29381145_5917308,CM021107.1,8,29381145,237757010,6318947,5917308,243674318,238663701
29381145_5917322,CM021107.1,8,29381145,237757010,6318947,5917322,243674332,238663715
29381145_5917397,CM021107.1,8,29381145,237757010,6318947,5917397,243674407,238663790
29381145_5917474,CM021107.1,8,29381145,237757010,6318947,5917474,243674484,238663867
29381145_5985291,CM021107.1,8,29381145,237757010,6318947,5985291,243742301,238731684
29381145_5985382,CM021107.1,8,29381145,237757010,6318947,5985382,243742392,238731775
29381145_5985386,CM021107.1,8,29381145,237757010,6318947,5985386,243742396,238731779
29381145_6053005,CM021107.1,8,29381145,237757010,6318947,6053005,243810015,238799398
29381145_6053082,CM021107.1,8,29381145,237757010,6318947,6053082,243810092,238799475
29381145_6053176,CM021107.1,8,29381145,237757010,6318947,6053176,243810186,238799569
29381145_6053186,CM021107.1,8,29381145,237757010,6318947,6053186,243810196,238799579
29381145_6053247,CM021107.1,8,29381145,237757010,6318947,6053247,243810257,238799640
29381145_6054613,CM021107.1,8,29381145,237757010,6318947,6054613,243811623,238801006
29381145_6054658,CM021107.1,8,29381145,237757010,6318947,6054658,243811668,238801051
29381145_6054749,CM021107.1,8,29381145,237757010,6318947,6054749,243811759,238801142
29381145_6054789,CM021107.1,8,29381145,237757010,6318947,6054789,243811799,238801182
29377783_133904,CM021107.1,8,29377783,244307498,350197,133904,244441402,239430785
29377783_133910,CM021107.1,8,29377783,244307498,350197,133910,244441408,239430791
29377783_133944,CM021107.1,8,29377783,244307498,350197,133944,244441442,239430825
29379440_7027137,CM021107.1,8,29379440,237751525,7468824,7027137,244778662,239768045
29379440_7027152,CM021107.1,8,29379440,237751525,7468824,7027152,244778677,239768060
29382049_7838964,CM021107.1,8,29382049,237751526,12753296,7838964,245590490,240579873
29382049_7839463,CM021107.1,8,29382049,237751526,12753296,7839463,245590989,240580372
29382049_8451419,CM021107.1,8,29382049,237751526,12753296,8451419,246202945,241192328
29382049_8451425,CM021107.1,8,29382049,237751526,12753296,8451425,246202951,241192334
29382049_10742188,CM021107.1,8,29382049,237751526,12753296,10742188,248493714,243483097
29382049_10742317,CM021107.1,8,29382049,237751526,12753296,10742317,248493843,243483226
29382049_10743928,CM021107.1,8,29382049,237751526,12753296,10743928,248495454,243484837
29382049_10743938,CM021107.1,8,29382049,237751526,12753296,10743938,248495464,243484847
29382049_11055131,CM021107.1,8,29382049,237751526,12753296,11055131,248806657,243796040
29382049_11055246,CM021107.1,8,29382049,237751526,12753296,11055246,248806772,243796155
29382049_11055369,CM021107.1,8,29382049,237751526,12753296,11055369,248806895,243796278
29382049_11055631,CM021107.1,8,29382049,237751526,12753296,11055631,248807157,243796540
29382049_11102892,CM021107.1,8,29382049,237751526,12753296,11102892,248854418,243843801
29382049_11103970,CM021107.1,8,29382049,237751526,12753296,11103970,248855496,243844879
29382049_11645795,CM021107.1,8,29382049,237751526,12753296,11645795,249397321,244386704
29382049_11645851,CM021107.1,8,29382049,237751526,12753296,11645851,249397377,244386760
29382049_11645864,CM021107.1,8,29382049,237751526,12753296,11645864,249397390,244386773
29382049_11656635,CM021107.1,8,29382049,237751526,12753296,11656635,249408161,244397544
29382049_11657148,CM021107.1,8,29382049,237751526,12753296,11657148,249408674,244398057
29341002_8607,CM021107.1,8,29341002,253692602,37477,8607,253701209,248690592
29380586_60249,CM021107.1,8,29380586,256147696,562936,60249,256207945,251197328
29380586_60365,CM021107.1,8,29380586,256147696,562936,60365,256208061,251197444
29380586_60410,CM021107.1,8,29380586,256147696,562936,60410,256208106,251197489
29377154_84256,CM021107.1,8,29377154,256148518,495837,84256,256232774,251222157
29377154_84283,CM021107.1,8,29377154,256148518,495837,84283,256232801,251222184
29377154_84296,CM021107.1,8,29377154,256148518,495837,84296,256232814,251222197
29380586_173317,CM021107.1,8,29380586,256147696,562936,173317,256321013,251310396
29380586_173378,CM021107.1,8,29380586,256147696,562936,173378,256321074,251310457
29380586_173506,CM021107.1,8,29380586,256147696,562936,173506,256321202,251310585
29380586_173532,CM021107.1,8,29380586,256147696,562936,173532,256321228,251310611
29381767_211300,CM021107.1,8,29381767,256147693,1754824,211300,256358993,251348376
29381767_211377,CM021107.1,8,29381767,256147693,1754824,211377,256359070,251348453
29381767_220299,CM021107.1,8,29381767,256147693,1754824,220299,256367992,251357375
29381767_353666,CM021107.1,8,29381767,256147693,1754824,353666,256501359,251490742
29377154_461199,CM021107.1,8,29377154,256148518,495837,461199,256609717,251599100
29377424_516775,CM021107.1,8,29377424,256147688,1501576,516775,256664463,251653846
29377424_526081,CM021107.1,8,29377424,256147688,1501576,526081,256673769,251663152
29377424_526251,CM021107.1,8,29377424,256147688,1501576,526251,256673939,251663322
29381767_571091,CM021107.1,8,29381767,256147693,1754824,571091,256718784,251708167
29381767_611868,CM021107.1,8,29381767,256147693,1754824,611868,256759561,251748944
29381767_615552,CM021107.1,8,29381767,256147693,1754824,615552,256763245,251752628
29381767_615821,CM021107.1,8,29381767,256147693,1754824,615821,256763514,251752897
29377424_627426,CM021107.1,8,29377424,256147688,1501576,627426,256775114,251764497
29377424_920111,CM021107.1,8,29377424,256147688,1501576,920111,257067799,252057182
29379130_934959,CM021107.1,8,29379130,256147693,1252382,934959,257082652,252072035
29379130_934964,CM021107.1,8,29379130,256147693,1252382,934964,257082657,252072040
29380279_992905,CM021107.1,8,29380279,256147999,1822431,992905,257140904,252130287
29380279_992911,CM021107.1,8,29380279,256147999,1822431,992911,257140910,252130293
29380279_1004553,CM021107.1,8,29380279,256147999,1822431,1004553,257152552,252141935
29380279_1017568,CM021107.1,8,29380279,256147999,1822431,1017568,257165567,252154950
29380279_1033509,CM021107.1,8,29380279,256147999,1822431,1033509,257181508,252170891
29380279_1033576,CM021107.1,8,29380279,256147999,1822431,1033576,257181575,252170958
29380279_1033612,CM021107.1,8,29380279,256147999,1822431,1033612,257181611,252170994
29380279_1034719,CM021107.1,8,29380279,256147999,1822431,1034719,257182718,252172101
29380279_1034721,CM021107.1,8,29380279,256147999,1822431,1034721,257182720,252172103
29380279_1034780,CM021107.1,8,29380279,256147999,1822431,1034780,257182779,252172162
29380279_1034841,CM021107.1,8,29380279,256147999,1822431,1034841,257182840,252172223
29380279_1034842,CM021107.1,8,29380279,256147999,1822431,1034842,257182841,252172224
29381767_1387895,CM021107.1,8,29381767,256147693,1754824,1387895,257535588,252524971
29381767_1388797,CM021107.1,8,29381767,256147693,1754824,1388797,257536490,252525873
29381767_1388842,CM021107.1,8,29381767,256147693,1754824,1388842,257536535,252525918
29363928_144539,CM021107.1,8,29363928,257897599,241551,144539,258042138,253031521
29381996_447778,CM021107.1,8,29381996,258681318,2821352,447778,259129096,254118479
29379306_523392,CM021107.1,8,29379306,258682657,1044883,523392,259206049,254195432
29379306_523463,CM021107.1,8,29379306,258682657,1044883,523463,259206120,254195503
29381996_696275,CM021107.1,8,29381996,258681318,2821352,696275,259377593,254366976
29381996_696276,CM021107.1,8,29381996,258681318,2821352,696276,259377594,254366977
29381996_716204,CM021107.1,8,29381996,258681318,2821352,716204,259397522,254386905
29382411_755610,CM021107.1,8,29382411,258681319,1378366,755610,259436929,254426312
29381996_773498,CM021107.1,8,29381996,258681318,2821352,773498,259454816,254444199
29381996_773553,CM021107.1,8,29381996,258681318,2821352,773553,259454871,254444254
29381996_790559,CM021107.1,8,29381996,258681318,2821352,790559,259471877,254461260
29381996_790578,CM021107.1,8,29381996,258681318,2821352,790578,259471896,254461279
29381996_790747,CM021107.1,8,29381996,258681318,2821352,790747,259472065,254461448
29381996_790799,CM021107.1,8,29381996,258681318,2821352,790799,259472117,254461500
29381996_971884,CM021107.1,8,29381996,258681318,2821352,971884,259653202,254642585
29381996_971907,CM021107.1,8,29381996,258681318,2821352,971907,259653225,254642608
29381996_971956,CM021107.1,8,29381996,258681318,2821352,971956,259653274,254642657
29381996_971976,CM021107.1,8,29381996,258681318,2821352,971976,259653294,254642677
29381996_972029,CM021107.1,8,29381996,258681318,2821352,972029,259653347,254642730
29381996_972038,CM021107.1,8,29381996,258681318,2821352,972038,259653356,254642739
29382411_1323437,CM021107.1,8,29382411,258681319,1378366,1323437,260004756,254994139
29381996_1422003,CM021107.1,8,29381996,258681318,2821352,1422003,260103321,255092704
29381996_1422034,CM021107.1,8,29381996,258681318,2821352,1422034,260103352,255092735
29381996_1422043,CM021107.1,8,29381996,258681318,2821352,1422043,260103361,255092744
29381996_1422057,CM021107.1,8,29381996,258681318,2821352,1422057,260103375,255092758
29381996_1422063,CM021107.1,8,29381996,258681318,2821352,1422063,260103381,255092764
29381996_1422070,CM021107.1,8,29381996,258681318,2821352,1422070,260103388,255092771
29381996_1422071,CM021107.1,8,29381996,258681318,2821352,1422071,260103389,255092772
29381996_1422074,CM021107.1,8,29381996,258681318,2821352,1422074,260103392,255092775
29381996_1422077,CM021107.1,8,29381996,258681318,2821352,1422077,260103395,255092778
29381996_1422081,CM021107.1,8,29381996,258681318,2821352,1422081,260103399,255092782
29381996_1422088,CM021107.1,8,29381996,258681318,2821352,1422088,260103406,255092789
29381996_1422089,CM021107.1,8,29381996,258681318,2821352,1422089,260103407,255092790
29381996_1422091,CM021107.1,8,29381996,258681318,2821352,1422091,260103409,255092792
29381996_1422092,CM021107.1,8,29381996,258681318,2821352,1422092,260103410,255092793
29381996_1422115,CM021107.1,8,29381996,258681318,2821352,1422115,260103433,255092816
29381996_1824632,CM021107.1,8,29381996,258681318,2821352,1824632,260505950,255495333
29381996_1824633,CM021107.1,8,29381996,258681318,2821352,1824633,260505951,255495334
29381996_1892676,CM021107.1,8,29381996,258681318,2821352,1892676,260573994,255563377
29381996_1892687,CM021107.1,8,29381996,258681318,2821352,1892687,260574005,255563388
29381996_1892810,CM021107.1,8,29381996,258681318,2821352,1892810,260574128,255563511
29381996_1892929,CM021107.1,8,29381996,258681318,2821352,1892929,260574247,255563630
29381996_1892980,CM021107.1,8,29381996,258681318,2821352,1892980,260574298,255563681
29381996_1963812,CM021107.1,8,29381996,258681318,2821352,1963812,260645130,255634513
29381996_1963818,CM021107.1,8,29381996,258681318,2821352,1963818,260645136,255634519
29381996_1963846,CM021107.1,8,29381996,258681318,2821352,1963846,260645164,255634547
29381996_1964085,CM021107.1,8,29381996,258681318,2821352,1964085,260645403,255634786
29381996_1964182,CM021107.1,8,29381996,258681318,2821352,1964182,260645500,255634883
29381996_1964256,CM021107.1,8,29381996,258681318,2821352,1964256,260645574,255634957
29381996_1964295,CM021107.1,8,29381996,258681318,2821352,1964295,260645613,255634996
29381996_1981393,CM021107.1,8,29381996,258681318,2821352,1981393,260662711,255652094
29381996_1981701,CM021107.1,8,29381996,258681318,2821352,1981701,260663019,255652402
29381996_1981732,CM021107.1,8,29381996,258681318,2821352,1981732,260663050,255652433
29381996_1986597,CM021107.1,8,29381996,258681318,2821352,1986597,260667915,255657298
29381996_1986618,CM021107.1,8,29381996,258681318,2821352,1986618,260667936,255657319
29381996_1987336,CM021107.1,8,29381996,258681318,2821352,1987336,260668654,255658037
29381996_1987356,CM021107.1,8,29381996,258681318,2821352,1987356,260668674,255658057
29381996_1987357,CM021107.1,8,29381996,258681318,2821352,1987357,260668675,255658058
29381996_1987397,CM021107.1,8,29381996,258681318,2821352,1987397,260668715,255658098
29381996_2166776,CM021107.1,8,29381996,258681318,2821352,2166776,260848094,255837477
29381996_2348844,CM021107.1,8,29381996,258681318,2821352,2348844,261030162,256019545
29381996_2348873,CM021107.1,8,29381996,258681318,2821352,2348873,261030191,256019574
28390819_2898,CM021107.1,8,28390819,273458291,5264,2898,273461189,268450572
29338706_8987,CM021107.1,8,29338706,275843625,20676,8987,275852612,270841995
29348679_93904,CM021107.1,8,29348679,276441928,1196480,93904,276535832,271525215
29348679_94005,CM021107.1,8,29348679,276441928,1196480,94005,276535933,271525316
29348679_94011,CM021107.1,8,29348679,276441928,1196480,94011,276535939,271525322
29348679_94013,CM021107.1,8,29348679,276441928,1196480,94013,276535941,271525324
29380990_123242,CM021107.1,8,29380990,276441925,1183542,123242,276565167,271554550
29380990_128212,CM021107.1,8,29380990,276441925,1183542,128212,276570137,271559520
29380990_128284,CM021107.1,8,29380990,276441925,1183542,128284,276570209,271559592
29379266_209995,CM021107.1,8,29379266,276441913,1031451,209995,276651908,271641291
29339144_223704,CM021107.1,8,29339144,276441923,889519,223704,276665627,271655010
29339144_227100,CM021107.1,8,29339144,276441923,889519,227100,276669023,271658406
29380210_252369,CM021107.1,8,29380210,276441924,1609654,252369,276694293,271683676
29380210_259033,CM021107.1,8,29380210,276441924,1609654,259033,276700957,271690340
29380210_259597,CM021107.1,8,29380210,276441924,1609654,259597,276701521,271690904
29380210_265855,CM021107.1,8,29380210,276441924,1609654,265855,276707779,271697162
29380210_265863,CM021107.1,8,29380210,276441924,1609654,265863,276707787,271697170
29339144_452208,CM021107.1,8,29339144,276441923,889519,452208,276894131,271883514
29339144_453117,CM021107.1,8,29339144,276441923,889519,453117,276895040,271884423
29339144_453270,CM021107.1,8,29339144,276441923,889519,453270,276895193,271884576
29379066_600506,CM021107.1,8,29379066,276443595,628721,600506,277044101,272033484
29379066_600650,CM021107.1,8,29379066,276443595,628721,600650,277044245,272033628
29379066_600676,CM021107.1,8,29379066,276443595,628721,600676,277044271,272033654
29379066_600684,CM021107.1,8,29379066,276443595,628721,600684,277044279,272033662
29339144_759625,CM021107.1,8,29339144,276441923,889519,759625,277201548,272190931
29339144_759671,CM021107.1,8,29339144,276441923,889519,759671,277201594,272190977
29339144_759680,CM021107.1,8,29339144,276441923,889519,759680,277201603,272190986
29339144_759820,CM021107.1,8,29339144,276441923,889519,759820,277201743,272191126
29339144_759824,CM021107.1,8,29339144,276441923,889519,759824,277201747,272191130
29380990_778085,CM021107.1,8,29380990,276441925,1183542,778085,277220010,272209393
29381387_1140166,CM021107.1,8,29381387,276441923,1510782,1140166,277582089,272571472
29382448_2587779,CM021107.1,8,29382448,276441924,3374239,2587779,279029703,274019086
29382448_2587924,CM021107.1,8,29382448,276441924,3374239,2587924,279029848,274019231
29382448_2718369,CM021107.1,8,29382448,276441924,3374239,2718369,279160293,274149676
29382448_3063144,CM021107.1,8,29382448,276441924,3374239,3063144,279505068,274494451
29382448_3096672,CM021107.1,8,29382448,276441924,3374239,3096672,279538596,274527979
29382448_3096795,CM021107.1,8,29382448,276441924,3374239,3096795,279538719,274528102
29382448_3096884,CM021107.1,8,29382448,276441924,3374239,3096884,279538808,274528191
29382180_18166,CM021107.1,8,29382180,293579376,125302,18166,293597542,288586925
29382180_43223,CM021107.1,8,29382180,293579376,125302,43223,293622599,288611982
29382180_43227,CM021107.1,8,29382180,293579376,125302,43227,293622603,288611986
29377710_49976,CM021107.1,8,29377710,293584736,1751317,49976,293634712,288624095
29382180_68055,CM021107.1,8,29382180,293579376,125302,68055,293647431,288636814
29377312_113940,CM021107.1,8,29377312,293585023,1888292,113940,293698963,288688346
29377312_151641,CM021107.1,8,29377312,293585023,1888292,151641,293736664,288726047
29377312_151693,CM021107.1,8,29377312,293585023,1888292,151693,293736716,288726099
29378810_186631,CM021107.1,8,29378810,293584104,1291360,186631,293770735,288760118
29377312_353240,CM021107.1,8,29377312,293585023,1888292,353240,293938263,288927646
29377312_353298,CM021107.1,8,29377312,293585023,1888292,353298,293938321,288927704
29377312_353908,CM021107.1,8,29377312,293585023,1888292,353908,293938931,288928314
29377312_430546,CM021107.1,8,29377312,293585023,1888292,430546,294015569,289004952
29377312_430641,CM021107.1,8,29377312,293585023,1888292,430641,294015664,289005047
29377312_464453,CM021107.1,8,29377312,293585023,1888292,464453,294049476,289038859
29377312_464504,CM021107.1,8,29377312,293585023,1888292,464504,294049527,289038910
29377312_465371,CM021107.1,8,29377312,293585023,1888292,465371,294050394,289039777
29377312_465464,CM021107.1,8,29377312,293585023,1888292,465464,294050487,289039870
29377312_468334,CM021107.1,8,29377312,293585023,1888292,468334,294053357,289042740
29378607_550204,CM021107.1,8,29378607,293579383,900481,550204,294129587,289118970
29378810_840969,CM021107.1,8,29378810,293584104,1291360,840969,294425073,289414456
29378810_841118,CM021107.1,8,29378810,293584104,1291360,841118,294425222,289414605
29378810_841119,CM021107.1,8,29378810,293584104,1291360,841119,294425223,289414606
29378810_1048062,CM021107.1,8,29378810,293584104,1291360,1048062,294632166,289621549
29377492_1121109,CM021107.1,8,29377492,293579382,4614265,1121109,294700491,289689874
29377492_1121150,CM021107.1,8,29377492,293579382,4614265,1121150,294700532,289689915
29377492_1121272,CM021107.1,8,29377492,293579382,4614265,1121272,294700654,289690037
29377312_1883572,CM021107.1,8,29377312,293585023,1888292,1883572,295468595,290457978
29377312_1883645,CM021107.1,8,29377312,293585023,1888292,1883645,295468668,290458051
29381676_9684,CM021107.1,8,29381676,297309287,377986,9684,297318971,292308354
29379629_75299,CM021107.1,8,29379629,297308346,304161,75299,297383645,292373028
29379629_75326,CM021107.1,8,29379629,297308346,304161,75326,297383672,292373055
29379629_75328,CM021107.1,8,29379629,297308346,304161,75328,297383674,292373057
29379629_75360,CM021107.1,8,29379629,297308346,304161,75360,297383706,292373089
29379629_75370,CM021107.1,8,29379629,297308346,304161,75370,297383716,292373099
29379629_75371,CM021107.1,8,29379629,297308346,304161,75371,297383717,292373100
29379629_75377,CM021107.1,8,29379629,297308346,304161,75377,297383723,292373106
29379629_75384,CM021107.1,8,29379629,297308346,304161,75384,297383730,292373113
29379629_75394,CM021107.1,8,29379629,297308346,304161,75394,297383740,292373123
29379629_75429,CM021107.1,8,29379629,297308346,304161,75429,297383775,292373158
29379629_75442,CM021107.1,8,29379629,297308346,304161,75442,297383788,292373171
29379629_75464,CM021107.1,8,29379629,297308346,304161,75464,297383810,292373193
29352029_364639,CM021107.1,8,29352029,297308346,448072,364639,297672985,292662368
29379460_602373,CM021107.1,8,29379460,297308740,1009775,602373,297911113,292900496
29377492_4591676,CM021107.1,8,29377492,293579382,4614265,4591676,298171058,293160441
29377419_918267,CM021107.1,8,29377419,297308349,1741268,918267,298226616,293215999
29377419_919395,CM021107.1,8,29377419,297308349,1741268,919395,298227744,293217127
29377419_919492,CM021107.1,8,29377419,297308349,1741268,919492,298227841,293217224
29377419_919920,CM021107.1,8,29377419,297308349,1741268,919920,298228269,293217652
29380078_1170793,CM021107.1,8,29380078,297308346,1246153,1170793,298479139,293468522
29377419_1225434,CM021107.1,8,29377419,297308349,1741268,1225434,298533783,293523166
29377419_1569184,CM021107.1,8,29377419,297308349,1741268,1569184,298877533,293866916
29377419_1569192,CM021107.1,8,29377419,297308349,1741268,1569192,298877541,293866924
29377419_1569242,CM021107.1,8,29377419,297308349,1741268,1569242,298877591,293866974
29377419_1569243,CM021107.1,8,29377419,297308349,1741268,1569243,298877592,293866975
29377419_1569281,CM021107.1,8,29377419,297308349,1741268,1569281,298877630,293867013
29377419_1569287,CM021107.1,8,29377419,297308349,1741268,1569287,298877636,293867019
29377419_1569288,CM021107.1,8,29377419,297308349,1741268,1569288,298877637,293867020
29377737_87035,CM021107.1,8,29377737,309335536,1931823,87035,309422571,304411954
29382499_286287,CM021107.1,8,29382499,309336979,339797,286287,309623266,304612649
29382499_286294,CM021107.1,8,29382499,309336979,339797,286294,309623273,304612656
29382499_286311,CM021107.1,8,29382499,309336979,339797,286311,309623290,304612673
29382499_286329,CM021107.1,8,29382499,309336979,339797,286329,309623308,304612691
29382499_286411,CM021107.1,8,29382499,309336979,339797,286411,309623390,304612773
29377737_384015,CM021107.1,8,29377737,309335536,1931823,384015,309719551,304708934
29377737_428180,CM021107.1,8,29377737,309335536,1931823,428180,309763716,304753099
29379732_431329,CM021107.1,8,29379732,309334109,1491764,431329,309765438,304754821
29379732_431347,CM021107.1,8,29379732,309334109,1491764,431347,309765456,304754839
29379732_431367,CM021107.1,8,29379732,309334109,1491764,431367,309765476,304754859
29381336_663570,CM021107.1,8,29381336,309334508,2743449,663570,309998078,304987461
29382095_862477,CM021107.1,8,29382095,309335151,3421992,862477,310197628,305187011
29381336_915175,CM021107.1,8,29381336,309334508,2743449,915175,310249683,305239066
29381336_915216,CM021107.1,8,29381336,309334508,2743449,915216,310249724,305239107
29381336_939908,CM021107.1,8,29381336,309334508,2743449,939908,310274416,305263799
29381336_939973,CM021107.1,8,29381336,309334508,2743449,939973,310274481,305263864
29379732_967059,CM021107.1,8,29379732,309334109,1491764,967059,310301168,305290551
29379732_967135,CM021107.1,8,29379732,309334109,1491764,967135,310301244,305290627
29379732_967136,CM021107.1,8,29379732,309334109,1491764,967136,310301245,305290628
29381336_1002489,CM021107.1,8,29381336,309334508,2743449,1002489,310336997,305326380
29381336_1002702,CM021107.1,8,29381336,309334508,2743449,1002702,310337210,305326593
29381336_1004366,CM021107.1,8,29381336,309334508,2743449,1004366,310338874,305328257
29377737_1074286,CM021107.1,8,29377737,309335536,1931823,1074286,310409822,305399205
29379732_1090109,CM021107.1,8,29379732,309334109,1491764,1090109,310424218,305413601
29379732_1090126,CM021107.1,8,29379732,309334109,1491764,1090126,310424235,305413618
29379732_1090165,CM021107.1,8,29379732,309334109,1491764,1090165,310424274,305413657
29379732_1152043,CM021107.1,8,29379732,309334109,1491764,1152043,310486152,305475535
29381336_1153057,CM021107.1,8,29381336,309334508,2743449,1153057,310487565,305476948
29381336_1153058,CM021107.1,8,29381336,309334508,2743449,1153058,310487566,305476949
29381336_1153084,CM021107.1,8,29381336,309334508,2743449,1153084,310487592,305476975
29379820_1158010,CM021107.1,8,29379820,309336974,1413722,1158010,310494984,305484367
29379732_1191886,CM021107.1,8,29379732,309334109,1491764,1191886,310525995,305515378
29377737_1200785,CM021107.1,8,29377737,309335536,1931823,1200785,310536321,305525704
29377737_1200789,CM021107.1,8,29377737,309335536,1931823,1200789,310536325,305525708
29377737_1200797,CM021107.1,8,29377737,309335536,1931823,1200797,310536333,305525716
29377737_1204401,CM021107.1,8,29377737,309335536,1931823,1204401,310539937,305529320
29381336_1215056,CM021107.1,8,29381336,309334508,2743449,1215056,310549564,305538947
29381336_1263947,CM021107.1,8,29381336,309334508,2743449,1263947,310598455,305587838
29381336_1264045,CM021107.1,8,29381336,309334508,2743449,1264045,310598553,305587936
29381336_1264051,CM021107.1,8,29381336,309334508,2743449,1264051,310598559,305587942
29377737_1268517,CM021107.1,8,29377737,309335536,1931823,1268517,310604053,305593436
29377737_1268587,CM021107.1,8,29377737,309335536,1931823,1268587,310604123,305593506
29377737_1268595,CM021107.1,8,29377737,309335536,1931823,1268595,310604131,305593514
29377737_1268610,CM021107.1,8,29377737,309335536,1931823,1268610,310604146,305593529
29377737_1268639,CM021107.1,8,29377737,309335536,1931823,1268639,310604175,305593558
29377737_1268640,CM021107.1,8,29377737,309335536,1931823,1268640,310604176,305593559
29377737_1268655,CM021107.1,8,29377737,309335536,1931823,1268655,310604191,305593574
29379820_1276709,CM021107.1,8,29379820,309336974,1413722,1276709,310613683,305603066
29379820_1337065,CM021107.1,8,29379820,309336974,1413722,1337065,310674039,305663422
29379820_1337168,CM021107.1,8,29379820,309336974,1413722,1337168,310674142,305663525
29381336_1390320,CM021107.1,8,29381336,309334508,2743449,1390320,310724828,305714211
29381336_1390393,CM021107.1,8,29381336,309334508,2743449,1390393,310724901,305714284
29377737_1606841,CM021107.1,8,29377737,309335536,1931823,1606841,310942377,305931760
29377737_1607621,CM021107.1,8,29377737,309335536,1931823,1607621,310943157,305932540
29377737_1608080,CM021107.1,8,29377737,309335536,1931823,1608080,310943616,305932999
29381336_1814382,CM021107.1,8,29381336,309334508,2743449,1814382,311148890,306138273
29381336_1814491,CM021107.1,8,29381336,309334508,2743449,1814491,311148999,306138382
29381336_1814627,CM021107.1,8,29381336,309334508,2743449,1814627,311149135,306138518
29381336_1839007,CM021107.1,8,29381336,309334508,2743449,1839007,311173515,306162898
29381336_1839054,CM021107.1,8,29381336,309334508,2743449,1839054,311173562,306162945
29381336_1839061,CM021107.1,8,29381336,309334508,2743449,1839061,311173569,306162952
29381336_1937929,CM021107.1,8,29381336,309334508,2743449,1937929,311272437,306261820
29381336_1937966,CM021107.1,8,29381336,309334508,2743449,1937966,311272474,306261857
29381336_1937968,CM021107.1,8,29381336,309334508,2743449,1937968,311272476,306261859
29381336_1937969,CM021107.1,8,29381336,309334508,2743449,1937969,311272477,306261860
29381336_1938036,CM021107.1,8,29381336,309334508,2743449,1938036,311272544,306261927
29381336_1938097,CM021107.1,8,29381336,309334508,2743449,1938097,311272605,306261988
29381336_1938154,CM021107.1,8,29381336,309334508,2743449,1938154,311272662,306262045
29381336_1940262,CM021107.1,8,29381336,309334508,2743449,1940262,311274770,306264153
29381336_1940270,CM021107.1,8,29381336,309334508,2743449,1940270,311274778,306264161
29381336_1974164,CM021107.1,8,29381336,309334508,2743449,1974164,311308672,306298055
29381336_1974195,CM021107.1,8,29381336,309334508,2743449,1974195,311308703,306298086
29381336_1974804,CM021107.1,8,29381336,309334508,2743449,1974804,311309312,306298695
29379028_1995774,CM021107.1,8,29379028,309335247,4826607,1995774,311331021,306320404
29379028_1995845,CM021107.1,8,29379028,309335247,4826607,1995845,311331092,306320475
29379028_2035467,CM021107.1,8,29379028,309335247,4826607,2035467,311370714,306360097
29379028_2037475,CM021107.1,8,29379028,309335247,4826607,2037475,311372722,306362105
29381336_2079209,CM021107.1,8,29381336,309334508,2743449,2079209,311413717,306403100
29381336_2165146,CM021107.1,8,29381336,309334508,2743449,2165146,311499654,306489037
29381336_2166528,CM021107.1,8,29381336,309334508,2743449,2166528,311501036,306490419
29381336_2212597,CM021107.1,8,29381336,309334508,2743449,2212597,311547105,306536488
29381336_2212619,CM021107.1,8,29381336,309334508,2743449,2212619,311547127,306536510
29381336_2212688,CM021107.1,8,29381336,309334508,2743449,2212688,311547196,306536579
29381336_2212867,CM021107.1,8,29381336,309334508,2743449,2212867,311547375,306536758
29379028_2230319,CM021107.1,8,29379028,309335247,4826607,2230319,311565566,306554949
29379028_2555393,CM021107.1,8,29379028,309335247,4826607,2555393,311890640,306880023
29379028_2555421,CM021107.1,8,29379028,309335247,4826607,2555421,311890668,306880051
29379028_2555478,CM021107.1,8,29379028,309335247,4826607,2555478,311890725,306880108
29379028_2555608,CM021107.1,8,29379028,309335247,4826607,2555608,311890855,306880238
29379028_2555829,CM021107.1,8,29379028,309335247,4826607,2555829,311891076,306880459
29379028_2555883,CM021107.1,8,29379028,309335247,4826607,2555883,311891130,306880513
29379028_2559261,CM021107.1,8,29379028,309335247,4826607,2559261,311894508,306883891
29379028_2559308,CM021107.1,8,29379028,309335247,4826607,2559308,311894555,306883938
29379028_2559544,CM021107.1,8,29379028,309335247,4826607,2559544,311894791,306884174
29379028_3559674,CM021107.1,8,29379028,309335247,4826607,3559674,312894921,307884304
29379028_3946652,CM021107.1,8,29379028,309335247,4826607,3946652,313281899,308271282
29379028_3949126,CM021107.1,8,29379028,309335247,4826607,3949126,313284373,308273756
29381009_129737,CM021107.1,8,29381009,313402331,1360496,129737,313532068,308521451
29381009_130256,CM021107.1,8,29381009,313402331,1360496,130256,313532587,308521970
29381009_130421,CM021107.1,8,29381009,313402331,1360496,130421,313532752,308522135
29381009_130522,CM021107.1,8,29381009,313402331,1360496,130522,313532853,308522236
29381009_130566,CM021107.1,8,29381009,313402331,1360496,130566,313532897,308522280
29381455_207162,CM021107.1,8,29381455,313402328,607702,207162,313609490,308598873
29381455_207251,CM021107.1,8,29381455,313402328,607702,207251,313609579,308598962
29381455_207258,CM021107.1,8,29381455,313402328,607702,207258,313609586,308598969
29377532_224590,CM021107.1,8,29377532,313402392,975029,224590,313626982,308616365
29377532_224675,CM021107.1,8,29377532,313402392,975029,224675,313627067,308616450
29377532_224799,CM021107.1,8,29377532,313402392,975029,224799,313627191,308616574
29377532_224896,CM021107.1,8,29377532,313402392,975029,224896,313627288,308616671
29377532_224912,CM021107.1,8,29377532,313402392,975029,224912,313627304,308616687
29381009_320559,CM021107.1,8,29381009,313402331,1360496,320559,313722890,308712273
29381009_320584,CM021107.1,8,29381009,313402331,1360496,320584,313722915,308712298
29381009_325928,CM021107.1,8,29381009,313402331,1360496,325928,313728259,308717642
29377532_328313,CM021107.1,8,29377532,313402392,975029,328313,313730705,308720088
29377532_328386,CM021107.1,8,29377532,313402392,975029,328386,313730778,308720161
29378645_360209,CM021107.1,8,29378645,313402328,1103396,360209,313762537,308751920
29378645_360242,CM021107.1,8,29378645,313402328,1103396,360242,313762570,308751953
29378645_360243,CM021107.1,8,29378645,313402328,1103396,360243,313762571,308751954
29378645_360245,CM021107.1,8,29378645,313402328,1103396,360245,313762573,308751956
29378645_360266,CM021107.1,8,29378645,313402328,1103396,360266,313762594,308751977
29378645_360281,CM021107.1,8,29378645,313402328,1103396,360281,313762609,308751992
29380945_452411,CM021107.1,8,29380945,313402328,2513212,452411,313854739,308844122
29380945_452477,CM021107.1,8,29380945,313402328,2513212,452477,313854805,308844188
29380945_456441,CM021107.1,8,29380945,313402328,2513212,456441,313858769,308848152
29381955_464006,CM021107.1,8,29381955,313402328,4782747,464006,313866334,308855717
29381273_481718,CM021107.1,8,29381273,313402328,644604,481718,313884046,308873429
29380155_514025,CM021107.1,8,29380155,313402328,3005504,514025,313916353,308905736
29380155_514072,CM021107.1,8,29380155,313402328,3005504,514072,313916400,308905783
29380155_514210,CM021107.1,8,29380155,313402328,3005504,514210,313916538,308905921
29380155_514240,CM021107.1,8,29380155,313402328,3005504,514240,313916568,308905951
29377532_514907,CM021107.1,8,29377532,313402392,975029,514907,313917299,308906682
29377532_514965,CM021107.1,8,29377532,313402392,975029,514965,313917357,308906740
29377532_514993,CM021107.1,8,29377532,313402392,975029,514993,313917385,308906768
29377532_515006,CM021107.1,8,29377532,313402392,975029,515006,313917398,308906781
29377532_515353,CM021107.1,8,29377532,313402392,975029,515353,313917745,308907128
29377532_515413,CM021107.1,8,29377532,313402392,975029,515413,313917805,308907188
29377532_515449,CM021107.1,8,29377532,313402392,975029,515449,313917841,308907224
29377532_515631,CM021107.1,8,29377532,313402392,975029,515631,313918023,308907406
29381955_530341,CM021107.1,8,29381955,313402328,4782747,530341,313932669,308922052
29380155_558350,CM021107.1,8,29380155,313402328,3005504,558350,313960678,308950061
29380155_574201,CM021107.1,8,29380155,313402328,3005504,574201,313976529,308965912
29380155_574260,CM021107.1,8,29380155,313402328,3005504,574260,313976588,308965971
29378940_676763,CM021107.1,8,29378940,313402331,3018488,676763,314079094,309068477
29378940_676772,CM021107.1,8,29378940,313402331,3018488,676772,314079103,309068486
29378940_676851,CM021107.1,8,29378940,313402331,3018488,676851,314079182,309068565
29378940_676855,CM021107.1,8,29378940,313402331,3018488,676855,314079186,309068569
29378940_676862,CM021107.1,8,29378940,313402331,3018488,676862,314079193,309068576
29380848_785027,CM021107.1,8,29380848,313402331,876556,785027,314187358,309176741
29380848_785063,CM021107.1,8,29380848,313402331,876556,785063,314187394,309176777
29380848_785109,CM021107.1,8,29380848,313402331,876556,785109,314187440,309176823
29380848_785118,CM021107.1,8,29380848,313402331,876556,785118,314187449,309176832
29380848_785131,CM021107.1,8,29380848,313402331,876556,785131,314187462,309176845
29380848_785166,CM021107.1,8,29380848,313402331,876556,785166,314187497,309176880
29380848_785315,CM021107.1,8,29380848,313402331,876556,785315,314187646,309177029
29380848_785352,CM021107.1,8,29380848,313402331,876556,785352,314187683,309177066
29378940_788019,CM021107.1,8,29378940,313402331,3018488,788019,314190350,309179733
29380945_816786,CM021107.1,8,29380945,313402328,2513212,816786,314219114,309208497
29378940_929811,CM021107.1,8,29378940,313402331,3018488,929811,314332142,309321525
29378940_929854,CM021107.1,8,29378940,313402331,3018488,929854,314332185,309321568
29378940_929857,CM021107.1,8,29378940,313402331,3018488,929857,314332188,309321571
29378940_929863,CM021107.1,8,29378940,313402331,3018488,929863,314332194,309321577
29378940_929904,CM021107.1,8,29378940,313402331,3018488,929904,314332235,309321618
29378645_988945,CM021107.1,8,29378645,313402328,1103396,988945,314391273,309380656
29380155_992609,CM021107.1,8,29380155,313402328,3005504,992609,314394937,309384320
29380155_1015888,CM021107.1,8,29380155,313402328,3005504,1015888,314418216,309407599
29380155_1015923,CM021107.1,8,29380155,313402328,3005504,1015923,314418251,309407634
29380155_1015936,CM021107.1,8,29380155,313402328,3005504,1015936,314418264,309407647
29380155_1015938,CM021107.1,8,29380155,313402328,3005504,1015938,314418266,309407649
29380155_1015947,CM021107.1,8,29380155,313402328,3005504,1015947,314418275,309407658
29380155_1015979,CM021107.1,8,29380155,313402328,3005504,1015979,314418307,309407690
29380155_1082974,CM021107.1,8,29380155,313402328,3005504,1082974,314485302,309474685
29380155_1083648,CM021107.1,8,29380155,313402328,3005504,1083648,314485976,309475359
29380155_1217064,CM021107.1,8,29380155,313402328,3005504,1217064,314619392,309608775
29380543_1363262,CM021107.1,8,29380543,313402329,2538208,1363262,314765591,309754974
29380155_1422250,CM021107.1,8,29380155,313402328,3005504,1422250,314824578,309813961
29380155_1422299,CM021107.1,8,29380155,313402328,3005504,1422299,314824627,309814010
29380155_1422301,CM021107.1,8,29380155,313402328,3005504,1422301,314824629,309814012
29380155_1422349,CM021107.1,8,29380155,313402328,3005504,1422349,314824677,309814060
29378940_1660211,CM021107.1,8,29378940,313402331,3018488,1660211,315062542,310051925
29378940_1660226,CM021107.1,8,29378940,313402331,3018488,1660226,315062557,310051940
29378940_1660246,CM021107.1,8,29378940,313402331,3018488,1660246,315062577,310051960
29378940_1660314,CM021107.1,8,29378940,313402331,3018488,1660314,315062645,310052028
29378940_1660327,CM021107.1,8,29378940,313402331,3018488,1660327,315062658,310052041
29378940_1660335,CM021107.1,8,29378940,313402331,3018488,1660335,315062666,310052049
29378940_1660386,CM021107.1,8,29378940,313402331,3018488,1660386,315062717,310052100
29380543_1684173,CM021107.1,8,29380543,313402329,2538208,1684173,315086502,310075885
29380155_1705359,CM021107.1,8,29380155,313402328,3005504,1705359,315107687,310097070
29380155_1705432,CM021107.1,8,29380155,313402328,3005504,1705432,315107760,310097143
29380155_1705468,CM021107.1,8,29380155,313402328,3005504,1705468,315107796,310097179
29377750_1729481,CM021107.1,8,29377750,313402329,1891752,1729481,315131810,310121193
29377750_1729569,CM021107.1,8,29377750,313402329,1891752,1729569,315131898,310121281
29377750_1729669,CM021107.1,8,29377750,313402329,1891752,1729669,315131998,310121381
29380945_1731334,CM021107.1,8,29380945,313402328,2513212,1731334,315133662,310123045
29377750_1760786,CM021107.1,8,29377750,313402329,1891752,1760786,315163115,310152498
29380155_1775754,CM021107.1,8,29380155,313402328,3005504,1775754,315178082,310167465
29380155_1776123,CM021107.1,8,29380155,313402328,3005504,1776123,315178451,310167834
29377750_1842952,CM021107.1,8,29377750,313402329,1891752,1842952,315245281,310234664
29377750_1843014,CM021107.1,8,29377750,313402329,1891752,1843014,315245343,310234726
29377750_1843076,CM021107.1,8,29377750,313402329,1891752,1843076,315245405,310234788
29377750_1867987,CM021107.1,8,29377750,313402329,1891752,1867987,315270316,310259699
29377750_1871466,CM021107.1,8,29377750,313402329,1891752,1871466,315273795,310263178
29377750_1871547,CM021107.1,8,29377750,313402329,1891752,1871547,315273876,310263259
29380155_1971838,CM021107.1,8,29380155,313402328,3005504,1971838,315374166,310363549
29378940_2073723,CM021107.1,8,29378940,313402331,3018488,2073723,315476054,310465437
29378940_2073821,CM021107.1,8,29378940,313402331,3018488,2073821,315476152,310465535
29377198_2081916,CM021107.1,8,29377198,313402585,2965814,2081916,315484501,310473884
29377198_2081962,CM021107.1,8,29377198,313402585,2965814,2081962,315484547,310473930
29377198_2081977,CM021107.1,8,29377198,313402585,2965814,2081977,315484562,310473945
29378940_2207023,CM021107.1,8,29378940,313402331,3018488,2207023,315609354,310598737
29378940_2244005,CM021107.1,8,29378940,313402331,3018488,2244005,315646336,310635719
29378940_2447671,CM021107.1,8,29378940,313402331,3018488,2447671,315850002,310839385
29378940_2685690,CM021107.1,8,29378940,313402331,3018488,2685690,316088021,311077404
29378940_2685710,CM021107.1,8,29378940,313402331,3018488,2685710,316088041,311077424
29378940_2685802,CM021107.1,8,29378940,313402331,3018488,2685802,316088133,311077516
29381955_3093903,CM021107.1,8,29381955,313402328,4782747,3093903,316496231,311485614
29381955_3093934,CM021107.1,8,29381955,313402328,4782747,3093934,316496262,311485645
29381955_3094018,CM021107.1,8,29381955,313402328,4782747,3094018,316496346,311485729
29381955_3094029,CM021107.1,8,29381955,313402328,4782747,3094029,316496357,311485740
29381955_3718208,CM021107.1,8,29381955,313402328,4782747,3718208,317120536,312109919
29381955_3736305,CM021107.1,8,29381955,313402328,4782747,3736305,317138633,312128016
29381955_3736487,CM021107.1,8,29381955,313402328,4782747,3736487,317138815,312128198
29381955_3763907,CM021107.1,8,29381955,313402328,4782747,3763907,317166235,312155618
29381955_4400544,CM021107.1,8,29381955,313402328,4782747,4400544,317802872,312792255
29381955_4401630,CM021107.1,8,29381955,313402328,4782747,4401630,317803958,312793341
29377744_9710,CM021107.1,8,29377744,335734533,1159802,9710,335744243,330733626
29377744_197085,CM021107.1,8,29377744,335734533,1159802,197085,335931618,330921001
29377744_1089228,CM021107.1,8,29377744,335734533,1159802,1089228,336823761,331813144
29377744_1089314,CM021107.1,8,29377744,335734533,1159802,1089314,336823847,331813230
29340795_12114,CM021107.1,8,29340795,346222741,44587,12114,346234855,341224238
29380663_38523,CM021107.1,8,29380663,346222748,647093,38523,346261271,341250654
29380663_38601,CM021107.1,8,29380663,346222748,647093,38601,346261349,341250732
29380663_54425,CM021107.1,8,29380663,346222748,647093,54425,346277173,341266556
29380663_110298,CM021107.1,8,29380663,346222748,647093,110298,346333046,341322429
29380663_251546,CM021107.1,8,29380663,346222748,647093,251546,346474294,341463677
29380663_356430,CM021107.1,8,29380663,346222748,647093,356430,346579178,341568561
29382272_239,CM021107.1,8,29382272,346659039,2345721,239,346659278,341648661
29382272_586,CM021107.1,8,29382272,346659039,2345721,586,346659625,341649008
29381332_3025,CM021107.1,8,29381332,346657436,2392716,3025,346660461,341649844
29381332_6371,CM021107.1,8,29381332,346657436,2392716,6371,346663807,341653190
29381987_95764,CM021107.1,8,29381987,346638776,624007,95764,346734540,341723923
29380963_12943,CM021107.1,8,29380963,346820705,1073670,12943,346833648,341823031
29380963_12997,CM021107.1,8,29380963,346820705,1073670,12997,346833702,341823085
29380963_13156,CM021107.1,8,29380963,346820705,1073670,13156,346833861,341823244
29380963_13180,CM021107.1,8,29380963,346820705,1073670,13180,346833885,341823268
29342508_8626,CM021107.1,8,29342508,346825342,57967,8626,346833968,341823351
29342508_8686,CM021107.1,8,29342508,346825342,57967,8686,346834028,341823411
29342508_8693,CM021107.1,8,29342508,346825342,57967,8693,346834035,341823418
29342508_8716,CM021107.1,8,29342508,346825342,57967,8716,346834058,341823441
29378535_201395,CM021107.1,8,29378535,346638775,894819,201395,346840170,341829553
29378535_201401,CM021107.1,8,29378535,346638775,894819,201401,346840176,341829559
29378535_201407,CM021107.1,8,29378535,346638775,894819,201407,346840182,341829565
29378535_201408,CM021107.1,8,29378535,346638775,894819,201408,346840183,341829566
29378535_201416,CM021107.1,8,29378535,346638775,894819,201416,346840191,341829574
29378535_201433,CM021107.1,8,29378535,346638775,894819,201433,346840208,341829591
29378535_201441,CM021107.1,8,29378535,346638775,894819,201441,346840216,341829599
29378535_201449,CM021107.1,8,29378535,346638775,894819,201449,346840224,341829607
29379718_36119,CM021107.1,8,29379718,346820708,1210800,36119,346856827,341846210
29379718_36189,CM021107.1,8,29379718,346820708,1210800,36189,346856897,341846280
29379718_36374,CM021107.1,8,29379718,346820708,1210800,36374,346857082,341846465
29380963_55374,CM021107.1,8,29380963,346820705,1073670,55374,346876079,341865462
29382179_146202,CM021107.1,8,29382179,346823752,598674,146202,346969954,341959337
29382179_146217,CM021107.1,8,29382179,346823752,598674,146217,346969969,341959352
29377062_388512,CM021107.1,8,29377062,346638779,818288,388512,347027291,342016674
29380963_249130,CM021107.1,8,29380963,346820705,1073670,249130,347069835,342059218
29380963_249149,CM021107.1,8,29380963,346820705,1073670,249149,347069854,342059237
29380963_249150,CM021107.1,8,29380963,346820705,1073670,249150,347069855,342059238
29380963_249227,CM021107.1,8,29380963,346820705,1073670,249227,347069932,342059315
29380963_249231,CM021107.1,8,29380963,346820705,1073670,249231,347069936,342059319
29380963_249236,CM021107.1,8,29380963,346820705,1073670,249236,347069941,342059324
29380793_440364,CM021107.1,8,29380793,346656811,7906560,440364,347097175,342086558
29380793_440466,CM021107.1,8,29380793,346656811,7906560,440466,347097277,342086660
29380793_440687,CM021107.1,8,29380793,346656811,7906560,440687,347097498,342086881
29380793_440731,CM021107.1,8,29380793,346656811,7906560,440731,347097542,342086925
29380793_440752,CM021107.1,8,29380793,346656811,7906560,440752,347097563,342086946
29380793_440755,CM021107.1,8,29380793,346656811,7906560,440755,347097566,342086949
29382272_449240,CM021107.1,8,29382272,346659039,2345721,449240,347108279,342097662
29382272_449276,CM021107.1,8,29382272,346659039,2345721,449276,347108315,342097698
29382272_449280,CM021107.1,8,29382272,346659039,2345721,449280,347108319,342097702
29382179_315767,CM021107.1,8,29382179,346823752,598674,315767,347139519,342128902
29377929_511507,CM021107.1,8,29377929,346638776,2364781,511507,347150283,342139666
29377929_511633,CM021107.1,8,29377929,346638776,2364781,511633,347150409,342139792
29378222_338734,CM021107.1,8,29378222,346820706,1443971,338734,347159440,342148823
29378222_339234,CM021107.1,8,29378222,346820706,1443971,339234,347159940,342149323
29381189_553318,CM021107.1,8,29381189,346653286,14650609,553318,347206604,342195987
29379718_397948,CM021107.1,8,29379718,346820708,1210800,397948,347218656,342208039
29381189_597026,CM021107.1,8,29381189,346653286,14650609,597026,347250312,342239695
29377885_663562,CM021107.1,8,29377885,346654076,3299685,663562,347317638,342307021
29377885_666498,CM021107.1,8,29377885,346654076,3299685,666498,347320574,342309957
29377885_666531,CM021107.1,8,29377885,346654076,3299685,666531,347320607,342309990
29377885_666536,CM021107.1,8,29377885,346654076,3299685,666536,347320612,342309995
29377885_666710,CM021107.1,8,29377885,346654076,3299685,666710,347320786,342310169
29380357_690572,CM021107.1,8,29380357,346638775,3075693,690572,347329347,342318730
29380357_690679,CM021107.1,8,29380357,346638775,3075693,690679,347329454,342318837
29382179_523034,CM021107.1,8,29382179,346823752,598674,523034,347346786,342336169
29382179_524830,CM021107.1,8,29382179,346823752,598674,524830,347348582,342337965
29382179_524835,CM021107.1,8,29382179,346823752,598674,524835,347348587,342337970
29382179_525159,CM021107.1,8,29382179,346823752,598674,525159,347348911,342338294
29381131_750358,CM021107.1,8,29381131,346656833,889960,750358,347407191,342396574
29342934_613031,CM021107.1,8,29342934,346820706,1076835,613031,347433737,342423120
29342934_613157,CM021107.1,8,29342934,346820706,1076835,613157,347433863,342423246
29379718_665781,CM021107.1,8,29379718,346820708,1210800,665781,347486489,342475872
29382272_851194,CM021107.1,8,29382272,346659039,2345721,851194,347510233,342499616
29378222_707232,CM021107.1,8,29378222,346820706,1443971,707232,347527938,342517321
29378222_707244,CM021107.1,8,29378222,346820706,1443971,707244,347527950,342517333
29378222_709311,CM021107.1,8,29378222,346820706,1443971,709311,347530017,342519400
29378222_709414,CM021107.1,8,29378222,346820706,1443971,709414,347530120,342519503
29380963_719670,CM021107.1,8,29380963,346820705,1073670,719670,347540375,342529758
29378728_734953,CM021107.1,8,29378728,346820704,2764901,734953,347555657,342545040
29377860_925280,CM021107.1,8,29377860,346638772,2914276,925280,347564052,342553435
29342934_777367,CM021107.1,8,29342934,346820706,1076835,777367,347598073,342587456
29342934_777370,CM021107.1,8,29342934,346820706,1076835,777370,347598076,342587459
29342934_777405,CM021107.1,8,29342934,346820706,1076835,777405,347598111,342587494
29342934_777412,CM021107.1,8,29342934,346820706,1076835,777412,347598118,342587501
29381016_784740,CM021107.1,8,29381016,346820706,1080873,784740,347605446,342594829
29381016_784751,CM021107.1,8,29381016,346820706,1080873,784751,347605457,342594840
29381016_784756,CM021107.1,8,29381016,346820706,1080873,784756,347605462,342594845
29381016_784764,CM021107.1,8,29381016,346820706,1080873,784764,347605470,342594853
29381016_784766,CM021107.1,8,29381016,346820706,1080873,784766,347605472,342594855
29381016_784770,CM021107.1,8,29381016,346820706,1080873,784770,347605476,342594859
29381016_784781,CM021107.1,8,29381016,346820706,1080873,784781,347605487,342594870
29381016_784789,CM021107.1,8,29381016,346820706,1080873,784789,347605495,342594878
29381016_784818,CM021107.1,8,29381016,346820706,1080873,784818,347605524,342594907
29380963_802712,CM021107.1,8,29380963,346820705,1073670,802712,347623417,342612800
29378167_995214,CM021107.1,8,29378167,346638778,1621074,995214,347633992,342623375
29378167_995232,CM021107.1,8,29378167,346638778,1621074,995232,347634010,342623393
29378167_995308,CM021107.1,8,29378167,346638778,1621074,995308,347634086,342623469
29380963_857170,CM021107.1,8,29380963,346820705,1073670,857170,347677875,342667258
29380963_857221,CM021107.1,8,29380963,346820705,1073670,857221,347677926,342667309
29378167_1083525,CM021107.1,8,29378167,346638778,1621074,1083525,347722303,342711686
29378167_1152593,CM021107.1,8,29378167,346638778,1621074,1152593,347791371,342780754
29382475_1177567,CM021107.1,8,29382475,346820708,5956856,1177567,347998275,342987658
29379718_1209368,CM021107.1,8,29379718,346820708,1210800,1209368,348030076,343019459
29379718_1209377,CM021107.1,8,29379718,346820708,1210800,1209377,348030085,343019468
29379283_1401117,CM021107.1,8,29379283,346651358,1782400,1401117,348052475,343041858
29380793_1405086,CM021107.1,8,29380793,346656811,7906560,1405086,348061897,343051280
29380793_1405092,CM021107.1,8,29380793,346656811,7906560,1405092,348061903,343051286
29380793_1405145,CM021107.1,8,29380793,346656811,7906560,1405145,348061956,343051339
29380793_1405146,CM021107.1,8,29380793,346656811,7906560,1405146,348061957,343051340
29378429_1259562,CM021107.1,8,29378429,346821029,3408269,1259562,348080591,343069974
29380128_1458623,CM021107.1,8,29380128,346638775,1564281,1458623,348097398,343086781
29380128_1460030,CM021107.1,8,29380128,346638775,1564281,1460030,348098805,343088188
29378461_1597450,CM021107.1,8,29378461,346820708,5266775,1597450,348418158,343407541
29378461_1598549,CM021107.1,8,29378461,346820708,5266775,1598549,348419257,343408640
29378461_1598608,CM021107.1,8,29378461,346820708,5266775,1598608,348419316,343408699
29378461_1598649,CM021107.1,8,29378461,346820708,5266775,1598649,348419357,343408740
29378461_1599602,CM021107.1,8,29378461,346820708,5266775,1599602,348420310,343409693
29378461_1599626,CM021107.1,8,29378461,346820708,5266775,1599626,348420334,343409717
29378461_1599627,CM021107.1,8,29378461,346820708,5266775,1599627,348420335,343409718
29381332_1793522,CM021107.1,8,29381332,346657436,2392716,1793522,348450958,343440341
29381332_1793536,CM021107.1,8,29381332,346657436,2392716,1793536,348450972,343440355
29381332_1793787,CM021107.1,8,29381332,346657436,2392716,1793787,348451223,343440606
29381332_1793846,CM021107.1,8,29381332,346657436,2392716,1793846,348451282,343440665
29382475_1911374,CM021107.1,8,29382475,346820708,5956856,1911374,348732082,343721465
29382475_1911375,CM021107.1,8,29382475,346820708,5956856,1911375,348732083,343721466
29382475_1911441,CM021107.1,8,29382475,346820708,5956856,1911441,348732149,343721532
29382475_1911489,CM021107.1,8,29382475,346820708,5956856,1911489,348732197,343721580
29382475_1911492,CM021107.1,8,29382475,346820708,5956856,1911492,348732200,343721583
29382475_1911527,CM021107.1,8,29382475,346820708,5956856,1911527,348732235,343721618
29382475_1911531,CM021107.1,8,29382475,346820708,5956856,1911531,348732239,343721622
29382475_1911592,CM021107.1,8,29382475,346820708,5956856,1911592,348732300,343721683
29382475_1961045,CM021107.1,8,29382475,346820708,5956856,1961045,348781753,343771136
29382475_1961059,CM021107.1,8,29382475,346820708,5956856,1961059,348781767,343771150
29378461_1993745,CM021107.1,8,29378461,346820708,5266775,1993745,348814453,343803836
29377860_2232653,CM021107.1,8,29377860,346638772,2914276,2232653,348871425,343860808
29377860_2232787,CM021107.1,8,29377860,346638772,2914276,2232787,348871559,343860942
29378461_2058936,CM021107.1,8,29378461,346820708,5266775,2058936,348879644,343869027
29378461_2058963,CM021107.1,8,29378461,346820708,5266775,2058963,348879671,343869054
29378461_2058991,CM021107.1,8,29378461,346820708,5266775,2058991,348879699,343869082
29378461_2059007,CM021107.1,8,29378461,346820708,5266775,2059007,348879715,343869098
29378461_2059011,CM021107.1,8,29378461,346820708,5266775,2059011,348879719,343869102
29381332_2233961,CM021107.1,8,29381332,346657436,2392716,2233961,348891397,343880780
29381332_2297781,CM021107.1,8,29381332,346657436,2392716,2297781,348955217,343944600
29381332_2297816,CM021107.1,8,29381332,346657436,2392716,2297816,348955252,343944635
29381332_2323005,CM021107.1,8,29381332,346657436,2392716,2323005,348980441,343969824
29381332_2323027,CM021107.1,8,29381332,346657436,2392716,2323027,348980463,343969846
29382475_2272503,CM021107.1,8,29382475,346820708,5956856,2272503,349093211,344082594
29382475_2272530,CM021107.1,8,29382475,346820708,5956856,2272530,349093238,344082621
29382475_2272580,CM021107.1,8,29382475,346820708,5956856,2272580,349093288,344082671
29382475_2272581,CM021107.1,8,29382475,346820708,5956856,2272581,349093289,344082672
29382475_2272603,CM021107.1,8,29382475,346820708,5956856,2272603,349093311,344082694
29382475_2272627,CM021107.1,8,29382475,346820708,5956856,2272627,349093335,344082718
29382475_2332051,CM021107.1,8,29382475,346820708,5956856,2332051,349152759,344142142
29382475_2332052,CM021107.1,8,29382475,346820708,5956856,2332052,349152760,344142143
29382475_2332073,CM021107.1,8,29382475,346820708,5956856,2332073,349152781,344142164
29382475_2332161,CM021107.1,8,29382475,346820708,5956856,2332161,349152869,344142252
29382475_2332429,CM021107.1,8,29382475,346820708,5956856,2332429,349153137,344142520
29382475_2332437,CM021107.1,8,29382475,346820708,5956856,2332437,349153145,344142528
29382475_2332513,CM021107.1,8,29382475,346820708,5956856,2332513,349153221,344142604
29382475_2332549,CM021107.1,8,29382475,346820708,5956856,2332549,349153257,344142640
29382475_2332643,CM021107.1,8,29382475,346820708,5956856,2332643,349153351,344142734
29382475_2332679,CM021107.1,8,29382475,346820708,5956856,2332679,349153387,344142770
29382475_2332816,CM021107.1,8,29382475,346820708,5956856,2332816,349153524,344142907
29378728_2348649,CM021107.1,8,29378728,346820704,2764901,2348649,349169353,344158736
29382475_2376151,CM021107.1,8,29382475,346820708,5956856,2376151,349196859,344186242
29378461_2390263,CM021107.1,8,29378461,346820708,5266775,2390263,349210971,344200354
29378728_2394310,CM021107.1,8,29378728,346820704,2764901,2394310,349215014,344204397
29378728_2394350,CM021107.1,8,29378728,346820704,2764901,2394350,349215054,344204437
29378461_2394671,CM021107.1,8,29378461,346820708,5266775,2394671,349215379,344204762
29378728_2394741,CM021107.1,8,29378728,346820704,2764901,2394741,349215445,344204828
29380793_2741193,CM021107.1,8,29380793,346656811,7906560,2741193,349398004,344387387
29380793_2748951,CM021107.1,8,29380793,346656811,7906560,2748951,349405762,344395145
29380793_2748970,CM021107.1,8,29380793,346656811,7906560,2748970,349405781,344395164
29380793_2750974,CM021107.1,8,29380793,346656811,7906560,2750974,349407785,344397168
29382475_2743832,CM021107.1,8,29382475,346820708,5956856,2743832,349564540,344553923
29382475_2743855,CM021107.1,8,29382475,346820708,5956856,2743855,349564563,344553946
29382475_2832400,CM021107.1,8,29382475,346820708,5956856,2832400,349653108,344642491
29382475_2832413,CM021107.1,8,29382475,346820708,5956856,2832413,349653121,344642504
29382475_2832433,CM021107.1,8,29382475,346820708,5956856,2832433,349653141,344642524
29382475_2846933,CM021107.1,8,29382475,346820708,5956856,2846933,349667641,344657024
29382475_2847064,CM021107.1,8,29382475,346820708,5956856,2847064,349667772,344657155
29382475_2847153,CM021107.1,8,29382475,346820708,5956856,2847153,349667861,344657244
29382475_2847323,CM021107.1,8,29382475,346820708,5956856,2847323,349668031,344657414
29382475_2847949,CM021107.1,8,29382475,346820708,5956856,2847949,349668657,344658040
29382475_2848011,CM021107.1,8,29382475,346820708,5956856,2848011,349668719,344658102
29382475_2848070,CM021107.1,8,29382475,346820708,5956856,2848070,349668778,344658161
29378461_3040206,CM021107.1,8,29378461,346820708,5266775,3040206,349860914,344850297
29378461_3040681,CM021107.1,8,29378461,346820708,5266775,3040681,349861389,344850772
29378461_3041987,CM021107.1,8,29378461,346820708,5266775,3041987,349862695,344852078
29378461_3042029,CM021107.1,8,29378461,346820708,5266775,3042029,349862737,344852120
29378461_3042129,CM021107.1,8,29378461,346820708,5266775,3042129,349862837,344852220
29378461_3042646,CM021107.1,8,29378461,346820708,5266775,3042646,349863354,344852737
29378461_3042762,CM021107.1,8,29378461,346820708,5266775,3042762,349863470,344852853
29378461_3042787,CM021107.1,8,29378461,346820708,5266775,3042787,349863495,344852878
29382475_3093258,CM021107.1,8,29382475,346820708,5956856,3093258,349913966,344903349
29382475_3093274,CM021107.1,8,29382475,346820708,5956856,3093274,349913982,344903365
29382475_3093284,CM021107.1,8,29382475,346820708,5956856,3093284,349913992,344903375
29382475_3093581,CM021107.1,8,29382475,346820708,5956856,3093581,349914289,344903672
29382475_3093619,CM021107.1,8,29382475,346820708,5956856,3093619,349914327,344903710
29382475_3170489,CM021107.1,8,29382475,346820708,5956856,3170489,349991197,344980580
29382475_3170509,CM021107.1,8,29382475,346820708,5956856,3170509,349991217,344980600
29377477_15525,CM021107.1,8,29377477,349996316,657087,15525,350011841,345001224
29377477_15526,CM021107.1,8,29377477,349996316,657087,15526,350011842,345001225
29377477_15554,CM021107.1,8,29377477,349996316,657087,15554,350011870,345001253
29377477_15559,CM021107.1,8,29377477,349996316,657087,15559,350011875,345001258
29377477_15573,CM021107.1,8,29377477,349996316,657087,15573,350011889,345001272
29377477_15574,CM021107.1,8,29377477,349996316,657087,15574,350011890,345001273
29377477_15589,CM021107.1,8,29377477,349996316,657087,15589,350011905,345001288
29377477_15686,CM021107.1,8,29377477,349996316,657087,15686,350012002,345001385
29377477_15726,CM021107.1,8,29377477,349996316,657087,15726,350012042,345001425
29377477_15777,CM021107.1,8,29377477,349996316,657087,15777,350012093,345001476
29377477_15795,CM021107.1,8,29377477,349996316,657087,15795,350012111,345001494
29377477_15801,CM021107.1,8,29377477,349996316,657087,15801,350012117,345001500
29377477_16080,CM021107.1,8,29377477,349996316,657087,16080,350012396,345001779
29377477_16091,CM021107.1,8,29377477,349996316,657087,16091,350012407,345001790
29377477_16143,CM021107.1,8,29377477,349996316,657087,16143,350012459,345001842
29378461_3221025,CM021107.1,8,29378461,346820708,5266775,3221025,350041733,345031116
29378800_91680,CM021107.1,8,29378800,349992714,3709788,91680,350084394,345073777
29378800_91925,CM021107.1,8,29378800,349992714,3709788,91925,350084639,345074022
29378800_92111,CM021107.1,8,29378800,349992714,3709788,92111,350084825,345074208
29378800_92292,CM021107.1,8,29378800,349992714,3709788,92292,350085006,345074389
29378800_92498,CM021107.1,8,29378800,349992714,3709788,92498,350085212,345074595
29378206_123238,CM021107.1,8,29378206,349992714,1098794,123238,350115952,345105335
29378206_123332,CM021107.1,8,29378206,349992714,1098794,123332,350116046,345105429
29378206_127166,CM021107.1,8,29378206,349992714,1098794,127166,350119880,345109263
29378206_127517,CM021107.1,8,29378206,349992714,1098794,127517,350120231,345109614
29378206_127568,CM021107.1,8,29378206,349992714,1098794,127568,350120282,345109665
29377477_141061,CM021107.1,8,29377477,349996316,657087,141061,350137377,345126760
29377477_141065,CM021107.1,8,29377477,349996316,657087,141065,350137381,345126764
29377477_141086,CM021107.1,8,29377477,349996316,657087,141086,350137402,345126785
29378206_148166,CM021107.1,8,29378206,349992714,1098794,148166,350140880,345130263
29378206_148627,CM021107.1,8,29378206,349992714,1098794,148627,350141341,345130724
29378206_148675,CM021107.1,8,29378206,349992714,1098794,148675,350141389,345130772
29378800_156055,CM021107.1,8,29378800,349992714,3709788,156055,350148769,345138152
29378800_156067,CM021107.1,8,29378800,349992714,3709788,156067,350148781,345138164
29378800_156103,CM021107.1,8,29378800,349992714,3709788,156103,350148817,345138200
29378800_156121,CM021107.1,8,29378800,349992714,3709788,156121,350148835,345138218
29378800_156130,CM021107.1,8,29378800,349992714,3709788,156130,350148844,345138227
29378800_156149,CM021107.1,8,29378800,349992714,3709788,156149,350148863,345138246
29378206_173269,CM021107.1,8,29378206,349992714,1098794,173269,350165983,345155366
29380793_3516129,CM021107.1,8,29380793,346656811,7906560,3516129,350172940,345162323
29377477_178132,CM021107.1,8,29377477,349996316,657087,178132,350174448,345163831
29377477_178155,CM021107.1,8,29377477,349996316,657087,178155,350174471,345163854
29377477_178536,CM021107.1,8,29377477,349996316,657087,178536,350174852,345164235
29382475_3396527,CM021107.1,8,29382475,346820708,5956856,3396527,350217235,345206618
29381189_3592746,CM021107.1,8,29381189,346653286,14650609,3592746,350246032,345235415
29379867_262732,CM021107.1,8,29379867,349992715,633477,262732,350255447,345244830
29379867_262752,CM021107.1,8,29379867,349992715,633477,262752,350255467,345244850
29379867_264488,CM021107.1,8,29379867,349992715,633477,264488,350257203,345246586
29379867_264526,CM021107.1,8,29379867,349992715,633477,264526,350257241,345246624
29380340_272575,CM021107.1,8,29380340,349992713,1700639,272575,350265288,345254671
29379867_282031,CM021107.1,8,29379867,349992715,633477,282031,350274746,345264129
29379867_282103,CM021107.1,8,29379867,349992715,633477,282103,350274818,345264201
29379867_282142,CM021107.1,8,29379867,349992715,633477,282142,350274857,345264240
29377477_281196,CM021107.1,8,29377477,349996316,657087,281196,350277512,345266895
29377477_281222,CM021107.1,8,29377477,349996316,657087,281222,350277538,345266921
29377477_281226,CM021107.1,8,29377477,349996316,657087,281226,350277542,345266925
29377477_281229,CM021107.1,8,29377477,349996316,657087,281229,350277545,345266928
29377477_284358,CM021107.1,8,29377477,349996316,657087,284358,350280674,345270057
29377477_284422,CM021107.1,8,29377477,349996316,657087,284422,350280738,345270121
29377477_284423,CM021107.1,8,29377477,349996316,657087,284423,350280739,345270122
29377477_284539,CM021107.1,8,29377477,349996316,657087,284539,350280855,345270238
29377477_284618,CM021107.1,8,29377477,349996316,657087,284618,350280934,345270317
29379867_307716,CM021107.1,8,29379867,349992715,633477,307716,350300431,345289814
29377303_345868,CM021107.1,8,29377303,349992711,2074289,345868,350338579,345327962
29381792_381503,CM021107.1,8,29381792,349994528,814612,381503,350376031,345365414
29377477_410775,CM021107.1,8,29377477,349996316,657087,410775,350407091,345396474
29377477_410885,CM021107.1,8,29377477,349996316,657087,410885,350407201,345396584
29381792_456292,CM021107.1,8,29381792,349994528,814612,456292,350450820,345440203
29381792_456336,CM021107.1,8,29381792,349994528,814612,456336,350450864,345440247
29378461_3718408,CM021107.1,8,29378461,346820708,5266775,3718408,350539116,345528499
29377477_565741,CM021107.1,8,29377477,349996316,657087,565741,350562057,345551440
29377477_565822,CM021107.1,8,29377477,349996316,657087,565822,350562138,345551521
29377477_565914,CM021107.1,8,29377477,349996316,657087,565914,350562230,345551613
29377477_566274,CM021107.1,8,29377477,349996316,657087,566274,350562590,345551973
29377477_568208,CM021107.1,8,29377477,349996316,657087,568208,350564524,345553907
29377477_568287,CM021107.1,8,29377477,349996316,657087,568287,350564603,345553986
29377477_568299,CM021107.1,8,29377477,349996316,657087,568299,350564615,345553998
29377477_568342,CM021107.1,8,29377477,349996316,657087,568342,350564658,345554041
29377477_568345,CM021107.1,8,29377477,349996316,657087,568345,350564661,345554044
29378206_697387,CM021107.1,8,29378206,349992714,1098794,697387,350690101,345679484
29378206_697408,CM021107.1,8,29378206,349992714,1098794,697408,350690122,345679505
29378800_706226,CM021107.1,8,29378800,349992714,3709788,706226,350698940,345688323
29378800_706251,CM021107.1,8,29378800,349992714,3709788,706251,350698965,345688348
29378800_706647,CM021107.1,8,29378800,349992714,3709788,706647,350699361,345688744
29381792_718354,CM021107.1,8,29381792,349994528,814612,718354,350712882,345702265
29381792_718380,CM021107.1,8,29381792,349994528,814612,718380,350712908,345702291
29381792_718434,CM021107.1,8,29381792,349994528,814612,718434,350712962,345702345
29378206_832706,CM021107.1,8,29378206,349992714,1098794,832706,350825420,345814803
29378206_832780,CM021107.1,8,29378206,349992714,1098794,832780,350825494,345814877
29378800_981459,CM021107.1,8,29378800,349992714,3709788,981459,350974173,345963556
29378800_981461,CM021107.1,8,29378800,349992714,3709788,981461,350974175,345963558
29378800_981468,CM021107.1,8,29378800,349992714,3709788,981468,350974182,345963565
29378800_981473,CM021107.1,8,29378800,349992714,3709788,981473,350974187,345963570
29378800_981480,CM021107.1,8,29378800,349992714,3709788,981480,350974194,345963577
29378800_987148,CM021107.1,8,29378800,349992714,3709788,987148,350979862,345969245
29378800_987392,CM021107.1,8,29378800,349992714,3709788,987392,350980106,345969489
29378800_1012811,CM021107.1,8,29378800,349992714,3709788,1012811,351005525,345994908
29378800_1012858,CM021107.1,8,29378800,349992714,3709788,1012858,351005572,345994955
29378206_1063021,CM021107.1,8,29378206,349992714,1098794,1063021,351055735,346045118
29378206_1064300,CM021107.1,8,29378206,349992714,1098794,1064300,351057014,346046397
29378206_1076360,CM021107.1,8,29378206,349992714,1098794,1076360,351069074,346058457
29377303_1204339,CM021107.1,8,29377303,349992711,2074289,1204339,351197050,346186433
29377303_1223743,CM021107.1,8,29377303,349992711,2074289,1223743,351216454,346205837
29381474_4667141,CM021107.1,8,29381474,346658082,6237908,4667141,351325223,346314606
29380874_1384349,CM021107.1,8,29380874,349992715,2511098,1384349,351377064,346366447
29380874_1386103,CM021107.1,8,29380874,349992715,2511098,1386103,351378818,346368201
29377303_1415221,CM021107.1,8,29377303,349992711,2074289,1415221,351407932,346397315
29377303_1415260,CM021107.1,8,29377303,349992711,2074289,1415260,351407971,346397354
29377303_1415900,CM021107.1,8,29377303,349992711,2074289,1415900,351408611,346397994
29377303_1416091,CM021107.1,8,29377303,349992711,2074289,1416091,351408802,346398185
29378461_4689472,CM021107.1,8,29378461,346820708,5266775,4689472,351510180,346499563
29378461_4689526,CM021107.1,8,29378461,346820708,5266775,4689526,351510234,346499617
29378461_4689531,CM021107.1,8,29378461,346820708,5266775,4689531,351510239,346499622
29378461_4689532,CM021107.1,8,29378461,346820708,5266775,4689532,351510240,346499623
29380793_4879121,CM021107.1,8,29380793,346656811,7906560,4879121,351535932,346525315
29380793_4879360,CM021107.1,8,29380793,346656811,7906560,4879360,351536171,346525554
29381189_4968625,CM021107.1,8,29381189,346653286,14650609,4968625,351621911,346611294
29380874_1873724,CM021107.1,8,29380874,349992715,2511098,1873724,351866439,346855822
29380874_1873779,CM021107.1,8,29380874,349992715,2511098,1873779,351866494,346855877
29378800_1892787,CM021107.1,8,29378800,349992714,3709788,1892787,351885501,346874884
29378800_1895802,CM021107.1,8,29378800,349992714,3709788,1895802,351888516,346877899
29378800_1895943,CM021107.1,8,29378800,349992714,3709788,1895943,351888657,346878040
29378800_1895963,CM021107.1,8,29378800,349992714,3709788,1895963,351888677,346878060
29378800_1896006,CM021107.1,8,29378800,349992714,3709788,1896006,351888720,346878103
29378800_1896015,CM021107.1,8,29378800,349992714,3709788,1896015,351888729,346878112
29377303_2035360,CM021107.1,8,29377303,349992711,2074289,2035360,352028071,347017454
29380793_5502645,CM021107.1,8,29380793,346656811,7906560,5502645,352159456,347148839
29380793_5502654,CM021107.1,8,29380793,346656811,7906560,5502654,352159465,347148848
29380793_5503228,CM021107.1,8,29380793,346656811,7906560,5503228,352160039,347149422
29380793_5503259,CM021107.1,8,29380793,346656811,7906560,5503259,352160070,347149453
29380793_5596601,CM021107.1,8,29380793,346656811,7906560,5596601,352253412,347242795
29380793_5596672,CM021107.1,8,29380793,346656811,7906560,5596672,352253483,347242866
29367299_1198,CM021107.1,8,29367299,352604118,22548,1198,352605316,347594699
29378800_2781542,CM021107.1,8,29378800,349992714,3709788,2781542,352774256,347763639
29378800_2818217,CM021107.1,8,29378800,349992714,3709788,2818217,352810931,347800314
29378800_2818243,CM021107.1,8,29378800,349992714,3709788,2818243,352810957,347800340
29378800_2818257,CM021107.1,8,29378800,349992714,3709788,2818257,352810971,347800354
29378800_2818265,CM021107.1,8,29378800,349992714,3709788,2818265,352810979,347800362
29378800_2818307,CM021107.1,8,29378800,349992714,3709788,2818307,352811021,347800404
29378800_2818316,CM021107.1,8,29378800,349992714,3709788,2818316,352811030,347800413
29381474_6232246,CM021107.1,8,29381474,346658082,6237908,6232246,352890328,347879711
29378800_3514618,CM021107.1,8,29378800,349992714,3709788,3514618,353507332,348496715
29378800_3668076,CM021107.1,8,29378800,349992714,3709788,3668076,353660790,348650173
29378800_3668088,CM021107.1,8,29378800,349992714,3709788,3668088,353660802,348650185
29378800_3668096,CM021107.1,8,29378800,349992714,3709788,3668096,353660810,348650193
29378800_3668100,CM021107.1,8,29378800,349992714,3709788,3668100,353660814,348650197
29378800_3668101,CM021107.1,8,29378800,349992714,3709788,3668101,353660815,348650198
29378800_3668131,CM021107.1,8,29378800,349992714,3709788,3668131,353660845,348650228
29378800_3668133,CM021107.1,8,29378800,349992714,3709788,3668133,353660847,348650230
29378800_3668140,CM021107.1,8,29378800,349992714,3709788,3668140,353660854,348650237
29378800_3668172,CM021107.1,8,29378800,349992714,3709788,3668172,353660886,348650269
29378800_3668184,CM021107.1,8,29378800,349992714,3709788,3668184,353660898,348650281
29381189_7345241,CM021107.1,8,29381189,346653286,14650609,7345241,353998527,348987910
29381189_8887496,CM021107.1,8,29381189,346653286,14650609,8887496,355540782,350530165
29381189_8887497,CM021107.1,8,29381189,346653286,14650609,8887497,355540783,350530166
29381189_8887507,CM021107.1,8,29381189,346653286,14650609,8887507,355540793,350530176
29381189_8902954,CM021107.1,8,29381189,346653286,14650609,8902954,355556240,350545623
29381189_8903053,CM021107.1,8,29381189,346653286,14650609,8903053,355556339,350545722
29381189_8903105,CM021107.1,8,29381189,346653286,14650609,8903105,355556391,350545774
29381189_8968925,CM021107.1,8,29381189,346653286,14650609,8968925,355622211,350611594
29381189_8969026,CM021107.1,8,29381189,346653286,14650609,8969026,355622312,350611695
29381189_9086245,CM021107.1,8,29381189,346653286,14650609,9086245,355739531,350728914
29381189_9086302,CM021107.1,8,29381189,346653286,14650609,9086302,355739588,350728971
29381189_9086317,CM021107.1,8,29381189,346653286,14650609,9086317,355739603,350728986
29381189_9086399,CM021107.1,8,29381189,346653286,14650609,9086399,355739685,350729068
29381189_9086400,CM021107.1,8,29381189,346653286,14650609,9086400,355739686,350729069
29381189_9086896,CM021107.1,8,29381189,346653286,14650609,9086896,355740182,350729565
29381189_9087082,CM021107.1,8,29381189,346653286,14650609,9087082,355740368,350729751
29381189_9087116,CM021107.1,8,29381189,346653286,14650609,9087116,355740402,350729785
29378205_983220,CM021107.1,8,29378205,366495367,1159369,983220,367478587,362467970
29378205_983430,CM021107.1,8,29378205,366495367,1159369,983430,367478797,362468180
29378205_1067106,CM021107.1,8,29378205,366495367,1159369,1067106,367562473,362551856
29378205_1067231,CM021107.1,8,29378205,366495367,1159369,1067231,367562598,362551981
28907044_7342,CM021107.1,8,28907044,375556484,8026,7342,375563826,370553209
28907044_7374,CM021107.1,8,28907044,375556484,8026,7374,375563858,370553241
28907044_7571,CM021107.1,8,28907044,375556484,8026,7571,375564055,370553438
28907044_7596,CM021107.1,8,28907044,375556484,8026,7596,375564080,370553463
29377615_142974,CM021107.1,8,29377615,390856995,269268,142974,390999969,385989352
29377615_142993,CM021107.1,8,29377615,390856995,269268,142993,390999988,385989371
29338907_178299,CM021107.1,8,29338907,390853860,197122,178299,391032159,386021542
29338907_178323,CM021107.1,8,29338907,390853860,197122,178323,391032183,386021566
29338907_178368,CM021107.1,8,29338907,390853860,197122,178368,391032228,386021611
29377856_80472,CM021107.1,8,29377856,390987981,1152330,80472,391068453,386057836
29377856_80564,CM021107.1,8,29377856,390987981,1152330,80564,391068545,386057928
29377856_80575,CM021107.1,8,29377856,390987981,1152330,80575,391068556,386057939
29377856_80578,CM021107.1,8,29377856,390987981,1152330,80578,391068559,386057942
29377856_80639,CM021107.1,8,29377856,390987981,1152330,80639,391068620,386058003
29378888_116329,CM021107.1,8,29378888,390987981,1372165,116329,391104310,386093693
29377836_268315,CM021107.1,8,29377836,390853859,1458702,268315,391122174,386111557
29381389_145709,CM021107.1,8,29381389,390987981,1049993,145709,391133690,386123073
29377271_527371,CM021107.1,8,29377271,390853856,1314819,527371,391381227,386370610
29377271_527389,CM021107.1,8,29377271,390853856,1314819,527389,391381245,386370628
29377271_527390,CM021107.1,8,29377271,390853856,1314819,527390,391381246,386370629
29377271_527454,CM021107.1,8,29377271,390853856,1314819,527454,391381310,386370693
29377271_646863,CM021107.1,8,29377271,390853856,1314819,646863,391500719,386490102
29377271_693916,CM021107.1,8,29377271,390853856,1314819,693916,391547772,386537155
29377271_731302,CM021107.1,8,29377271,390853856,1314819,731302,391585158,386574541
29377271_731381,CM021107.1,8,29377271,390853856,1314819,731381,391585237,386574620
29379885_849845,CM021107.1,8,29379885,390856185,2304235,849845,391706030,386695413
29379885_849846,CM021107.1,8,29379885,390856185,2304235,849846,391706031,386695414
29379885_849863,CM021107.1,8,29379885,390856185,2304235,849863,391706048,386695431
29379885_849918,CM021107.1,8,29379885,390856185,2304235,849918,391706103,386695486
29377271_1057574,CM021107.1,8,29377271,390853856,1314819,1057574,391911430,386900813
29377271_1057602,CM021107.1,8,29377271,390853856,1314819,1057602,391911458,386900841
29377271_1057654,CM021107.1,8,29377271,390853856,1314819,1057654,391911510,386900893
29377271_1057664,CM021107.1,8,29377271,390853856,1314819,1057664,391911520,386900903
29380866_1060826,CM021107.1,8,29380866,390853861,2695798,1060826,391914687,386904070
29380866_1060907,CM021107.1,8,29380866,390853861,2695798,1060907,391914768,386904151
29380866_1060942,CM021107.1,8,29380866,390853861,2695798,1060942,391914803,386904186
29377271_1292368,CM021107.1,8,29377271,390853856,1314819,1292368,392146224,387135607
29377271_1292403,CM021107.1,8,29377271,390853856,1314819,1292403,392146259,387135642
29377621_1342807,CM021107.1,8,29377621,390856721,2124235,1342807,392199528,387188911
29377621_1342884,CM021107.1,8,29377621,390856721,2124235,1342884,392199605,387188988
29379224_1439004,CM021107.1,8,29379224,390853861,1777185,1439004,392292865,387282248
29381853_1527063,CM021107.1,8,29381853,390987981,3538127,1527063,392515044,387504427
29377621_1958902,CM021107.1,8,29377621,390856721,2124235,1958902,392815623,387805006
29381870_1960770,CM021107.1,8,29381870,390987980,2297817,1960770,392948750,387938133
29381870_1960811,CM021107.1,8,29381870,390987980,2297817,1960811,392948791,387938174
29381870_2100919,CM021107.1,8,29381870,390987980,2297817,2100919,393088899,388078282
29381870_2101790,CM021107.1,8,29381870,390987980,2297817,2101790,393089770,388079153
29381870_2101798,CM021107.1,8,29381870,390987980,2297817,2101798,393089778,388079161
29381870_2101898,CM021107.1,8,29381870,390987980,2297817,2101898,393089878,388079261
29381870_2105194,CM021107.1,8,29381870,390987980,2297817,2105194,393093174,388082557
29381870_2105211,CM021107.1,8,29381870,390987980,2297817,2105211,393093191,388082574
29381870_2215431,CM021107.1,8,29381870,390987980,2297817,2215431,393203411,388192794
29381870_2215450,CM021107.1,8,29381870,390987980,2297817,2215450,393203430,388192813
29381870_2215454,CM021107.1,8,29381870,390987980,2297817,2215454,393203434,388192817
29381870_2215461,CM021107.1,8,29381870,390987980,2297817,2215461,393203441,388192824
29381870_2215477,CM021107.1,8,29381870,390987980,2297817,2215477,393203457,388192840
29381870_2215506,CM021107.1,8,29381870,390987980,2297817,2215506,393203486,388192869
29381870_2215554,CM021107.1,8,29381870,390987980,2297817,2215554,393203534,388192917
29381870_2216860,CM021107.1,8,29381870,390987980,2297817,2216860,393204840,388194223
29381745_338525,CM021107.1,8,29381745,419453783,679440,338525,419792308,414781691
29381745_338528,CM021107.1,8,29381745,419453783,679440,338528,419792311,414781694
29381745_338539,CM021107.1,8,29381745,419453783,679440,338539,419792322,414781705
29381745_338576,CM021107.1,8,29381745,419453783,679440,338576,419792359,414781742
29381745_338593,CM021107.1,8,29381745,419453783,679440,338593,419792376,414781759
29381745_564591,CM021107.1,8,29381745,419453783,679440,564591,420018374,415007757
29381745_564626,CM021107.1,8,29381745,419453783,679440,564626,420018409,415007792
29381745_564639,CM021107.1,8,29381745,419453783,679440,564639,420018422,415007805
29381745_564706,CM021107.1,8,29381745,419453783,679440,564706,420018489,415007872
29381745_564710,CM021107.1,8,29381745,419453783,679440,564710,420018493,415007876
29381745_564716,CM021107.1,8,29381745,419453783,679440,564716,420018499,415007882
29381745_564733,CM021107.1,8,29381745,419453783,679440,564733,420018516,415007899
29380665_24209,CM021107.1,8,29380665,426814395,41396,24209,426838604,421827987
29380665_24269,CM021107.1,8,29380665,426814395,41396,24269,426838664,421828047
29380218_263598,CM021107.1,8,29380218,426814395,702342,263598,427077993,422067376
29380218_295549,CM021107.1,8,29380218,426814395,702342,295549,427109944,422099327
29380218_304324,CM021107.1,8,29380218,426814395,702342,304324,427118719,422108102
29378264_145197,CM021107.1,8,29378264,434557080,1035013,145197,434702277,429691660
29381169_215108,CM021107.1,8,29381169,434557077,435794,215108,434772185,429761568
29381169_215121,CM021107.1,8,29381169,434557077,435794,215121,434772198,429761581
29381169_215135,CM021107.1,8,29381169,434557077,435794,215135,434772212,429761595
29377276_261259,CM021107.1,8,29377276,434557074,478693,261259,434818333,429807716
29377276_345650,CM021107.1,8,29377276,434557074,478693,345650,434902724,429892107
29377276_345692,CM021107.1,8,29377276,434557074,478693,345692,434902766,429892149
29377276_452998,CM021107.1,8,29377276,434557074,478693,452998,435010072,429999455
29381810_520216,CM021107.1,8,29381810,434557077,958032,520216,435077293,430066676
29381810_520626,CM021107.1,8,29381810,434557077,958032,520626,435077703,430067086
29381810_520689,CM021107.1,8,29381810,434557077,958032,520689,435077766,430067149
29381081_668280,CM021107.1,8,29381081,434557080,753977,668280,435225360,430214743
29381081_668283,CM021107.1,8,29381081,434557080,753977,668283,435225363,430214746
29378264_885851,CM021107.1,8,29378264,434557080,1035013,885851,435442931,430432314
29378264_900339,CM021107.1,8,29378264,434557080,1035013,900339,435457419,430446802
29378264_900671,CM021107.1,8,29378264,434557080,1035013,900671,435457751,430447134
29378264_900761,CM021107.1,8,29378264,434557080,1035013,900761,435457841,430447224
29378264_900765,CM021107.1,8,29378264,434557080,1035013,900765,435457845,430447228
29378264_952130,CM021107.1,8,29378264,434557080,1035013,952130,435509210,430498593
29378264_974276,CM021107.1,8,29378264,434557080,1035013,974276,435531356,430520739
28430478_3086,CM021107.1,8,28430478,481012048,7794,3086,481015134,476004517
28430478_3235,CM021107.1,8,28430478,481012048,7794,3235,481015283,476004666
29347979_37640,CM021107.1,8,29347979,483453965,183131,37640,483491605,478480988
29347979_37646,CM021107.1,8,29347979,483453965,183131,37646,483491611,478480994
29347979_37675,CM021107.1,8,29347979,483453965,183131,37675,483491640,478481023
29347979_37676,CM021107.1,8,29347979,483453965,183131,37676,483491641,478481024
29377236_46401,CM021107.1,8,29377236,483452073,1765326,46401,483498474,478487857
29377236_92383,CM021107.1,8,29377236,483452073,1765326,92383,483544456,478533839
29377236_92401,CM021107.1,8,29377236,483452073,1765326,92401,483544474,478533857
29377236_92423,CM021107.1,8,29377236,483452073,1765326,92423,483544496,478533879
29378714_99168,CM021107.1,8,29378714,483452074,320893,99168,483551242,478540625
29378714_99229,CM021107.1,8,29378714,483452074,320893,99229,483551303,478540686
29377236_119136,CM021107.1,8,29377236,483452073,1765326,119136,483571209,478560592
29377236_119201,CM021107.1,8,29377236,483452073,1765326,119201,483571274,478560657
29377236_119231,CM021107.1,8,29377236,483452073,1765326,119231,483571304,478560687
29377236_119232,CM021107.1,8,29377236,483452073,1765326,119232,483571305,478560688
29377236_120414,CM021107.1,8,29377236,483452073,1765326,120414,483572487,478561870
29377236_120419,CM021107.1,8,29377236,483452073,1765326,120419,483572492,478561875
29377236_121244,CM021107.1,8,29377236,483452073,1765326,121244,483573317,478562700
29377236_121335,CM021107.1,8,29377236,483452073,1765326,121335,483573408,478562791
29377236_121341,CM021107.1,8,29377236,483452073,1765326,121341,483573414,478562797
29377236_121349,CM021107.1,8,29377236,483452073,1765326,121349,483573422,478562805
29380611_171498,CM021107.1,8,29380611,483452075,1015824,171498,483623573,478612956
29380611_175749,CM021107.1,8,29380611,483452075,1015824,175749,483627824,478617207
29378597_244763,CM021107.1,8,29378597,483452075,1403909,244763,483696838,478686221
29378597_244823,CM021107.1,8,29378597,483452075,1403909,244823,483696898,478686281
29377236_448472,CM021107.1,8,29377236,483452073,1765326,448472,483900545,478889928
29377236_448498,CM021107.1,8,29377236,483452073,1765326,448498,483900571,478889954
29377236_448519,CM021107.1,8,29377236,483452073,1765326,448519,483900592,478889975
29380545_614212,CM021107.1,8,29380545,483453230,761009,614212,484067442,479056825
29380763_708055,CM021107.1,8,29380763,483452074,2738016,708055,484160129,479149512
29380763_708205,CM021107.1,8,29380763,483452074,2738016,708205,484160279,479149662
29382068_722331,CM021107.1,8,29382068,483452069,2563163,722331,484174400,479163783
29382068_722354,CM021107.1,8,29382068,483452069,2563163,722354,484174423,479163806
29382068_722359,CM021107.1,8,29382068,483452069,2563163,722359,484174428,479163811
29382068_722373,CM021107.1,8,29382068,483452069,2563163,722373,484174442,479163825
29382068_722374,CM021107.1,8,29382068,483452069,2563163,722374,484174443,479163826
29382068_853023,CM021107.1,8,29382068,483452069,2563163,853023,484305092,479294475
29382068_853085,CM021107.1,8,29382068,483452069,2563163,853085,484305154,479294537
29377236_888038,CM021107.1,8,29377236,483452073,1765326,888038,484340111,479329494
29378597_917699,CM021107.1,8,29378597,483452075,1403909,917699,484369774,479359157
29377236_930490,CM021107.1,8,29377236,483452073,1765326,930490,484382563,479371946
29377236_965824,CM021107.1,8,29377236,483452073,1765326,965824,484417897,479407280
29380611_980541,CM021107.1,8,29380611,483452075,1015824,980541,484432616,479421999
29380611_980794,CM021107.1,8,29380611,483452075,1015824,980794,484432869,479422252
29377236_1091462,CM021107.1,8,29377236,483452073,1765326,1091462,484543535,479532918
29377236_1091510,CM021107.1,8,29377236,483452073,1765326,1091510,484543583,479532966
29377236_1116477,CM021107.1,8,29377236,483452073,1765326,1116477,484568550,479557933
29378597_1124437,CM021107.1,8,29378597,483452075,1403909,1124437,484576512,479565895
29377236_1137470,CM021107.1,8,29377236,483452073,1765326,1137470,484589543,479578926
29382068_1328080,CM021107.1,8,29382068,483452069,2563163,1328080,484780149,479769532
29382068_1328116,CM021107.1,8,29382068,483452069,2563163,1328116,484780185,479769568
29382068_1328177,CM021107.1,8,29382068,483452069,2563163,1328177,484780246,479769629
29382068_1328187,CM021107.1,8,29382068,483452069,2563163,1328187,484780256,479769639
29382068_1331844,CM021107.1,8,29382068,483452069,2563163,1331844,484783913,479773296
29377236_1413445,CM021107.1,8,29377236,483452073,1765326,1413445,484865518,479854901
29377236_1413567,CM021107.1,8,29377236,483452073,1765326,1413567,484865640,479855023
29377236_1413574,CM021107.1,8,29377236,483452073,1765326,1413574,484865647,479855030
29377236_1413587,CM021107.1,8,29377236,483452073,1765326,1413587,484865660,479855043
29377236_1413633,CM021107.1,8,29377236,483452073,1765326,1413633,484865706,479855089
29379848_1673780,CM021107.1,8,29379848,483452069,2382325,1673780,485125849,480115232
29379378_1675864,CM021107.1,8,29379378,483452075,3544491,1675864,485127939,480117322
29379378_1675880,CM021107.1,8,29379378,483452075,3544491,1675880,485127955,480117338
29379378_1675887,CM021107.1,8,29379378,483452075,3544491,1675887,485127962,480117345
29379378_1675953,CM021107.1,8,29379378,483452075,3544491,1675953,485128028,480117411
29381271_2136304,CM021107.1,8,29381271,483452075,4206771,2136304,485588379,480577762
29379378_2193069,CM021107.1,8,29379378,483452075,3544491,2193069,485645144,480634527
29379378_2193216,CM021107.1,8,29379378,483452075,3544491,2193216,485645291,480634674
29379378_2713962,CM021107.1,8,29379378,483452075,3544491,2713962,486166037,481155420
29379378_2714007,CM021107.1,8,29379378,483452075,3544491,2714007,486166082,481155465
29379378_2714046,CM021107.1,8,29379378,483452075,3544491,2714046,486166121,481155504
29381271_4148842,CM021107.1,8,29381271,483452075,4206771,4148842,487600917,482590300
29377125_90886,CM021107.1,8,29377125,488952200,202829,90886,489043086,484032469
29377125_90901,CM021107.1,8,29377125,488952200,202829,90901,489043101,484032484
29377125_90902,CM021107.1,8,29377125,488952200,202829,90902,489043102,484032485
29374737_38610,CM021107.1,8,29374737,495318342,57415,38610,495356952,490346335
29378400_157232,CM021107.1,8,29378400,495318342,243189,157232,495475574,490464957
29381485_258365,CM021107.1,8,29381485,495318337,1470872,258365,495576702,490566085
29380018_372093,CM021107.1,8,29380018,495319590,860906,372093,495691683,490681066
29381566_443707,CM021107.1,8,29381566,495318337,586776,443707,495762044,490751427
29381566_443741,CM021107.1,8,29381566,495318337,586776,443741,495762078,490751461
29381566_443846,CM021107.1,8,29381566,495318337,586776,443846,495762183,490751566
29381566_443858,CM021107.1,8,29381566,495318337,586776,443858,495762195,490751578
29381566_443869,CM021107.1,8,29381566,495318337,586776,443869,495762206,490751589
29381566_443893,CM021107.1,8,29381566,495318337,586776,443893,495762230,490751613
29381566_443894,CM021107.1,8,29381566,495318337,586776,443894,495762231,490751614
29381566_443905,CM021107.1,8,29381566,495318337,586776,443905,495762242,490751625
29381566_542278,CM021107.1,8,29381566,495318337,586776,542278,495860615,490849998
29379321_544442,CM021107.1,8,29379321,495318339,1946375,544442,495862781,490852164
29381485_721616,CM021107.1,8,29381485,495318337,1470872,721616,496039953,491029336
29381485_721620,CM021107.1,8,29381485,495318337,1470872,721620,496039957,491029340
29381485_721652,CM021107.1,8,29381485,495318337,1470872,721652,496039989,491029372
29380018_740739,CM021107.1,8,29380018,495319590,860906,740739,496060329,491049712
29380018_740744,CM021107.1,8,29380018,495319590,860906,740744,496060334,491049717
29380018_740783,CM021107.1,8,29380018,495319590,860906,740783,496060373,491049756
29380018_740817,CM021107.1,8,29380018,495319590,860906,740817,496060407,491049790
29380018_740818,CM021107.1,8,29380018,495319590,860906,740818,496060408,491049791
29380018_740829,CM021107.1,8,29380018,495319590,860906,740829,496060419,491049802
29379321_1537204,CM021107.1,8,29379321,495318339,1946375,1537204,496855543,491844926
29379321_1537234,CM021107.1,8,29379321,495318339,1946375,1537234,496855573,491844956
29209767_1839,CM021107.1,8,29209767,502179804,7059,1839,502181643,497171026
29209767_1866,CM021107.1,8,29209767,502179804,7059,1866,502181670,497171053
29209767_1925,CM021107.1,8,29209767,502179804,7059,1925,502181729,497171112
29209767_3222,CM021107.1,8,29209767,502179804,7059,3222,502183026,497172409
29209767_3233,CM021107.1,8,29209767,502179804,7059,3233,502183037,497172420
29209767_3271,CM021107.1,8,29209767,502179804,7059,3271,502183075,497172458
29209767_3329,CM021107.1,8,29209767,502179804,7059,3329,502183133,497172516
28134598_200,CM021107.1,8,28134598,502342137,3648,200,502342337,497331720
28172411_2045,CM021107.1,8,28172411,502432875,2947,2045,502434920,497424303
29380539_42469,CM021107.1,8,29380539,539669798,223812,42469,539712267,534701650
29379941_47729,CM021107.1,8,29379941,542143261,268578,47729,542190990,537180373
29377103_61101,CM021107.1,8,29377103,542130466,485397,61101,542191567,537180950
29381344_119626,CM021107.1,8,29381344,542131596,2054292,119626,542251222,537240605
29380450_260761,CM021107.1,8,29380450,542137105,5580067,260761,542397866,537387249
29380450_260832,CM021107.1,8,29380450,542137105,5580067,260832,542397937,537387320
29380450_263576,CM021107.1,8,29380450,542137105,5580067,263576,542400681,537390064
29381344_1187689,CM021107.1,8,29381344,542131596,2054292,1187689,543319285,538308668
29381344_1187718,CM021107.1,8,29381344,542131596,2054292,1187718,543319314,538308697
29381344_1187724,CM021107.1,8,29381344,542131596,2054292,1187724,543319320,538308703
29381344_1187729,CM021107.1,8,29381344,542131596,2054292,1187729,543319325,538308708
29381344_1187746,CM021107.1,8,29381344,542131596,2054292,1187746,543319342,538308725
29381344_1187755,CM021107.1,8,29381344,542131596,2054292,1187755,543319351,538308734
29381344_1187757,CM021107.1,8,29381344,542131596,2054292,1187757,543319353,538308736
29381344_1187759,CM021107.1,8,29381344,542131596,2054292,1187759,543319355,538308738
29381344_1187772,CM021107.1,8,29381344,542131596,2054292,1187772,543319368,538308751
29381344_1187779,CM021107.1,8,29381344,542131596,2054292,1187779,543319375,538308758
29381344_1187801,CM021107.1,8,29381344,542131596,2054292,1187801,543319397,538308780
29381344_1187802,CM021107.1,8,29381344,542131596,2054292,1187802,543319398,538308781
29381344_1187809,CM021107.1,8,29381344,542131596,2054292,1187809,543319405,538308788
29381344_1187834,CM021107.1,8,29381344,542131596,2054292,1187834,543319430,538308813
29381344_1187849,CM021107.1,8,29381344,542131596,2054292,1187849,543319445,538308828
29381344_1187879,CM021107.1,8,29381344,542131596,2054292,1187879,543319475,538308858
29381344_1229765,CM021107.1,8,29381344,542131596,2054292,1229765,543361361,538350744
29381344_1230026,CM021107.1,8,29381344,542131596,2054292,1230026,543361622,538351005
29360311_83717,CM021107.1,8,29360311,548742146,268066,83717,548825863,543815246
29360311_83720,CM021107.1,8,29360311,548742146,268066,83720,548825866,543815249
29360311_83765,CM021107.1,8,29360311,548742146,268066,83765,548825911,543815294
29380263_197392,CM021107.1,8,29380263,548741536,749421,197392,548938928,543928311
29380263_197462,CM021107.1,8,29380263,548741536,749421,197462,548938998,543928381
29380263_442138,CM021107.1,8,29380263,548741536,749421,442138,549183674,544173057
29381222_33120,CM021107.1,8,29381222,556529900,525092,33120,556563020,551552403
29379374_200728,CM021107.1,8,29379374,556529908,1053754,200728,556730636,551720019
29379374_990034,CM021107.1,8,29379374,556529908,1053754,990034,557519942,552509325
29379374_991102,CM021107.1,8,29379374,556529908,1053754,991102,557521010,552510393
29379374_991107,CM021107.1,8,29379374,556529908,1053754,991107,557521015,552510398
29379374_994682,CM021107.1,8,29379374,556529908,1053754,994682,557524590,552513973
29379374_994745,CM021107.1,8,29379374,556529908,1053754,994745,557524653,552514036
29379374_994765,CM021107.1,8,29379374,556529908,1053754,994765,557524673,552514056
29379374_994780,CM021107.1,8,29379374,556529908,1053754,994780,557524688,552514071
29379374_994796,CM021107.1,8,29379374,556529908,1053754,994796,557524704,552514087
29379374_994810,CM021107.1,8,29379374,556529908,1053754,994810,557524718,552514101
29379374_994816,CM021107.1,8,29379374,556529908,1053754,994816,557524724,552514107
29379374_994819,CM021107.1,8,29379374,556529908,1053754,994819,557524727,552514110
29379374_994827,CM021107.1,8,29379374,556529908,1053754,994827,557524735,552514118
29379374_994891,CM021107.1,8,29379374,556529908,1053754,994891,557524799,552514182
29379374_994982,CM021107.1,8,29379374,556529908,1053754,994982,557524890,552514273
29379616_426562,CM021107.1,8,29379616,575143607,590865,426562,575570169,570559552
29379616_426647,CM021107.1,8,29379616,575143607,590865,426647,575570254,570559637
29379616_426667,CM021107.1,8,29379616,575143607,590865,426667,575570274,570559657
29379616_426671,CM021107.1,8,29379616,575143607,590865,426671,575570278,570559661
29379616_426677,CM021107.1,8,29379616,575143607,590865,426677,575570284,570559667
29379616_426683,CM021107.1,8,29379616,575143607,590865,426683,575570290,570559673
29379616_426684,CM021107.1,8,29379616,575143607,590865,426684,575570291,570559674
29381225_1543,CM021107.1,8,29381225,588484224,733980,1543,588485767,583475150
29381225_1586,CM021107.1,8,29381225,588484224,733980,1586,588485810,583475193
29381225_1589,CM021107.1,8,29381225,588484224,733980,1589,588485813,583475196
29381225_1595,CM021107.1,8,29381225,588484224,733980,1595,588485819,583475202
29381225_17245,CM021107.1,8,29381225,588484224,733980,17245,588501469,583490852
29381225_17257,CM021107.1,8,29381225,588484224,733980,17257,588501481,583490864
29381225_17264,CM021107.1,8,29381225,588484224,733980,17264,588501488,583490871
29381225_17311,CM021107.1,8,29381225,588484224,733980,17311,588501535,583490918
29381225_59558,CM021107.1,8,29381225,588484224,733980,59558,588543782,583533165
29381225_59572,CM021107.1,8,29381225,588484224,733980,59572,588543796,583533179
29381225_274648,CM021107.1,8,29381225,588484224,733980,274648,588758872,583748255
29381225_275803,CM021107.1,8,29381225,588484224,733980,275803,588760027,583749410
29381225_275818,CM021107.1,8,29381225,588484224,733980,275818,588760042,583749425
29377769_334584,CM021107.1,8,29377769,588484229,525060,334584,588818813,583808196
29377769_334613,CM021107.1,8,29377769,588484229,525060,334613,588818842,583808225
29377769_334629,CM021107.1,8,29377769,588484229,525060,334629,588818858,583808241
29377769_334662,CM021107.1,8,29377769,588484229,525060,334662,588818891,583808274
29377769_437011,CM021107.1,8,29377769,588484229,525060,437011,588921240,583910623
29377769_437012,CM021107.1,8,29377769,588484229,525060,437012,588921241,583910624
29377769_437033,CM021107.1,8,29377769,588484229,525060,437033,588921262,583910645
29377769_437034,CM021107.1,8,29377769,588484229,525060,437034,588921263,583910646
29377769_437037,CM021107.1,8,29377769,588484229,525060,437037,588921266,583910649
29377769_437042,CM021107.1,8,29377769,588484229,525060,437042,588921271,583910654
29377769_437063,CM021107.1,8,29377769,588484229,525060,437063,588921292,583910675
29377769_437071,CM021107.1,8,29377769,588484229,525060,437071,588921300,583910683
29377769_437073,CM021107.1,8,29377769,588484229,525060,437073,588921302,583910685
29377769_437078,CM021107.1,8,29377769,588484229,525060,437078,588921307,583910690
29381225_447748,CM021107.1,8,29381225,588484224,733980,447748,588931972,583921355
29381225_448092,CM021107.1,8,29381225,588484224,733980,448092,588932316,583921699
29381225_448115,CM021107.1,8,29381225,588484224,733980,448115,588932339,583921722
29188197_1252,CM021107.1,8,29188197,590344737,3482,1252,590345989,585335372
29188197_1279,CM021107.1,8,29188197,590344737,3482,1279,590346016,585335399
29188197_1337,CM021107.1,8,29188197,590344737,3482,1337,590346074,585335457
29342646_55099,CM021107.1,8,29342646,593513558,69966,55099,593568657,588558040
29342646_55104,CM021107.1,8,29342646,593513558,69966,55104,593568662,588558045
29342646_55157,CM021107.1,8,29342646,593513558,69966,55157,593568715,588558098
29342646_55165,CM021107.1,8,29342646,593513558,69966,55165,593568723,588558106
29342646_55174,CM021107.1,8,29342646,593513558,69966,55174,593568732,588558115
29342646_55177,CM021107.1,8,29342646,593513558,69966,55177,593568735,588558118
29342646_55192,CM021107.1,8,29342646,593513558,69966,55192,593568750,588558133
29342646_55233,CM021107.1,8,29342646,593513558,69966,55233,593568791,588558174
29342646_55258,CM021107.1,8,29342646,593513558,69966,55258,593568816,588558199
28483315_5460,CM021107.1,8,28483315,597291503,8902,5460,597296963,592286346
28483315_5465,CM021107.1,8,28483315,597291503,8902,5465,597296968,592286351
28483315_5482,CM021107.1,8,28483315,597291503,8902,5482,597296985,592286368
28483315_5484,CM021107.1,8,28483315,597291503,8902,5484,597296987,592286370
28483315_5486,CM021107.1,8,28483315,597291503,8902,5486,597296989,592286372
29381335_26052,CM021107.1,8,29381335,598163387,512476,26052,598189439,593178822
29379478_985589,CM021107.1,8,29379478,598163387,1474951,985589,599148976,594138359
29378620_1027646,CM021107.1,8,29378620,603568884,3913685,1027646,604596530,599585913
29378620_1027649,CM021107.1,8,29378620,603568884,3913685,1027649,604596533,599585916
29378620_1027768,CM021107.1,8,29378620,603568884,3913685,1027768,604596652,599586035
29378620_1027769,CM021107.1,8,29378620,603568884,3913685,1027769,604596653,599586036
29378620_1027777,CM021107.1,8,29378620,603568884,3913685,1027777,604596661,599586044
29378620_1027783,CM021107.1,8,29378620,603568884,3913685,1027783,604596667,599586050
29378620_1162710,CM021107.1,8,29378620,603568884,3913685,1162710,604731594,599720977
29378620_1162743,CM021107.1,8,29378620,603568884,3913685,1162743,604731627,599721010
29378620_1162819,CM021107.1,8,29378620,603568884,3913685,1162819,604731703,599721086
29377344_1179752,CM021107.1,8,29377344,603568885,1436279,1179752,604748637,599738020
29377344_1179786,CM021107.1,8,29377344,603568885,1436279,1179786,604748671,599738054
29377344_1179794,CM021107.1,8,29377344,603568885,1436279,1179794,604748679,599738062
29377344_1179804,CM021107.1,8,29377344,603568885,1436279,1179804,604748689,599738072
29377344_1179810,CM021107.1,8,29377344,603568885,1436279,1179810,604748695,599738078
29377344_1179918,CM021107.1,8,29377344,603568885,1436279,1179918,604748803,599738186
29380643_1214378,CM021107.1,8,29380643,603568884,2639339,1214378,604783262,599772645
29380643_1214396,CM021107.1,8,29380643,603568884,2639339,1214396,604783280,599772663
29380643_1214442,CM021107.1,8,29380643,603568884,2639339,1214442,604783326,599772709
29380643_1214476,CM021107.1,8,29380643,603568884,2639339,1214476,604783360,599772743
29377344_1234606,CM021107.1,8,29377344,603568885,1436279,1234606,604803491,599792874
29377344_1234613,CM021107.1,8,29377344,603568885,1436279,1234613,604803498,599792881
29377344_1234623,CM021107.1,8,29377344,603568885,1436279,1234623,604803508,599792891
29377344_1234632,CM021107.1,8,29377344,603568885,1436279,1234632,604803517,599792900
29377344_1234633,CM021107.1,8,29377344,603568885,1436279,1234633,604803518,599792901
29377344_1241595,CM021107.1,8,29377344,603568885,1436279,1241595,604810480,599799863
29377344_1241672,CM021107.1,8,29377344,603568885,1436279,1241672,604810557,599799940
29377344_1241714,CM021107.1,8,29377344,603568885,1436279,1241714,604810599,599799982
29377344_1241868,CM021107.1,8,29377344,603568885,1436279,1241868,604810753,599800136
29377344_1360198,CM021107.1,8,29377344,603568885,1436279,1360198,604929083,599918466
29377344_1360310,CM021107.1,8,29377344,603568885,1436279,1360310,604929195,599918578
29377344_1360392,CM021107.1,8,29377344,603568885,1436279,1360392,604929277,599918660
29377344_1360405,CM021107.1,8,29377344,603568885,1436279,1360405,604929290,599918673
29379494_1705181,CM021107.1,8,29379494,603568883,3502666,1705181,605274064,600263447
29379494_1705196,CM021107.1,8,29379494,603568883,3502666,1705196,605274079,600263462
29379494_1705239,CM021107.1,8,29379494,603568883,3502666,1705239,605274122,600263505
29379494_1705250,CM021107.1,8,29379494,603568883,3502666,1705250,605274133,600263516
29379494_2284043,CM021107.1,8,29379494,603568883,3502666,2284043,605852926,600842309
29380643_2592169,CM021107.1,8,29380643,603568884,2639339,2592169,606161053,601150436
29374774_37274,CM021107.1,8,29374774,623123619,39659,37274,623160893,618150276
29374774_37311,CM021107.1,8,29374774,623123619,39659,37311,623160930,618150313
29374774_37312,CM021107.1,8,29374774,623123619,39659,37312,623160931,618150314
29374774_37314,CM021107.1,8,29374774,623123619,39659,37314,623160933,618150316
29374774_37330,CM021107.1,8,29374774,623123619,39659,37330,623160949,618150332
29381258_171249,CM021107.1,8,29381258,632537686,1982007,171249,632708935,627698318
29378876_189403,CM021107.1,8,29378876,632536667,6622742,189403,632726070,627715453
29378876_189453,CM021107.1,8,29378876,632536667,6622742,189453,632726120,627715503
29378876_189478,CM021107.1,8,29378876,632536667,6622742,189478,632726145,627715528
29378876_232686,CM021107.1,8,29378876,632536667,6622742,232686,632769353,627758736
29378876_273256,CM021107.1,8,29378876,632536667,6622742,273256,632809923,627799306
29378876_273312,CM021107.1,8,29378876,632536667,6622742,273312,632809979,627799362
29377465_925939,CM021107.1,8,29377465,632533612,1160780,925939,633459551,628448934
29377465_925982,CM021107.1,8,29377465,632533612,1160780,925982,633459594,628448977
29377465_929119,CM021107.1,8,29377465,632533612,1160780,929119,633462731,628452114
29380731_1138837,CM021107.1,8,29380731,632538240,1140429,1138837,633677077,628666460
29378876_3289178,CM021107.1,8,29378876,632536667,6622742,3289178,635825845,630815228
29378876_3289185,CM021107.1,8,29378876,632536667,6622742,3289185,635825852,630815235
29378876_3289197,CM021107.1,8,29378876,632536667,6622742,3289197,635825864,630815247
29378876_3289204,CM021107.1,8,29378876,632536667,6622742,3289204,635825871,630815254
29378876_4667764,CM021107.1,8,29378876,632536667,6622742,4667764,637204431,632193814
29378876_4667792,CM021107.1,8,29378876,632536667,6622742,4667792,637204459,632193842
29378876_4671864,CM021107.1,8,29378876,632536667,6622742,4671864,637208531,632197914
29378876_4675398,CM021107.1,8,29378876,632536667,6622742,4675398,637212065,632201448
29378876_4675417,CM021107.1,8,29378876,632536667,6622742,4675417,637212084,632201467
29378876_4712625,CM021107.1,8,29378876,632536667,6622742,4712625,637249292,632238675
29378876_4712676,CM021107.1,8,29378876,632536667,6622742,4712676,637249343,632238726
29378876_4712761,CM021107.1,8,29378876,632536667,6622742,4712761,637249428,632238811
29377524_458034,CM021108.1,9,29377524,3433703,2319272,458034,3891737,455964
29377524_458036,CM021108.1,9,29377524,3433703,2319272,458036,3891739,455966
29377524_458182,CM021108.1,9,29377524,3433703,2319272,458182,3891885,456112
29379608_1274099,CM021108.1,9,29379608,3435773,2560641,1274099,4709872,1274099
29379608_1398736,CM021108.1,9,29379608,3435773,2560641,1398736,4834509,1398736
29379608_1398816,CM021108.1,9,29379608,3435773,2560641,1398816,4834589,1398816
29379608_1398845,CM021108.1,9,29379608,3435773,2560641,1398845,4834618,1398845
29379608_1398871,CM021108.1,9,29379608,3435773,2560641,1398871,4834644,1398871
29379608_1566203,CM021108.1,9,29379608,3435773,2560641,1566203,5001976,1566203
29379608_1677862,CM021108.1,9,29379608,3435773,2560641,1677862,5113635,1677862
29379608_1893316,CM021108.1,9,29379608,3435773,2560641,1893316,5329089,1893316
29379608_1893318,CM021108.1,9,29379608,3435773,2560641,1893318,5329091,1893318
29379608_1893518,CM021108.1,9,29379608,3435773,2560641,1893518,5329291,1893518
29379608_1917410,CM021108.1,9,29379608,3435773,2560641,1917410,5353183,1917410
29379608_1947343,CM021108.1,9,29379608,3435773,2560641,1947343,5383116,1947343
29379608_1984271,CM021108.1,9,29379608,3435773,2560641,1984271,5420044,1984271
29379608_2004951,CM021108.1,9,29379608,3435773,2560641,2004951,5440724,2004951
29379608_2004997,CM021108.1,9,29379608,3435773,2560641,2004997,5440770,2004997
29379608_2035393,CM021108.1,9,29379608,3435773,2560641,2035393,5471166,2035393
29379608_2035396,CM021108.1,9,29379608,3435773,2560641,2035396,5471169,2035396
29379608_2035411,CM021108.1,9,29379608,3435773,2560641,2035411,5471184,2035411
29379608_2124833,CM021108.1,9,29379608,3435773,2560641,2124833,5560606,2124833
29379608_2124924,CM021108.1,9,29379608,3435773,2560641,2124924,5560697,2124924
29379608_2124925,CM021108.1,9,29379608,3435773,2560641,2124925,5560698,2124925
29379245_2144,CM021108.1,9,29379245,8835643,2222014,2144,8837787,5402014
29379245_2634,CM021108.1,9,29379245,8835643,2222014,2634,8838277,5402504
29379245_4947,CM021108.1,9,29379245,8835643,2222014,4947,8840590,5404817
29379245_4992,CM021108.1,9,29379245,8835643,2222014,4992,8840635,5404862
29379245_26694,CM021108.1,9,29379245,8835643,2222014,26694,8862337,5426564
29379245_27269,CM021108.1,9,29379245,8835643,2222014,27269,8862912,5427139
29379245_191447,CM021108.1,9,29379245,8835643,2222014,191447,9027090,5591317
29379245_191465,CM021108.1,9,29379245,8835643,2222014,191465,9027108,5591335
29341164_482171,CM021108.1,9,29341164,8835643,552167,482171,9317814,5882041
29341164_482506,CM021108.1,9,29341164,8835643,552167,482506,9318149,5882376
29341164_491183,CM021108.1,9,29341164,8835643,552167,491183,9326826,5891053
29341164_491194,CM021108.1,9,29341164,8835643,552167,491194,9326837,5891064
29341164_534437,CM021108.1,9,29341164,8835643,552167,534437,9370080,5934307
29341164_534512,CM021108.1,9,29341164,8835643,552167,534512,9370155,5934382
29341164_534808,CM021108.1,9,29341164,8835643,552167,534808,9370451,5934678
29341164_534811,CM021108.1,9,29341164,8835643,552167,534811,9370454,5934681
29379245_1672691,CM021108.1,9,29379245,8835643,2222014,1672691,10508334,7072561
29379245_1949380,CM021108.1,9,29379245,8835643,2222014,1949380,10785023,7349250
29340872_3474,CM021108.1,9,29340872,24542995,95585,3474,24546469,21110696
29340872_3515,CM021108.1,9,29340872,24542995,95585,3515,24546510,21110737
29340872_3522,CM021108.1,9,29340872,24542995,95585,3522,24546517,21110744
29382134_426792,CM021108.1,9,29382134,24540716,673453,426792,24967508,21531735
29382134_427468,CM021108.1,9,29382134,24540716,673453,427468,24968184,21532411
29378670_218903,CM021108.1,9,29378670,25533423,327969,218903,25752326,22316553
29378670_219101,CM021108.1,9,29378670,25533423,327969,219101,25752524,22316751
29378670_222907,CM021108.1,9,29378670,25533423,327969,222907,25756330,22320557
29378670_222913,CM021108.1,9,29378670,25533423,327969,222913,25756336,22320563
29378670_222934,CM021108.1,9,29378670,25533423,327969,222934,25756357,22320584
29378670_223005,CM021108.1,9,29378670,25533423,327969,223005,25756428,22320655
29378670_223026,CM021108.1,9,29378670,25533423,327969,223026,25756449,22320676
29378670_223080,CM021108.1,9,29378670,25533423,327969,223080,25756503,22320730
29378670_223089,CM021108.1,9,29378670,25533423,327969,223089,25756512,22320739
29378670_223100,CM021108.1,9,29378670,25533423,327969,223100,25756523,22320750
29378670_223117,CM021108.1,9,29378670,25533423,327969,223117,25756540,22320767
29378670_223132,CM021108.1,9,29378670,25533423,327969,223132,25756555,22320782
29378999_2551966,CM021108.1,9,29378999,25531429,2883562,2551966,28083395,24647622
29377512_3762712,CM021108.1,9,29377512,25532482,5028872,3762712,29295194,25859421
29377512_3868477,CM021108.1,9,29377512,25532482,5028872,3868477,29400959,25965186
29377512_3868479,CM021108.1,9,29377512,25532482,5028872,3868479,29400961,25965188
29377512_3868586,CM021108.1,9,29377512,25532482,5028872,3868586,29401068,25965295
29377512_4820059,CM021108.1,9,29377512,25532482,5028872,4820059,30352541,26916768
29377512_4820096,CM021108.1,9,29377512,25532482,5028872,4820096,30352578,26916805
29379500_97179,CM021108.1,9,29379500,44362992,1415556,97179,44460171,41024398
29379500_97613,CM021108.1,9,29379500,44362992,1415556,97613,44460605,41024832
29380091_108337,CM021108.1,9,29380091,44370296,485072,108337,44478633,41042860
29380091_108390,CM021108.1,9,29380091,44370296,485072,108390,44478686,41042913
29379500_210203,CM021108.1,9,29379500,44362992,1415556,210203,44573195,41137422
29379500_210236,CM021108.1,9,29379500,44362992,1415556,210236,44573228,41137455
29379500_210334,CM021108.1,9,29379500,44362992,1415556,210334,44573326,41137553
29380478_345332,CM021108.1,9,29380478,44370153,2899843,345332,44715485,41279712
29380478_367830,CM021108.1,9,29380478,44370153,2899843,367830,44737983,41302210
29381585_370446,CM021108.1,9,29381585,44373066,1060114,370446,44743512,41307739
29381585_370456,CM021108.1,9,29381585,44373066,1060114,370456,44743522,41307749
29381585_370474,CM021108.1,9,29381585,44373066,1060114,370474,44743540,41307767
29379500_540280,CM021108.1,9,29379500,44362992,1415556,540280,44903272,41467499
29379500_540635,CM021108.1,9,29379500,44362992,1415556,540635,44903627,41467854
29380478_835693,CM021108.1,9,29380478,44370153,2899843,835693,45205846,41770073
29380478_878283,CM021108.1,9,29380478,44370153,2899843,878283,45248436,41812663
29381585_1057170,CM021108.1,9,29381585,44373066,1060114,1057170,45430236,41994463
29380478_2566493,CM021108.1,9,29380478,44370153,2899843,2566493,46936646,43500873
29380478_2567955,CM021108.1,9,29380478,44370153,2899843,2567955,46938108,43502335
29380013_2835258,CM021108.1,9,29380013,44370056,13833396,2835258,47205314,43769541
29380013_2835259,CM021108.1,9,29380013,44370056,13833396,2835259,47205315,43769542
29380013_2835266,CM021108.1,9,29380013,44370056,13833396,2835266,47205322,43769549
29380013_2835267,CM021108.1,9,29380013,44370056,13833396,2835267,47205323,43769550
29380013_2835278,CM021108.1,9,29380013,44370056,13833396,2835278,47205334,43769561
29380013_2835291,CM021108.1,9,29380013,44370056,13833396,2835291,47205347,43769574
29380013_2885745,CM021108.1,9,29380013,44370056,13833396,2885745,47255801,43820028
29380013_2979894,CM021108.1,9,29380013,44370056,13833396,2979894,47349950,43914177
29380013_2979960,CM021108.1,9,29380013,44370056,13833396,2979960,47350016,43914243
29380013_2979961,CM021108.1,9,29380013,44370056,13833396,2979961,47350017,43914244
29380013_2980034,CM021108.1,9,29380013,44370056,13833396,2980034,47350090,43914317
29380013_2980058,CM021108.1,9,29380013,44370056,13833396,2980058,47350114,43914341
29380013_2980093,CM021108.1,9,29380013,44370056,13833396,2980093,47350149,43914376
29379229_849903,CM021108.1,9,29379229,46603426,1136989,849903,47453329,44017556
29379229_849915,CM021108.1,9,29379229,46603426,1136989,849915,47453341,44017568
29379229_968492,CM021108.1,9,29379229,46603426,1136989,968492,47571918,44136145
29379229_968510,CM021108.1,9,29379229,46603426,1136989,968510,47571936,44136163
29379229_1018712,CM021108.1,9,29379229,46603426,1136989,1018712,47622138,44186365
29379229_1018813,CM021108.1,9,29379229,46603426,1136989,1018813,47622239,44186466
29380013_4442090,CM021108.1,9,29380013,44370056,13833396,4442090,48812146,45376373
29380013_4525535,CM021108.1,9,29380013,44370056,13833396,4525535,48895591,45459818
29380013_4525688,CM021108.1,9,29380013,44370056,13833396,4525688,48895744,45459971
29380013_4528263,CM021108.1,9,29380013,44370056,13833396,4528263,48898319,45462546
29380013_4957294,CM021108.1,9,29380013,44370056,13833396,4957294,49327350,45891577
29380013_4957295,CM021108.1,9,29380013,44370056,13833396,4957295,49327351,45891578
29380013_4957362,CM021108.1,9,29380013,44370056,13833396,4957362,49327418,45891645
29380013_6565429,CM021108.1,9,29380013,44370056,13833396,6565429,50935485,47499712
29380013_6565487,CM021108.1,9,29380013,44370056,13833396,6565487,50935543,47499770
29380013_6565512,CM021108.1,9,29380013,44370056,13833396,6565512,50935568,47499795
29380013_6565532,CM021108.1,9,29380013,44370056,13833396,6565532,50935588,47499815
29380013_7625576,CM021108.1,9,29380013,44370056,13833396,7625576,51995632,48559859
29380013_8183281,CM021108.1,9,29380013,44370056,13833396,8183281,52553337,49117564
29380013_8629288,CM021108.1,9,29380013,44370056,13833396,8629288,52999344,49563571
29380013_8692284,CM021108.1,9,29380013,44370056,13833396,8692284,53062340,49626567
29380013_8724917,CM021108.1,9,29380013,44370056,13833396,8724917,53094973,49659200
29376588_57734,CM021108.1,9,29376588,54596004,280194,57734,54653738,51217965
29376588_99268,CM021108.1,9,29376588,54596004,280194,99268,54695272,51259499
29376588_113354,CM021108.1,9,29376588,54596004,280194,113354,54709358,51273585
29376588_166991,CM021108.1,9,29376588,54596004,280194,166991,54762995,51327222
29376588_167001,CM021108.1,9,29376588,54596004,280194,167001,54763005,51327232
29376588_167020,CM021108.1,9,29376588,54596004,280194,167020,54763024,51327251
28503057_5736,CM021108.1,9,28503057,55089331,9377,5736,55095067,51659294
29380013_11659699,CM021108.1,9,29380013,44370056,13833396,11659699,56029755,52593982
29379979_172318,CM021108.1,9,29379979,57003812,3061203,172318,57176130,53740357
29379979_182936,CM021108.1,9,29379979,57003812,3061203,182936,57186748,53750975
29379979_182979,CM021108.1,9,29379979,57003812,3061203,182979,57186791,53751018
29380013_12828306,CM021108.1,9,29380013,44370056,13833396,12828306,57198362,53762589
29380013_12845945,CM021108.1,9,29380013,44370056,13833396,12845945,57216001,53780228
29378737_221000,CM021108.1,9,29378737,57004117,848084,221000,57225117,53789344
29378737_221591,CM021108.1,9,29378737,57004117,848084,221591,57225708,53789935
29378737_221596,CM021108.1,9,29378737,57004117,848084,221596,57225713,53789940
29378737_221611,CM021108.1,9,29378737,57004117,848084,221611,57225728,53789955
29378737_221617,CM021108.1,9,29378737,57004117,848084,221617,57225734,53789961
29378737_221800,CM021108.1,9,29378737,57004117,848084,221800,57225917,53790144
29378737_221822,CM021108.1,9,29378737,57004117,848084,221822,57225939,53790166
29378737_222265,CM021108.1,9,29378737,57004117,848084,222265,57226382,53790609
29378737_222309,CM021108.1,9,29378737,57004117,848084,222309,57226426,53790653
29378737_222313,CM021108.1,9,29378737,57004117,848084,222313,57226430,53790657
29380013_12878624,CM021108.1,9,29380013,44370056,13833396,12878624,57248680,53812907
29380013_12878638,CM021108.1,9,29380013,44370056,13833396,12878638,57248694,53812921
29380502_515506,CM021108.1,9,29380502,57003803,1017255,515506,57519309,54083536
29381733_532972,CM021108.1,9,29381733,57004354,2997271,532972,57537326,54101553
29377321_594833,CM021108.1,9,29377321,57003844,747207,594833,57598677,54162904
29379979_1060851,CM021108.1,9,29379979,57003812,3061203,1060851,58064663,54628890
29378068_1176026,CM021108.1,9,29378068,57003812,1210776,1176026,58179838,54744065
29378068_1176430,CM021108.1,9,29378068,57003812,1210776,1176430,58180242,54744469
29378068_1178933,CM021108.1,9,29378068,57003812,1210776,1178933,58182745,54746972
29378068_1179022,CM021108.1,9,29378068,57003812,1210776,1179022,58182834,54747061
29378068_1179104,CM021108.1,9,29378068,57003812,1210776,1179104,58182916,54747143
29379979_1363274,CM021108.1,9,29379979,57003812,3061203,1363274,58367086,54931313
29379979_1363281,CM021108.1,9,29379979,57003812,3061203,1363281,58367093,54931320
29381733_1375079,CM021108.1,9,29381733,57004354,2997271,1375079,58379433,54943660
29381733_1375199,CM021108.1,9,29381733,57004354,2997271,1375199,58379553,54943780
29379979_1434394,CM021108.1,9,29379979,57003812,3061203,1434394,58438206,55002433
29379979_1434425,CM021108.1,9,29379979,57003812,3061203,1434425,58438237,55002464
29379979_1643552,CM021108.1,9,29379979,57003812,3061203,1643552,58647364,55211591
29379979_2231803,CM021108.1,9,29379979,57003812,3061203,2231803,59235615,55799842
29379979_2258674,CM021108.1,9,29379979,57003812,3061203,2258674,59262486,55826713
29381733_2383292,CM021108.1,9,29381733,57004354,2997271,2383292,59387646,55951873
29381733_2399141,CM021108.1,9,29381733,57004354,2997271,2399141,59403495,55967722
28758155_5168,CM021108.1,9,28758155,66386584,5296,5168,66391752,62955979
29346405_33822,CM021108.1,9,29346405,66683143,66932,33822,66716965,63281192
29346405_33887,CM021108.1,9,29346405,66683143,66932,33887,66717030,63281257
29346405_39646,CM021108.1,9,29346405,66683143,66932,39646,66722789,63287016
29346405_39650,CM021108.1,9,29346405,66683143,66932,39650,66722793,63287020
29346405_39654,CM021108.1,9,29346405,66683143,66932,39654,66722797,63287024
29346405_39710,CM021108.1,9,29346405,66683143,66932,39710,66722853,63287080
29346405_39714,CM021108.1,9,29346405,66683143,66932,39714,66722857,63287084
29370781_2497,CM021108.1,9,29370781,79249711,8916,2497,79252208,75816435
29370781_2538,CM021108.1,9,29370781,79249711,8916,2538,79252249,75816476
28454832_6791,CM021108.1,9,28454832,79277775,9434,6791,79284566,75848793
28454832_6792,CM021108.1,9,28454832,79277775,9434,6792,79284567,75848794
28454832_6808,CM021108.1,9,28454832,79277775,9434,6808,79284583,75848810
28454832_6894,CM021108.1,9,28454832,79277775,9434,6894,79284669,75848896
28454832_6926,CM021108.1,9,28454832,79277775,9434,6926,79284701,75848928
29380136_45160,CM021108.1,9,29380136,89269865,424214,45160,89315025,85879252
29381876_75937,CM021108.1,9,29381876,89269350,708433,75937,89345287,85909514
29381876_75987,CM021108.1,9,29381876,89269350,708433,75987,89345337,85909564
29381876_76017,CM021108.1,9,29381876,89269350,708433,76017,89345367,85909594
29381876_76018,CM021108.1,9,29381876,89269350,708433,76018,89345368,85909595
29379999_116301,CM021108.1,9,29379999,89269349,624107,116301,89385650,85949877
29379999_116316,CM021108.1,9,29379999,89269349,624107,116316,89385665,85949892
29379999_257408,CM021108.1,9,29379999,89269349,624107,257408,89526757,86090984
29379999_257555,CM021108.1,9,29379999,89269349,624107,257555,89526904,86091131
29379999_281692,CM021108.1,9,29379999,89269349,624107,281692,89551041,86115268
29363748_442075,CM021108.1,9,29363748,89269352,1008305,442075,89711427,86275654
29363748_442164,CM021108.1,9,29363748,89269352,1008305,442164,89711516,86275743
29363748_462472,CM021108.1,9,29363748,89269352,1008305,462472,89731824,86296051
29363748_595595,CM021108.1,9,29363748,89269352,1008305,595595,89864947,86429174
29363748_595674,CM021108.1,9,29363748,89269352,1008305,595674,89865026,86429253
29363748_595678,CM021108.1,9,29363748,89269352,1008305,595678,89865030,86429257
29363748_595704,CM021108.1,9,29363748,89269352,1008305,595704,89865056,86429283
29363748_728938,CM021108.1,9,29363748,89269352,1008305,728938,89998290,86562517
29381526_913965,CM021108.1,9,29381526,89269350,3203603,913965,90183315,86747542
29381526_993313,CM021108.1,9,29381526,89269350,3203603,993313,90262663,86826890
29381526_1053882,CM021108.1,9,29381526,89269350,3203603,1053882,90323232,86887459
29381526_1053937,CM021108.1,9,29381526,89269350,3203603,1053937,90323287,86887514
29381526_1124141,CM021108.1,9,29381526,89269350,3203603,1124141,90393491,86957718
29381526_1124258,CM021108.1,9,29381526,89269350,3203603,1124258,90393608,86957835
29381526_1127018,CM021108.1,9,29381526,89269350,3203603,1127018,90396368,86960595
29381526_2995183,CM021108.1,9,29381526,89269350,3203603,2995183,92264533,88828760
29381526_2995204,CM021108.1,9,29381526,89269350,3203603,2995204,92264554,88828781
29381526_2995206,CM021108.1,9,29381526,89269350,3203603,2995206,92264556,88828783
29381526_2995232,CM021108.1,9,29381526,89269350,3203603,2995232,92264582,88828809
29381526_2995233,CM021108.1,9,29381526,89269350,3203603,2995233,92264583,88828810
29381526_2995289,CM021108.1,9,29381526,89269350,3203603,2995289,92264639,88828866
29381526_2995329,CM021108.1,9,29381526,89269350,3203603,2995329,92264679,88828906
293703735_280346,CM021108.1,9,293703735,95706197,617705,280346,95986543,92550770
29378899_673177,CM021108.1,9,29378899,95704539,680760,673177,96377716,92941943
29380524_1567,CM021108.1,9,29380524,98432613,94644,1567,98434180,94998407
29382321_19323,CM021108.1,9,29382321,98425127,652178,19323,98444450,95008677
29335619_112579,CM021108.1,9,29335619,98425133,445229,112579,98537712,95101939
29380480_163087,CM021108.1,9,29380480,101987004,501185,163087,102150091,98714318
29380480_163100,CM021108.1,9,29380480,101987004,501185,163100,102150104,98714331
29380480_163200,CM021108.1,9,29380480,101987004,501185,163200,102150204,98714431
29380480_163261,CM021108.1,9,29380480,101987004,501185,163261,102150265,98714492
29380480_205334,CM021108.1,9,29380480,101987004,501185,205334,102192338,98756565
29380480_205335,CM021108.1,9,29380480,101987004,501185,205335,102192339,98756566
29380480_205410,CM021108.1,9,29380480,101987004,501185,205410,102192414,98756641
29380480_205421,CM021108.1,9,29380480,101987004,501185,205421,102192425,98756652
29380480_205572,CM021108.1,9,29380480,101987004,501185,205572,102192576,98756803
29380480_265693,CM021108.1,9,29380480,101987004,501185,265693,102252697,98816924
29380480_316663,CM021108.1,9,29380480,101987004,501185,316663,102303667,98867894
29380480_374394,CM021108.1,9,29380480,101987004,501185,374394,102361398,98925625
29380480_374596,CM021108.1,9,29380480,101987004,501185,374596,102361600,98925827
29380480_374615,CM021108.1,9,29380480,101987004,501185,374615,102361619,98925846
29379588_443555,CM021108.1,9,29379588,101987905,1079549,443555,102431460,98995687
29379588_443663,CM021108.1,9,29379588,101987905,1079549,443663,102431568,98995795
29379588_443825,CM021108.1,9,29379588,101987905,1079549,443825,102431730,98995957
29379588_443931,CM021108.1,9,29379588,101987905,1079549,443931,102431836,98996063
29379588_444038,CM021108.1,9,29379588,101987905,1079549,444038,102431943,98996170
29379588_444243,CM021108.1,9,29379588,101987905,1079549,444243,102432148,98996375
29379588_463357,CM021108.1,9,29379588,101987905,1079549,463357,102451262,99015489
29379588_463466,CM021108.1,9,29379588,101987905,1079549,463466,102451371,99015598
29379588_463467,CM021108.1,9,29379588,101987905,1079549,463467,102451372,99015599
29379588_463526,CM021108.1,9,29379588,101987905,1079549,463526,102451431,99015658
29378654_511949,CM021108.1,9,29378654,101987004,2269096,511949,102498953,99063180
29380093_885633,CM021108.1,9,29380093,101987000,1533896,885633,102872633,99436860
29380093_885692,CM021108.1,9,29380093,101987000,1533896,885692,102872692,99436919
29380093_891863,CM021108.1,9,29380093,101987000,1533896,891863,102878863,99443090
29379588_905216,CM021108.1,9,29379588,101987905,1079549,905216,102893121,99457348
29379588_905235,CM021108.1,9,29379588,101987905,1079549,905235,102893140,99457367
29379588_905236,CM021108.1,9,29379588,101987905,1079549,905236,102893141,99457368
29379588_905279,CM021108.1,9,29379588,101987905,1079549,905279,102893184,99457411
29380093_920586,CM021108.1,9,29380093,101987000,1533896,920586,102907586,99471813
29380093_920685,CM021108.1,9,29380093,101987000,1533896,920685,102907685,99471912
29380093_924075,CM021108.1,9,29380093,101987000,1533896,924075,102911075,99475302
29380093_1180053,CM021108.1,9,29380093,101987000,1533896,1180053,103167053,99731280
29378909_1208387,CM021108.1,9,29378909,101987063,2437550,1208387,103195450,99759677
29378909_1208453,CM021108.1,9,29378909,101987063,2437550,1208453,103195516,99759743
29378909_1209477,CM021108.1,9,29378909,101987063,2437550,1209477,103196540,99760767
29378909_1237913,CM021108.1,9,29378909,101987063,2437550,1237913,103224976,99789203
29378909_1237939,CM021108.1,9,29378909,101987063,2437550,1237939,103225002,99789229
29378654_1254724,CM021108.1,9,29378654,101987004,2269096,1254724,103241728,99805955
29378909_2001903,CM021108.1,9,29378909,101987063,2437550,2001903,103988966,100553193
29378909_2002212,CM021108.1,9,29378909,101987063,2437550,2002212,103989275,100553502
29378909_2003278,CM021108.1,9,29378909,101987063,2437550,2003278,103990341,100554568
29378909_2003329,CM021108.1,9,29378909,101987063,2437550,2003329,103990392,100554619
29378909_2003450,CM021108.1,9,29378909,101987063,2437550,2003450,103990513,100554740
29378909_2202555,CM021108.1,9,29378909,101987063,2437550,2202555,104189618,100753845
29378909_2202613,CM021108.1,9,29378909,101987063,2437550,2202613,104189676,100753903
29378909_2202652,CM021108.1,9,29378909,101987063,2437550,2202652,104189715,100753942
29380989_37254,CM021108.1,9,29380989,104460131,378159,37254,104497385,101061612
29380989_37255,CM021108.1,9,29380989,104460131,378159,37255,104497386,101061613
29380989_37264,CM021108.1,9,29380989,104460131,378159,37264,104497395,101061622
29378207_43208,CM021108.1,9,29378207,104461204,2374534,43208,104504412,101068639
29378207_43273,CM021108.1,9,29378207,104461204,2374534,43273,104504477,101068704
29378207_43839,CM021108.1,9,29378207,104461204,2374534,43839,104505043,101069270
29378207_44052,CM021108.1,9,29378207,104461204,2374534,44052,104505256,101069483
29378497_46521,CM021108.1,9,29378497,104459273,6454536,46521,104505794,101070021
29378497_46549,CM021108.1,9,29378497,104459273,6454536,46549,104505822,101070049
29381668_57375,CM021108.1,9,29381668,104456963,3038979,57375,104514338,101078565
29381668_57477,CM021108.1,9,29381668,104456963,3038979,57477,104514440,101078667
29378329_62024,CM021108.1,9,29378329,104454409,410512,62024,104516433,101080660
29378329_62045,CM021108.1,9,29378329,104454409,410512,62045,104516454,101080681
29377393_63747,CM021108.1,9,29377393,104454408,2144560,63747,104518155,101082382
29377393_63784,CM021108.1,9,29377393,104454408,2144560,63784,104518192,101082419
29378329_65577,CM021108.1,9,29378329,104454409,410512,65577,104519986,101084213
29378329_65579,CM021108.1,9,29378329,104454409,410512,65579,104519988,101084215
29378329_65968,CM021108.1,9,29378329,104454409,410512,65968,104520377,101084604
29378353_76939,CM021108.1,9,29378353,104454408,678950,76939,104531347,101095574
29378353_76978,CM021108.1,9,29378353,104454408,678950,76978,104531386,101095613
29377189_82791,CM021108.1,9,29377189,104460057,1374627,82791,104542848,101107075
29377189_82842,CM021108.1,9,29377189,104460057,1374627,82842,104542899,101107126
29377189_82885,CM021108.1,9,29377189,104460057,1374627,82885,104542942,101107169
29377189_84477,CM021108.1,9,29377189,104460057,1374627,84477,104544534,101108761
29377189_84558,CM021108.1,9,29377189,104460057,1374627,84558,104544615,101108842
29377189_85075,CM021108.1,9,29377189,104460057,1374627,85075,104545132,101109359
29378329_168160,CM021108.1,9,29378329,104454409,410512,168160,104622569,101186796
29378329_168209,CM021108.1,9,29378329,104454409,410512,168209,104622618,101186845
29378329_168218,CM021108.1,9,29378329,104454409,410512,168218,104622627,101186854
29380989_175814,CM021108.1,9,29380989,104460131,378159,175814,104635945,101200172
29380989_175816,CM021108.1,9,29380989,104460131,378159,175816,104635947,101200174
29380989_175829,CM021108.1,9,29380989,104460131,378159,175829,104635960,101200187
29380989_175918,CM021108.1,9,29380989,104460131,378159,175918,104636049,101200276
29380989_175988,CM021108.1,9,29380989,104460131,378159,175988,104636119,101200346
29380989_175995,CM021108.1,9,29380989,104460131,378159,175995,104636126,101200353
29377095_203981,CM021108.1,9,29377095,104458869,2316258,203981,104662850,101227077
29377095_204328,CM021108.1,9,29377095,104458869,2316258,204328,104663197,101227424
29377095_206465,CM021108.1,9,29377095,104458869,2316258,206465,104665334,101229561
29379173_279555,CM021108.1,9,29379173,104460822,1370570,279555,104740377,101304604
29380045_409228,CM021108.1,9,29380045,104462030,1259398,409228,104871258,101435485
29380045_409280,CM021108.1,9,29380045,104462030,1259398,409280,104871310,101435537
29380045_409331,CM021108.1,9,29380045,104462030,1259398,409331,104871361,101435588
29380045_410861,CM021108.1,9,29380045,104462030,1259398,410861,104872891,101437118
29380045_411103,CM021108.1,9,29380045,104462030,1259398,411103,104873133,101437360
29380045_411133,CM021108.1,9,29380045,104462030,1259398,411133,104873163,101437390
29380045_411149,CM021108.1,9,29380045,104462030,1259398,411149,104873179,101437406
29380045_411184,CM021108.1,9,29380045,104462030,1259398,411184,104873214,101437441
29380045_426848,CM021108.1,9,29380045,104462030,1259398,426848,104888878,101453105
29380045_426853,CM021108.1,9,29380045,104462030,1259398,426853,104888883,101453110
29380045_439298,CM021108.1,9,29380045,104462030,1259398,439298,104901328,101465555
29380045_439305,CM021108.1,9,29380045,104462030,1259398,439305,104901335,101465562
29380045_440768,CM021108.1,9,29380045,104462030,1259398,440768,104902798,101467025
29380045_440773,CM021108.1,9,29380045,104462030,1259398,440773,104902803,101467030
29380045_440774,CM021108.1,9,29380045,104462030,1259398,440774,104902804,101467031
29380045_440834,CM021108.1,9,29380045,104462030,1259398,440834,104902864,101467091
29381668_466857,CM021108.1,9,29381668,104456963,3038979,466857,104923820,101488047
29381668_466872,CM021108.1,9,29381668,104456963,3038979,466872,104923835,101488062
29382169_465251,CM021108.1,9,29382169,104459648,1472583,465251,104924899,101489126
29382169_465299,CM021108.1,9,29382169,104459648,1472583,465299,104924947,101489174
29382169_465310,CM021108.1,9,29382169,104459648,1472583,465310,104924958,101489185
29382169_465344,CM021108.1,9,29382169,104459648,1472583,465344,104924992,101489219
29380045_482474,CM021108.1,9,29380045,104462030,1259398,482474,104944504,101508731
29380045_482492,CM021108.1,9,29380045,104462030,1259398,482492,104944522,101508749
29382430_537781,CM021108.1,9,29382430,104460889,1836880,537781,104998670,101562897
29380045_572974,CM021108.1,9,29380045,104462030,1259398,572974,105035004,101599231
29380045_573110,CM021108.1,9,29380045,104462030,1259398,573110,105035140,101599367
29380045_573143,CM021108.1,9,29380045,104462030,1259398,573143,105035173,101599400
29380045_573178,CM021108.1,9,29380045,104462030,1259398,573178,105035208,101599435
29380045_573212,CM021108.1,9,29380045,104462030,1259398,573212,105035242,101599469
29380045_573213,CM021108.1,9,29380045,104462030,1259398,573213,105035243,101599470
29380045_573255,CM021108.1,9,29380045,104462030,1259398,573255,105035285,101599512
29380045_574341,CM021108.1,9,29380045,104462030,1259398,574341,105036371,101600598
29380045_574365,CM021108.1,9,29380045,104462030,1259398,574365,105036395,101600622
29380045_574413,CM021108.1,9,29380045,104462030,1259398,574413,105036443,101600670
29380045_596698,CM021108.1,9,29380045,104462030,1259398,596698,105058728,101622955
29380045_597868,CM021108.1,9,29380045,104462030,1259398,597868,105059898,101624125
29380045_598030,CM021108.1,9,29380045,104462030,1259398,598030,105060060,101624287
29380045_598160,CM021108.1,9,29380045,104462030,1259398,598160,105060190,101624417
29380045_598162,CM021108.1,9,29380045,104462030,1259398,598162,105060192,101624419
29380045_598170,CM021108.1,9,29380045,104462030,1259398,598170,105060200,101624427
29362973_616168,CM021108.1,9,29362973,104462983,627706,616168,105079151,101643378
29377902_621116,CM021108.1,9,29377902,104460495,831301,621116,105081611,101645838
29362973_620494,CM021108.1,9,29362973,104462983,627706,620494,105083477,101647704
29382169_651523,CM021108.1,9,29382169,104459648,1472583,651523,105111171,101675398
29377189_700997,CM021108.1,9,29377189,104460057,1374627,700997,105161054,101725281
29377095_724028,CM021108.1,9,29377095,104458869,2316258,724028,105182897,101747124
29377902_761292,CM021108.1,9,29377902,104460495,831301,761292,105221787,101786014
29380241_771784,CM021108.1,9,29380241,104459813,2583736,771784,105231597,101795824
29380241_771829,CM021108.1,9,29380241,104459813,2583736,771829,105231642,101795869
29380241_772039,CM021108.1,9,29380241,104459813,2583736,772039,105231852,101796079
29382039_935484,CM021108.1,9,29382039,104460146,5291497,935484,105395630,101959857
29382430_937955,CM021108.1,9,29382430,104460889,1836880,937955,105398844,101963071
29377393_963121,CM021108.1,9,29377393,104454408,2144560,963121,105417529,101981756
29377393_1001581,CM021108.1,9,29377393,104454408,2144560,1001581,105455989,102020216
29379611_1002027,CM021108.1,9,29379611,104459265,1765746,1002027,105461292,102025519
29377189_1010169,CM021108.1,9,29377189,104460057,1374627,1010169,105470226,102034453
29378488_1038016,CM021108.1,9,29378488,104454408,6744213,1038016,105492424,102056651
29378207_1037320,CM021108.1,9,29378207,104461204,2374534,1037320,105498524,102062751
29378207_1037365,CM021108.1,9,29378207,104461204,2374534,1037365,105498569,102062796
29378207_1037376,CM021108.1,9,29378207,104461204,2374534,1037376,105498580,102062807
29378207_1037389,CM021108.1,9,29378207,104461204,2374534,1037389,105498593,102062820
29378207_1037439,CM021108.1,9,29378207,104461204,2374534,1037439,105498643,102062870
29377393_1158853,CM021108.1,9,29377393,104454408,2144560,1158853,105613261,102177488
29377368_1237425,CM021108.1,9,29377368,104460105,7506110,1237425,105697530,102261757
29377368_1237428,CM021108.1,9,29377368,104460105,7506110,1237428,105697533,102261760
29377368_1243074,CM021108.1,9,29377368,104460105,7506110,1243074,105703179,102267406
29377368_1243079,CM021108.1,9,29377368,104460105,7506110,1243079,105703184,102267411
29377368_1243103,CM021108.1,9,29377368,104460105,7506110,1243103,105703208,102267435
29378207_1323719,CM021108.1,9,29378207,104461204,2374534,1323719,105784923,102349150
29378207_1323751,CM021108.1,9,29378207,104461204,2374534,1323751,105784955,102349182
29378207_1354742,CM021108.1,9,29378207,104461204,2374534,1354742,105815946,102380173
29378207_1354744,CM021108.1,9,29378207,104461204,2374534,1354744,105815948,102380175
29378207_1355362,CM021108.1,9,29378207,104461204,2374534,1355362,105816566,102380793
29378207_1355422,CM021108.1,9,29378207,104461204,2374534,1355422,105816626,102380853
29378207_1696996,CM021108.1,9,29378207,104461204,2374534,1696996,106158200,102722427
29378207_1697551,CM021108.1,9,29378207,104461204,2374534,1697551,106158755,102722982
29378207_1697554,CM021108.1,9,29378207,104461204,2374534,1697554,106158758,102722985
29378207_1711303,CM021108.1,9,29378207,104461204,2374534,1711303,106172507,102736734
29380241_1841295,CM021108.1,9,29380241,104459813,2583736,1841295,106301108,102865335
29380241_1841442,CM021108.1,9,29380241,104459813,2583736,1841442,106301255,102865482
29380241_1841550,CM021108.1,9,29380241,104459813,2583736,1841550,106301363,102865590
29362754_4727,CM021108.1,9,29362754,106476284,15477,4727,106481011,103045238
29362754_4738,CM021108.1,9,29362754,106476284,15477,4738,106481022,103045249
29382039_2071792,CM021108.1,9,29382039,104460146,5291497,2071792,106531938,103096165
29381668_2160242,CM021108.1,9,29381668,104456963,3038979,2160242,106617205,103181432
29381668_2160298,CM021108.1,9,29381668,104456963,3038979,2160298,106617261,103181488
29381803_2271907,CM021108.1,9,29381803,104459718,2681012,2271907,106731625,103295852
29381803_2271964,CM021108.1,9,29381803,104459718,2681012,2271964,106731682,103295909
29382039_2417984,CM021108.1,9,29382039,104460146,5291497,2417984,106878130,103442357
29377450_2482855,CM021108.1,9,29377450,104454409,4176802,2482855,106937264,103501491
29377450_2482901,CM021108.1,9,29377450,104454409,4176802,2482901,106937310,103501537
29377450_2482910,CM021108.1,9,29377450,104454409,4176802,2482910,106937319,103501546
29382039_2501222,CM021108.1,9,29382039,104460146,5291497,2501222,106961368,103525595
29378488_2535302,CM021108.1,9,29378488,104454408,6744213,2535302,106989710,103553937
29378488_2535326,CM021108.1,9,29378488,104454408,6744213,2535326,106989734,103553961
29378488_2535327,CM021108.1,9,29378488,104454408,6744213,2535327,106989735,103553962
29378488_2535345,CM021108.1,9,29378488,104454408,6744213,2535345,106989753,103553980
29382039_2532151,CM021108.1,9,29382039,104460146,5291497,2532151,106992297,103556524
29382039_2532186,CM021108.1,9,29382039,104460146,5291497,2532186,106992332,103556559
29377368_2551399,CM021108.1,9,29377368,104460105,7506110,2551399,107011504,103575731
29377368_2551407,CM021108.1,9,29377368,104460105,7506110,2551407,107011512,103575739
29378488_2586591,CM021108.1,9,29378488,104454408,6744213,2586591,107040999,103605226
29378488_2587878,CM021108.1,9,29378488,104454408,6744213,2587878,107042286,103606513
29378488_2588739,CM021108.1,9,29378488,104454408,6744213,2588739,107043147,103607374
29378488_2588754,CM021108.1,9,29378488,104454408,6744213,2588754,107043162,103607389
29377368_2612469,CM021108.1,9,29377368,104460105,7506110,2612469,107072574,103636801
29377450_2630903,CM021108.1,9,29377450,104454409,4176802,2630903,107085312,103649539
29377368_2683061,CM021108.1,9,29377368,104460105,7506110,2683061,107143166,103707393
29377368_2683126,CM021108.1,9,29377368,104460105,7506110,2683126,107143231,103707458
29377368_2693923,CM021108.1,9,29377368,104460105,7506110,2693923,107154028,103718255
29381668_2707090,CM021108.1,9,29381668,104456963,3038979,2707090,107164053,103728280
29378488_2920024,CM021108.1,9,29378488,104454408,6744213,2920024,107374432,103938659
29378488_2920043,CM021108.1,9,29378488,104454408,6744213,2920043,107374451,103938678
29378488_2920064,CM021108.1,9,29378488,104454408,6744213,2920064,107374472,103938699
29378497_2940609,CM021108.1,9,29378497,104459273,6454536,2940609,107399882,103964109
29378488_2970454,CM021108.1,9,29378488,104454408,6744213,2970454,107424862,103989089
29378497_3034671,CM021108.1,9,29378497,104459273,6454536,3034671,107493944,104058171
29378497_3037237,CM021108.1,9,29378497,104459273,6454536,3037237,107496510,104060737
29377368_3069833,CM021108.1,9,29377368,104460105,7506110,3069833,107529938,104094165
29377368_3117339,CM021108.1,9,29377368,104460105,7506110,3117339,107577444,104141671
29377450_3193725,CM021108.1,9,29377450,104454409,4176802,3193725,107648134,104212361
29377450_3193748,CM021108.1,9,29377450,104454409,4176802,3193748,107648157,104212384
29378488_3557506,CM021108.1,9,29378488,104454408,6744213,3557506,108011914,104576141
29378488_3561136,CM021108.1,9,29378488,104454408,6744213,3561136,108015544,104579771
29377368_3610546,CM021108.1,9,29377368,104460105,7506110,3610546,108070651,104634878
29377368_3610570,CM021108.1,9,29377368,104460105,7506110,3610570,108070675,104634902
29377368_3610576,CM021108.1,9,29377368,104460105,7506110,3610576,108070681,104634908
29377450_3891672,CM021108.1,9,29377450,104454409,4176802,3891672,108346081,104910308
29377450_4090505,CM021108.1,9,29377450,104454409,4176802,4090505,108544914,105109141
29377450_4114785,CM021108.1,9,29377450,104454409,4176802,4114785,108569194,105133421
29377450_4121785,CM021108.1,9,29377450,104454409,4176802,4121785,108576194,105140421
29377450_4129845,CM021108.1,9,29377450,104454409,4176802,4129845,108584254,105148481
29377450_4160777,CM021108.1,9,29377450,104454409,4176802,4160777,108615186,105179413
29377450_4160864,CM021108.1,9,29377450,104454409,4176802,4160864,108615273,105179500
29377450_4160879,CM021108.1,9,29377450,104454409,4176802,4160879,108615288,105179515
29377368_4518671,CM021108.1,9,29377368,104460105,7506110,4518671,108978776,105543003
29377368_4521670,CM021108.1,9,29377368,104460105,7506110,4521670,108981775,105546002
29377368_4521702,CM021108.1,9,29377368,104460105,7506110,4521702,108981807,105546034
29377368_4522297,CM021108.1,9,29377368,104460105,7506110,4522297,108982402,105546629
29377368_4522452,CM021108.1,9,29377368,104460105,7506110,4522452,108982557,105546784
29382039_4655094,CM021108.1,9,29382039,104460146,5291497,4655094,109115240,105679467
29378488_4704257,CM021108.1,9,29378488,104454408,6744213,4704257,109158665,105722892
29378488_4704477,CM021108.1,9,29378488,104454408,6744213,4704477,109158885,105723112
29194803_1861,CM021108.1,9,29194803,109518472,9032,1861,109520333,106084560
29378488_6700512,CM021108.1,9,29378488,104454408,6744213,6700512,111154920,107719147
29382247_46857,CM021108.1,9,29382247,144956012,1253704,46857,145002869,141567096
29382247_47643,CM021108.1,9,29382247,144956012,1253704,47643,145003655,141567882
29382247_47659,CM021108.1,9,29382247,144956012,1253704,47659,145003671,141567898
29378662_62157,CM021108.1,9,29378662,144955667,661056,62157,145017824,141582051
29382247_111286,CM021108.1,9,29382247,144956012,1253704,111286,145067298,141631525
29382247_111318,CM021108.1,9,29382247,144956012,1253704,111318,145067330,141631557
29382247_111379,CM021108.1,9,29382247,144956012,1253704,111379,145067391,141631618
29380162_278799,CM021108.1,9,29380162,144955373,382365,278799,145234172,141798399
29378171_449847,CM021108.1,9,29378171,144955375,2324775,449847,145405222,141969449
29378171_450610,CM021108.1,9,29378171,144955375,2324775,450610,145405985,141970212
29378171_450617,CM021108.1,9,29378171,144955375,2324775,450617,145405992,141970219
29378171_621842,CM021108.1,9,29378171,144955375,2324775,621842,145577217,142141444
29378171_621925,CM021108.1,9,29378171,144955375,2324775,621925,145577300,142141527
29378171_621979,CM021108.1,9,29378171,144955375,2324775,621979,145577354,142141581
29378171_621990,CM021108.1,9,29378171,144955375,2324775,621990,145577365,142141592
29378171_622014,CM021108.1,9,29378171,144955375,2324775,622014,145577389,142141616
29378171_622114,CM021108.1,9,29378171,144955375,2324775,622114,145577489,142141716
29378171_622168,CM021108.1,9,29378171,144955375,2324775,622168,145577543,142141770
29378171_622192,CM021108.1,9,29378171,144955375,2324775,622192,145577567,142141794
29378171_622230,CM021108.1,9,29378171,144955375,2324775,622230,145577605,142141832
29378171_622253,CM021108.1,9,29378171,144955375,2324775,622253,145577628,142141855
29378171_622254,CM021108.1,9,29378171,144955375,2324775,622254,145577629,142141856
29380481_640910,CM021108.1,9,29380481,144955377,2083219,640910,145596287,142160514
29380481_640939,CM021108.1,9,29380481,144955377,2083219,640939,145596316,142160543
29380481_640948,CM021108.1,9,29380481,144955377,2083219,640948,145596325,142160552
29380481_640969,CM021108.1,9,29380481,144955377,2083219,640969,145596346,142160573
29380481_640982,CM021108.1,9,29380481,144955377,2083219,640982,145596359,142160586
29380481_640985,CM021108.1,9,29380481,144955377,2083219,640985,145596362,142160589
29380481_640988,CM021108.1,9,29380481,144955377,2083219,640988,145596365,142160592
29380481_641087,CM021108.1,9,29380481,144955377,2083219,641087,145596464,142160691
29382212_693832,CM021108.1,9,29382212,144955371,2006050,693832,145649203,142213430
29378171_802037,CM021108.1,9,29378171,144955375,2324775,802037,145757412,142321639
29378171_802248,CM021108.1,9,29378171,144955375,2324775,802248,145757623,142321850
29382078_856612,CM021108.1,9,29382078,144955374,2180240,856612,145811986,142376213
29378171_868616,CM021108.1,9,29378171,144955375,2324775,868616,145823991,142388218
29382078_891996,CM021108.1,9,29382078,144955374,2180240,891996,145847370,142411597
29382078_892200,CM021108.1,9,29382078,144955374,2180240,892200,145847574,142411801
29380133_970986,CM021108.1,9,29380133,144955374,4065675,970986,145926360,142490587
29378478_1029274,CM021108.1,9,29378478,144957126,4495770,1029274,145986400,142550627
29378478_1029400,CM021108.1,9,29378478,144957126,4495770,1029400,145986526,142550753
29378478_1029421,CM021108.1,9,29378478,144957126,4495770,1029421,145986547,142550774
29378478_1029445,CM021108.1,9,29378478,144957126,4495770,1029445,145986571,142550798
29378478_1031346,CM021108.1,9,29378478,144957126,4495770,1031346,145988472,142552699
29378478_1031712,CM021108.1,9,29378478,144957126,4495770,1031712,145988838,142553065
29378478_1031754,CM021108.1,9,29378478,144957126,4495770,1031754,145988880,142553107
29380133_1143741,CM021108.1,9,29380133,144955374,4065675,1143741,146099115,142663342
29382078_1163711,CM021108.1,9,29382078,144955374,2180240,1163711,146119085,142683312
29382078_1379496,CM021108.1,9,29382078,144955374,2180240,1379496,146334870,142899097
29382078_1379597,CM021108.1,9,29382078,144955374,2180240,1379597,146334971,142899198
29382078_1379666,CM021108.1,9,29382078,144955374,2180240,1379666,146335040,142899267
29382078_1379728,CM021108.1,9,29382078,144955374,2180240,1379728,146335102,142899329
29382078_1424289,CM021108.1,9,29382078,144955374,2180240,1424289,146379663,142943890
29382078_1424394,CM021108.1,9,29382078,144955374,2180240,1424394,146379768,142943995
29377104_1448241,CM021108.1,9,29377104,144955375,3118218,1448241,146403616,142967843
29377104_1448363,CM021108.1,9,29377104,144955375,3118218,1448363,146403738,142967965
29380551_1760720,CM021108.1,9,29380551,144955375,12050116,1760720,146716095,143280322
29380551_1760721,CM021108.1,9,29380551,144955375,12050116,1760721,146716096,143280323
29380551_1760778,CM021108.1,9,29380551,144955375,12050116,1760778,146716153,143280380
29377171_1786958,CM021108.1,9,29377171,144955374,5235942,1786958,146742332,143306559
29382212_1866179,CM021108.1,9,29382212,144955371,2006050,1866179,146821550,143385777
29379009_1983335,CM021108.1,9,29379009,144955374,2798487,1983335,146938709,143502936
29382078_2038011,CM021108.1,9,29382078,144955374,2180240,2038011,146993385,143557612
29382078_2039343,CM021108.1,9,29382078,144955374,2180240,2039343,146994717,143558944
29382078_2039344,CM021108.1,9,29382078,144955374,2180240,2039344,146994718,143558945
29382078_2039350,CM021108.1,9,29382078,144955374,2180240,2039350,146994724,143558951
29379009_2066317,CM021108.1,9,29379009,144955374,2798487,2066317,147021691,143585918
29379009_2083934,CM021108.1,9,29379009,144955374,2798487,2083934,147039308,143603535
29379009_2083961,CM021108.1,9,29379009,144955374,2798487,2083961,147039335,143603562
29379009_2083985,CM021108.1,9,29379009,144955374,2798487,2083985,147039359,143603586
29379009_2084061,CM021108.1,9,29379009,144955374,2798487,2084061,147039435,143603662
29379009_2084074,CM021108.1,9,29379009,144955374,2798487,2084074,147039448,143603675
29377696_2243527,CM021108.1,9,29377696,144955366,4094776,2243527,147198893,143763120
29370175_67621,CM021108.1,9,29370175,147268719,260372,67621,147336340,143900567
29370175_69528,CM021108.1,9,29370175,147268719,260372,69528,147338247,143902474
29370175_69559,CM021108.1,9,29370175,147268719,260372,69559,147338278,143902505
29370175_69650,CM021108.1,9,29370175,147268719,260372,69650,147338369,143902596
29370175_69685,CM021108.1,9,29370175,147268719,260372,69685,147338404,143902631
29370175_69819,CM021108.1,9,29370175,147268719,260372,69819,147338538,143902765
29370175_69827,CM021108.1,9,29370175,147268719,260372,69827,147338546,143902773
29370175_69841,CM021108.1,9,29370175,147268719,260372,69841,147338560,143902787
29370175_69869,CM021108.1,9,29370175,147268719,260372,69869,147338588,143902815
29378402_89853,CM021108.1,9,29378402,147268715,217510,89853,147358568,143922795
29379010_108927,CM021108.1,9,29379010,147268717,786571,108927,147377644,143941871
29379010_109007,CM021108.1,9,29379010,147268717,786571,109007,147377724,143941951
29353933_112492,CM021108.1,9,29353933,147268717,501752,112492,147381209,143945436
29377696_2430489,CM021108.1,9,29377696,144955366,4094776,2430489,147385855,143950082
29379010_127193,CM021108.1,9,29379010,147268717,786571,127193,147395910,143960137
29379010_127229,CM021108.1,9,29379010,147268717,786571,127229,147395946,143960173
29377696_2733695,CM021108.1,9,29377696,144955366,4094776,2733695,147689061,144253288
29377696_2733749,CM021108.1,9,29377696,144955366,4094776,2733749,147689115,144253342
29377696_2733792,CM021108.1,9,29377696,144955366,4094776,2733792,147689158,144253385
29377696_2733825,CM021108.1,9,29377696,144955366,4094776,2733825,147689191,144253418
29377696_2733849,CM021108.1,9,29377696,144955366,4094776,2733849,147689215,144253442
29377696_2733910,CM021108.1,9,29377696,144955366,4094776,2733910,147689276,144253503
29377696_2739975,CM021108.1,9,29377696,144955366,4094776,2739975,147695341,144259568
29377696_2740058,CM021108.1,9,29377696,144955366,4094776,2740058,147695424,144259651
29377696_2742415,CM021108.1,9,29377696,144955366,4094776,2742415,147697781,144262008
29377696_2742460,CM021108.1,9,29377696,144955366,4094776,2742460,147697826,144262053
29377696_2742464,CM021108.1,9,29377696,144955366,4094776,2742464,147697830,144262057
29377696_2742468,CM021108.1,9,29377696,144955366,4094776,2742468,147697834,144262061
29377696_3027032,CM021108.1,9,29377696,144955366,4094776,3027032,147982398,144546625
29377696_3027081,CM021108.1,9,29377696,144955366,4094776,3027081,147982447,144546674
29377696_3073523,CM021108.1,9,29377696,144955366,4094776,3073523,148028889,144593116
29377696_3073529,CM021108.1,9,29377696,144955366,4094776,3073529,148028895,144593122
29377696_3073566,CM021108.1,9,29377696,144955366,4094776,3073566,148028932,144593159
29380551_3310659,CM021108.1,9,29380551,144955375,12050116,3310659,148266034,144830261
29380551_3314263,CM021108.1,9,29380551,144955375,12050116,3314263,148269638,144833865
29377171_3626453,CM021108.1,9,29377171,144955374,5235942,3626453,148581827,145146054
29377171_3871062,CM021108.1,9,29377171,144955374,5235942,3871062,148826436,145390663
29380133_3903298,CM021108.1,9,29380133,144955374,4065675,3903298,148858672,145422899
29377171_3932082,CM021108.1,9,29377171,144955374,5235942,3932082,148887456,145451683
29381830_1947253,CM021108.1,9,29381830,147268717,2151731,1947253,149215970,145780197
29381830_1947346,CM021108.1,9,29381830,147268717,2151731,1947346,149216063,145780290
29381830_1947348,CM021108.1,9,29381830,147268717,2151731,1947348,149216065,145780292
29381830_1947349,CM021108.1,9,29381830,147268717,2151731,1947349,149216066,145780293
29381830_1947355,CM021108.1,9,29381830,147268717,2151731,1947355,149216072,145780299
29381830_1947495,CM021108.1,9,29381830,147268717,2151731,1947495,149216212,145780439
29377171_4772851,CM021108.1,9,29377171,144955374,5235942,4772851,149728225,146292452
29377171_4772904,CM021108.1,9,29377171,144955374,5235942,4772904,149728278,146292505
29380551_4798342,CM021108.1,9,29380551,144955375,12050116,4798342,149753717,146317944
29377171_4822855,CM021108.1,9,29377171,144955374,5235942,4822855,149778229,146342456
29377171_4905799,CM021108.1,9,29377171,144955374,5235942,4905799,149861173,146425400
29377171_5006835,CM021108.1,9,29377171,144955374,5235942,5006835,149962209,146526436
29377171_5006855,CM021108.1,9,29377171,144955374,5235942,5006855,149962229,146526456
29377171_5006917,CM021108.1,9,29377171,144955374,5235942,5006917,149962291,146526518
29377171_5009891,CM021108.1,9,29377171,144955374,5235942,5009891,149965265,146529492
29380551_5678581,CM021108.1,9,29380551,144955375,12050116,5678581,150633956,147198183
29380551_11183801,CM021108.1,9,29380551,144955375,12050116,11183801,156139176,152703403
29380551_11183836,CM021108.1,9,29380551,144955375,12050116,11183836,156139211,152703438
29380551_11255934,CM021108.1,9,29380551,144955375,12050116,11255934,156211309,152775536
29380551_11257130,CM021108.1,9,29380551,144955375,12050116,11257130,156212505,152776732
29380551_11531972,CM021108.1,9,29380551,144955375,12050116,11531972,156487347,153051574
29380551_11532346,CM021108.1,9,29380551,144955375,12050116,11532346,156487721,153051948
29380551_11532347,CM021108.1,9,29380551,144955375,12050116,11532347,156487722,153051949
29382248_24208,CM021108.1,9,29382248,162053392,321350,24208,162077600,158641827
29382248_24235,CM021108.1,9,29382248,162053392,321350,24235,162077627,158641854
29382248_25772,CM021108.1,9,29382248,162053392,321350,25772,162079164,158643391
29377255_292417,CM021108.1,9,29377255,174259919,866760,292417,174552336,171116563
29377255_292481,CM021108.1,9,29377255,174259919,866760,292481,174552400,171116627
29381146_420524,CM021108.1,9,29381146,174259917,479223,420524,174680441,171244668
29381146_420607,CM021108.1,9,29381146,174259917,479223,420607,174680524,171244751
29381146_420620,CM021108.1,9,29381146,174259917,479223,420620,174680537,171244764
29381146_420630,CM021108.1,9,29381146,174259917,479223,420630,174680547,171244774
29381146_420639,CM021108.1,9,29381146,174259917,479223,420639,174680556,171244783
29381146_420689,CM021108.1,9,29381146,174259917,479223,420689,174680606,171244833
29381146_420712,CM021108.1,9,29381146,174259917,479223,420712,174680629,171244856
29381146_420720,CM021108.1,9,29381146,174259917,479223,420720,174680637,171244864
29377255_774334,CM021108.1,9,29377255,174259919,866760,774334,175034253,171598480
29370172_44184,CM021108.1,9,29370172,198533607,380002,44184,198577791,195142018
29380935_77221,CM021108.1,9,29380935,198533610,2142117,77221,198610831,195175058
29370172_183964,CM021108.1,9,29370172,198533607,380002,183964,198717571,195281798
29349147_196226,CM021108.1,9,29349147,198533610,738847,196226,198729836,195294063
29380996_335874,CM021108.1,9,29380996,198533610,745648,335874,198869484,195433711
29380935_361996,CM021108.1,9,29380935,198533610,2142117,361996,198895606,195459833
29380935_362035,CM021108.1,9,29380935,198533610,2142117,362035,198895645,195459872
29380935_362137,CM021108.1,9,29380935,198533610,2142117,362137,198895747,195459974
29380935_362188,CM021108.1,9,29380935,198533610,2142117,362188,198895798,195460025
29380935_362211,CM021108.1,9,29380935,198533610,2142117,362211,198895821,195460048
29380935_362245,CM021108.1,9,29380935,198533610,2142117,362245,198895855,195460082
29378774_702002,CM021108.1,9,29378774,198533604,986452,702002,199235606,195799833
29378774_712352,CM021108.1,9,29378774,198533604,986452,712352,199245956,195810183
29378774_712431,CM021108.1,9,29378774,198533604,986452,712431,199246035,195810262
29378774_712493,CM021108.1,9,29378774,198533604,986452,712493,199246097,195810324
29378774_783422,CM021108.1,9,29378774,198533604,986452,783422,199317026,195881253
29380935_851114,CM021108.1,9,29380935,198533610,2142117,851114,199384724,195948951
29380935_851141,CM021108.1,9,29380935,198533610,2142117,851141,199384751,195948978
29378774_947417,CM021108.1,9,29378774,198533604,986452,947417,199481021,196045248
29380935_1114975,CM021108.1,9,29380935,198533610,2142117,1114975,199648585,196212812
29380935_1156605,CM021108.1,9,29380935,198533610,2142117,1156605,199690215,196254442
29380935_1158780,CM021108.1,9,29380935,198533610,2142117,1158780,199692390,196256617
29380935_1158863,CM021108.1,9,29380935,198533610,2142117,1158863,199692473,196256700
29380935_1158940,CM021108.1,9,29380935,198533610,2142117,1158940,199692550,196256777
29380935_1543856,CM021108.1,9,29380935,198533610,2142117,1543856,200077466,196641693
29380935_1717119,CM021108.1,9,29380935,198533610,2142117,1717119,200250729,196814956
29380935_1717137,CM021108.1,9,29380935,198533610,2142117,1717137,200250747,196814974
29380935_1717171,CM021108.1,9,29380935,198533610,2142117,1717171,200250781,196815008
29380935_1717173,CM021108.1,9,29380935,198533610,2142117,1717173,200250783,196815010
29380935_1717178,CM021108.1,9,29380935,198533610,2142117,1717178,200250788,196815015
29380935_1717221,CM021108.1,9,29380935,198533610,2142117,1717221,200250831,196815058
29377141_14696,CM021108.1,9,29377141,205779375,2237191,14696,205794071,202358298
29377141_14883,CM021108.1,9,29377141,205779375,2237191,14883,205794258,202358485
29378281_16128,CM021108.1,9,29378281,205779378,388281,16128,205795506,202359733
29378281_16147,CM021108.1,9,29378281,205779378,388281,16147,205795525,202359752
29378281_16148,CM021108.1,9,29378281,205779378,388281,16148,205795526,202359753
29378281_16154,CM021108.1,9,29378281,205779378,388281,16154,205795532,202359759
29378281_16156,CM021108.1,9,29378281,205779378,388281,16156,205795534,202359761
29378281_16159,CM021108.1,9,29378281,205779378,388281,16159,205795537,202359764
29378281_16174,CM021108.1,9,29378281,205779378,388281,16174,205795552,202359779
29378281_16191,CM021108.1,9,29378281,205779378,388281,16191,205795569,202359796
29378281_16220,CM021108.1,9,29378281,205779378,388281,16220,205795598,202359825
29378281_16226,CM021108.1,9,29378281,205779378,388281,16226,205795604,202359831
29378281_16228,CM021108.1,9,29378281,205779378,388281,16228,205795606,202359833
29378281_16252,CM021108.1,9,29378281,205779378,388281,16252,205795630,202359857
29378281_16254,CM021108.1,9,29378281,205779378,388281,16254,205795632,202359859
29378281_16269,CM021108.1,9,29378281,205779378,388281,16269,205795647,202359874
29378281_16279,CM021108.1,9,29378281,205779378,388281,16279,205795657,202359884
29378281_16286,CM021108.1,9,29378281,205779378,388281,16286,205795664,202359891
29378281_16293,CM021108.1,9,29378281,205779378,388281,16293,205795671,202359898
29378281_16295,CM021108.1,9,29378281,205779378,388281,16295,205795673,202359900
29378281_16299,CM021108.1,9,29378281,205779378,388281,16299,205795677,202359904
29378281_16309,CM021108.1,9,29378281,205779378,388281,16309,205795687,202359914
29380234_28127,CM021108.1,9,29380234,205779376,3055213,28127,205807503,202371730
29380234_28135,CM021108.1,9,29380234,205779376,3055213,28135,205807511,202371738
29380234_28179,CM021108.1,9,29380234,205779376,3055213,28179,205807555,202371782
29380234_28191,CM021108.1,9,29380234,205779376,3055213,28191,205807567,202371794
29380234_28208,CM021108.1,9,29380234,205779376,3055213,28208,205807584,202371811
29380234_28234,CM021108.1,9,29380234,205779376,3055213,28234,205807610,202371837
29380234_28235,CM021108.1,9,29380234,205779376,3055213,28235,205807611,202371838
29380234_28241,CM021108.1,9,29380234,205779376,3055213,28241,205807617,202371844
29380234_28267,CM021108.1,9,29380234,205779376,3055213,28267,205807643,202371870
29380234_28308,CM021108.1,9,29380234,205779376,3055213,28308,205807684,202371911
29380234_28325,CM021108.1,9,29380234,205779376,3055213,28325,205807701,202371928
29378760_49937,CM021108.1,9,29378760,205779369,638314,49937,205829306,202393533
29378760_50030,CM021108.1,9,29378760,205779369,638314,50030,205829399,202393626
29380234_211086,CM021108.1,9,29380234,205779376,3055213,211086,205990462,202554689
29380234_211099,CM021108.1,9,29380234,205779376,3055213,211099,205990475,202554702
29380322_227373,CM021108.1,9,29380322,205779375,988441,227373,206006748,202570975
29380322_227399,CM021108.1,9,29380322,205779375,988441,227399,206006774,202571001
29380322_227416,CM021108.1,9,29380322,205779375,988441,227416,206006791,202571018
29380322_227458,CM021108.1,9,29380322,205779375,988441,227458,206006833,202571060
29377141_310898,CM021108.1,9,29377141,205779375,2237191,310898,206090273,202654500
29377141_310955,CM021108.1,9,29377141,205779375,2237191,310955,206090330,202654557
29377141_310974,CM021108.1,9,29377141,205779375,2237191,310974,206090349,202654576
29377141_311250,CM021108.1,9,29377141,205779375,2237191,311250,206090625,202654852
29377141_311301,CM021108.1,9,29377141,205779375,2237191,311301,206090676,202654903
29377141_311313,CM021108.1,9,29377141,205779375,2237191,311313,206090688,202654915
29377141_336770,CM021108.1,9,29377141,205779375,2237191,336770,206116145,202680372
29377141_340204,CM021108.1,9,29377141,205779375,2237191,340204,206119579,202683806
29380322_422466,CM021108.1,9,29380322,205779375,988441,422466,206201841,202766068
29380322_422660,CM021108.1,9,29380322,205779375,988441,422660,206202035,202766262
29380322_422801,CM021108.1,9,29380322,205779375,988441,422801,206202176,202766403
29380322_422881,CM021108.1,9,29380322,205779375,988441,422881,206202256,202766483
29379907_456029,CM021108.1,9,29379907,205779376,3441038,456029,206235405,202799632
29379907_456059,CM021108.1,9,29379907,205779376,3441038,456059,206235435,202799662
29380322_470876,CM021108.1,9,29380322,205779375,988441,470876,206250251,202814478
29381818_472238,CM021108.1,9,29381818,205779376,4011740,472238,206251614,202815841
29379907_477168,CM021108.1,9,29379907,205779376,3441038,477168,206256544,202820771
29379907_477177,CM021108.1,9,29379907,205779376,3441038,477177,206256553,202820780
29379907_477184,CM021108.1,9,29379907,205779376,3441038,477184,206256560,202820787
29379907_477185,CM021108.1,9,29379907,205779376,3441038,477185,206256561,202820788
29380322_502601,CM021108.1,9,29380322,205779375,988441,502601,206281976,202846203
29380322_524375,CM021108.1,9,29380322,205779375,988441,524375,206303750,202867977
29380322_524541,CM021108.1,9,29380322,205779375,988441,524541,206303916,202868143
29378235_544162,CM021108.1,9,29378235,205779375,2802223,544162,206323537,202887764
29378235_544188,CM021108.1,9,29378235,205779375,2802223,544188,206323563,202887790
29378235_544220,CM021108.1,9,29378235,205779375,2802223,544220,206323595,202887822
29378235_544223,CM021108.1,9,29378235,205779375,2802223,544223,206323598,202887825
29378235_544226,CM021108.1,9,29378235,205779375,2802223,544226,206323601,202887828
29378235_544244,CM021108.1,9,29378235,205779375,2802223,544244,206323619,202887846
29378235_544245,CM021108.1,9,29378235,205779375,2802223,544245,206323620,202887847
29379593_640390,CM021108.1,9,29379593,205779376,2075281,640390,206419766,202983993
29379593_640418,CM021108.1,9,29379593,205779376,2075281,640418,206419794,202984021
29379593_652307,CM021108.1,9,29379593,205779376,2075281,652307,206431683,202995910
29379593_652319,CM021108.1,9,29379593,205779376,2075281,652319,206431695,202995922
29379593_652363,CM021108.1,9,29379593,205779376,2075281,652363,206431739,202995966
29379593_652366,CM021108.1,9,29379593,205779376,2075281,652366,206431742,202995969
29377953_735135,CM021108.1,9,29377953,205779376,816912,735135,206514511,203078738
29377953_735165,CM021108.1,9,29377953,205779376,816912,735165,206514541,203078768
29377953_735166,CM021108.1,9,29377953,205779376,816912,735166,206514542,203078769
29377953_735172,CM021108.1,9,29377953,205779376,816912,735172,206514548,203078775
29377953_735179,CM021108.1,9,29377953,205779376,816912,735179,206514555,203078782
29377953_735206,CM021108.1,9,29377953,205779376,816912,735206,206514582,203078809
29377953_735236,CM021108.1,9,29377953,205779376,816912,735236,206514612,203078839
29377953_735239,CM021108.1,9,29377953,205779376,816912,735239,206514615,203078842
29377953_735306,CM021108.1,9,29377953,205779376,816912,735306,206514682,203078909
29377953_735320,CM021108.1,9,29377953,205779376,816912,735320,206514696,203078923
29377953_735365,CM021108.1,9,29377953,205779376,816912,735365,206514741,203078968
29377953_735367,CM021108.1,9,29377953,205779376,816912,735367,206514743,203078970
29379593_766942,CM021108.1,9,29379593,205779376,2075281,766942,206546318,203110545
29379593_788665,CM021108.1,9,29379593,205779376,2075281,788665,206568041,203132268
29379593_788800,CM021108.1,9,29379593,205779376,2075281,788800,206568176,203132403
29379593_788815,CM021108.1,9,29379593,205779376,2075281,788815,206568191,203132418
29379132_800681,CM021108.1,9,29379132,205779375,1996170,800681,206580056,203144283
29379907_831344,CM021108.1,9,29379907,205779376,3441038,831344,206610720,203174947
29379907_831346,CM021108.1,9,29379907,205779376,3441038,831346,206610722,203174949
29379907_831360,CM021108.1,9,29379907,205779376,3441038,831360,206610736,203174963
29379907_831366,CM021108.1,9,29379907,205779376,3441038,831366,206610742,203174969
29379907_831371,CM021108.1,9,29379907,205779376,3441038,831371,206610747,203174974
29379907_831392,CM021108.1,9,29379907,205779376,3441038,831392,206610768,203174995
29379907_831428,CM021108.1,9,29379907,205779376,3441038,831428,206610804,203175031
29379907_831430,CM021108.1,9,29379907,205779376,3441038,831430,206610806,203175033
29379907_832759,CM021108.1,9,29379907,205779376,3441038,832759,206612135,203176362
29379907_832797,CM021108.1,9,29379907,205779376,3441038,832797,206612173,203176400
29379907_832858,CM021108.1,9,29379907,205779376,3441038,832858,206612234,203176461
29379907_832877,CM021108.1,9,29379907,205779376,3441038,832877,206612253,203176480
29379907_832907,CM021108.1,9,29379907,205779376,3441038,832907,206612283,203176510
29379907_832958,CM021108.1,9,29379907,205779376,3441038,832958,206612334,203176561
29379907_922822,CM021108.1,9,29379907,205779376,3441038,922822,206702198,203266425
29379593_937577,CM021108.1,9,29379593,205779376,2075281,937577,206716953,203281180
29380322_965170,CM021108.1,9,29380322,205779375,988441,965170,206744545,203308772
29380234_973717,CM021108.1,9,29380234,205779376,3055213,973717,206753093,203317320
29380234_974011,CM021108.1,9,29380234,205779376,3055213,974011,206753387,203317614
29379593_978249,CM021108.1,9,29379593,205779376,2075281,978249,206757625,203321852
29381801_1127151,CM021108.1,9,29381801,205779367,1817002,1127151,206906518,203470745
29381801_1127201,CM021108.1,9,29381801,205779367,1817002,1127201,206906568,203470795
29379593_1140738,CM021108.1,9,29379593,205779376,2075281,1140738,206920114,203484341
29377564_1186742,CM021108.1,9,29377564,205779375,1837565,1186742,206966117,203530344
29377564_1186823,CM021108.1,9,29377564,205779375,1837565,1186823,206966198,203530425
29379593_1276319,CM021108.1,9,29379593,205779376,2075281,1276319,207055695,203619922
29379593_1276402,CM021108.1,9,29379593,205779376,2075281,1276402,207055778,203620005
29379132_1359622,CM021108.1,9,29379132,205779375,1996170,1359622,207138997,203703224
29379132_1360893,CM021108.1,9,29379132,205779375,1996170,1360893,207140268,203704495
29379132_1360894,CM021108.1,9,29379132,205779375,1996170,1360894,207140269,203704496
29379132_1386960,CM021108.1,9,29379132,205779375,1996170,1386960,207166335,203730562
29379132_1602358,CM021108.1,9,29379132,205779375,1996170,1602358,207381733,203945960
29379132_1602664,CM021108.1,9,29379132,205779375,1996170,1602664,207382039,203946266
29379593_1638397,CM021108.1,9,29379593,205779376,2075281,1638397,207417773,203982000
29379593_1638398,CM021108.1,9,29379593,205779376,2075281,1638398,207417774,203982001
29379593_1638410,CM021108.1,9,29379593,205779376,2075281,1638410,207417786,203982013
29379593_1638413,CM021108.1,9,29379593,205779376,2075281,1638413,207417789,203982016
29379593_1638419,CM021108.1,9,29379593,205779376,2075281,1638419,207417795,203982022
29379593_1638531,CM021108.1,9,29379593,205779376,2075281,1638531,207417907,203982134
29380234_1826986,CM021108.1,9,29380234,205779376,3055213,1826986,207606362,204170589
29380234_1827204,CM021108.1,9,29380234,205779376,3055213,1827204,207606580,204170807
29380234_1827231,CM021108.1,9,29380234,205779376,3055213,1827231,207606607,204170834
29380234_1827264,CM021108.1,9,29380234,205779376,3055213,1827264,207606640,204170867
29379132_1907860,CM021108.1,9,29379132,205779375,1996170,1907860,207687235,204251462
29380234_1965143,CM021108.1,9,29380234,205779376,3055213,1965143,207744519,204308746
29380234_1965150,CM021108.1,9,29380234,205779376,3055213,1965150,207744526,204308753
29380234_1979822,CM021108.1,9,29380234,205779376,3055213,1979822,207759198,204323425
29381818_2121134,CM021108.1,9,29381818,205779376,4011740,2121134,207900510,204464737
29379907_2418874,CM021108.1,9,29379907,205779376,3441038,2418874,208198250,204762477
29381818_3771883,CM021108.1,9,29381818,205779376,4011740,3771883,209551259,206115486
29381818_3790955,CM021108.1,9,29381818,205779376,4011740,3790955,209570331,206134558
29381895_91971,CM021108.1,9,29381895,220610795,1755672,91971,220702766,217266993
29381895_91988,CM021108.1,9,29381895,220610795,1755672,91988,220702783,217267010
29381895_107992,CM021108.1,9,29381895,220610795,1755672,107992,220718787,217283014
29381895_108064,CM021108.1,9,29381895,220610795,1755672,108064,220718859,217283086
29381895_108099,CM021108.1,9,29381895,220610795,1755672,108099,220718894,217283121
29381895_108101,CM021108.1,9,29381895,220610795,1755672,108101,220718896,217283123
29381895_108113,CM021108.1,9,29381895,220610795,1755672,108113,220718908,217283135
29381895_108139,CM021108.1,9,29381895,220610795,1755672,108139,220718934,217283161
29381895_108183,CM021108.1,9,29381895,220610795,1755672,108183,220718978,217283205
29377968_28747,CM021108.1,9,29377968,220895134,377618,28747,220923881,217488108
29377968_28750,CM021108.1,9,29377968,220895134,377618,28750,220923884,217488111
29377968_28816,CM021108.1,9,29377968,220895134,377618,28816,220923950,217488177
29377968_28819,CM021108.1,9,29377968,220895134,377618,28819,220923953,217488180
29381895_444372,CM021108.1,9,29381895,220610795,1755672,444372,221055167,217619394
29381895_562371,CM021108.1,9,29381895,220610795,1755672,562371,221173166,217737393
29381683_1073584,CM021108.1,9,29381683,220610794,1231371,1073584,221684378,218248605
29381249_1074624,CM021108.1,9,29381249,220610795,1119451,1074624,221685419,218249646
29381249_1074661,CM021108.1,9,29381249,220610795,1119451,1074661,221685456,218249683
29381895_1364319,CM021108.1,9,29381895,220610795,1755672,1364319,221975114,218539341
29381895_1364328,CM021108.1,9,29381895,220610795,1755672,1364328,221975123,218539350
29350120_41235,CM021108.1,9,29350120,223253871,126562,41235,223295106,219859333
29350120_41251,CM021108.1,9,29350120,223253871,126562,41251,223295122,219859349
29377225_2857501,CM021108.1,9,29377225,220610795,3367971,2857501,223468296,220032523
29377225_2857652,CM021108.1,9,29377225,220610795,3367971,2857652,223468447,220032674
29377225_2857688,CM021108.1,9,29377225,220610795,3367971,2857688,223468483,220032710
29379653_595112,CM021108.1,9,29379653,231532615,692641,595112,232127727,228691954
29379653_595175,CM021108.1,9,29379653,231532615,692641,595175,232127790,228692017
29379653_595242,CM021108.1,9,29379653,231532615,692641,595242,232127857,228692084
29379653_595243,CM021108.1,9,29379653,231532615,692641,595243,232127858,228692085
29379653_595299,CM021108.1,9,29379653,231532615,692641,595299,232127914,228692141
29379653_595308,CM021108.1,9,29379653,231532615,692641,595308,232127923,228692150
29380144_27522,CM021108.1,9,29380144,260678646,1074448,27522,260706168,257270395
29380144_27825,CM021108.1,9,29380144,260678646,1074448,27825,260706471,257270698
29380144_27898,CM021108.1,9,29380144,260678646,1074448,27898,260706544,257270771
29381469_29967,CM021108.1,9,29381469,260678646,1959044,29967,260708613,257272840
29380076_82055,CM021108.1,9,29380076,260679215,525580,82055,260761270,257325497
29380076_82091,CM021108.1,9,29380076,260679215,525580,82091,260761306,257325533
29380076_82103,CM021108.1,9,29380076,260679215,525580,82103,260761318,257325545
29378633_88217,CM021108.1,9,29378633,260680669,123152,88217,260768886,257333113
29378633_88218,CM021108.1,9,29378633,260680669,123152,88218,260768887,257333114
29378633_88220,CM021108.1,9,29378633,260680669,123152,88220,260768889,257333116
29378633_88371,CM021108.1,9,29378633,260680669,123152,88371,260769040,257333267
29380571_124814,CM021108.1,9,29380571,260678646,1777835,124814,260803460,257367687
29378689_146684,CM021108.1,9,29378689,260678646,1863839,146684,260825330,257389557
29377443_176802,CM021108.1,9,29377443,260678645,1578512,176802,260855447,257419674
29378689_180635,CM021108.1,9,29378689,260678646,1863839,180635,260859281,257423508
29381469_216539,CM021108.1,9,29381469,260678646,1959044,216539,260895185,257459412
29381469_216553,CM021108.1,9,29381469,260678646,1959044,216553,260895199,257459426
29381469_395735,CM021108.1,9,29381469,260678646,1959044,395735,261074381,257638608
29381469_395787,CM021108.1,9,29381469,260678646,1959044,395787,261074433,257638660
29380571_411134,CM021108.1,9,29380571,260678646,1777835,411134,261089780,257654007
29380571_411575,CM021108.1,9,29380571,260678646,1777835,411575,261090221,257654448
29381469_551387,CM021108.1,9,29381469,260678646,1959044,551387,261230033,257794260
29381469_551390,CM021108.1,9,29381469,260678646,1959044,551390,261230036,257794263
29381469_551412,CM021108.1,9,29381469,260678646,1959044,551412,261230058,257794285
29381469_551442,CM021108.1,9,29381469,260678646,1959044,551442,261230088,257794315
29380800_620870,CM021108.1,9,29380800,260678646,2750862,620870,261299516,257863743
29377931_692540,CM021108.1,9,29377931,260678645,4752238,692540,261371185,257935412
29377931_692570,CM021108.1,9,29377931,260678645,4752238,692570,261371215,257935442
29380904_716650,CM021108.1,9,29380904,260678645,1532701,716650,261395295,257959522
29380904_716671,CM021108.1,9,29380904,260678645,1532701,716671,261395316,257959543
29380904_795198,CM021108.1,9,29380904,260678645,1532701,795198,261473843,258038070
29380904_795268,CM021108.1,9,29380904,260678645,1532701,795268,261473913,258038140
29380904_820440,CM021108.1,9,29380904,260678645,1532701,820440,261499085,258063312
29380904_840866,CM021108.1,9,29380904,260678645,1532701,840866,261519511,258083738
29380904_840880,CM021108.1,9,29380904,260678645,1532701,840880,261519525,258083752
29380904_840893,CM021108.1,9,29380904,260678645,1532701,840893,261519538,258083765
29377931_942994,CM021108.1,9,29377931,260678645,4752238,942994,261621639,258185866
29377931_943068,CM021108.1,9,29377931,260678645,4752238,943068,261621713,258185940
29380800_1000356,CM021108.1,9,29380800,260678646,2750862,1000356,261679002,258243229
29380860_1039951,CM021108.1,9,29380860,260678645,3018211,1039951,261718596,258282823
29380860_1045794,CM021108.1,9,29380860,260678645,3018211,1045794,261724439,258288666
29381469_1251375,CM021108.1,9,29381469,260678646,1959044,1251375,261930021,258494248
29381469_1251522,CM021108.1,9,29381469,260678646,1959044,1251522,261930168,258494395
29378631_1288730,CM021108.1,9,29378631,260678646,1342271,1288730,261967376,258531603
29380860_1297863,CM021108.1,9,29380860,260678645,3018211,1297863,261976508,258540735
29380860_1297881,CM021108.1,9,29380860,260678645,3018211,1297881,261976526,258540753
29380860_1297928,CM021108.1,9,29380860,260678645,3018211,1297928,261976573,258540800
29380860_1315130,CM021108.1,9,29380860,260678645,3018211,1315130,261993775,258558002
29380860_1345047,CM021108.1,9,29380860,260678645,3018211,1345047,262023692,258587919
29377931_1369753,CM021108.1,9,29377931,260678645,4752238,1369753,262048398,258612625
29377931_1369823,CM021108.1,9,29377931,260678645,4752238,1369823,262048468,258612695
29377931_1369829,CM021108.1,9,29377931,260678645,4752238,1369829,262048474,258612701
29377931_1426356,CM021108.1,9,29377931,260678645,4752238,1426356,262105001,258669228
29377931_1428489,CM021108.1,9,29377931,260678645,4752238,1428489,262107134,258671361
29377931_1893295,CM021108.1,9,29377931,260678645,4752238,1893295,262571940,259136167
29377931_1893739,CM021108.1,9,29377931,260678645,4752238,1893739,262572384,259136611
29380860_1898571,CM021108.1,9,29380860,260678645,3018211,1898571,262577216,259141443
29380860_1939805,CM021108.1,9,29380860,260678645,3018211,1939805,262618450,259182677
29380860_1939816,CM021108.1,9,29380860,260678645,3018211,1939816,262618461,259182688
29380800_2017361,CM021108.1,9,29380800,260678646,2750862,2017361,262696007,259260234
29380860_2026734,CM021108.1,9,29380860,260678645,3018211,2026734,262705379,259269606
29380860_2026804,CM021108.1,9,29380860,260678645,3018211,2026804,262705449,259269676
29380860_2026919,CM021108.1,9,29380860,260678645,3018211,2026919,262705564,259269791
29380860_2026967,CM021108.1,9,29380860,260678645,3018211,2026967,262705612,259269839
29380860_2035273,CM021108.1,9,29380860,260678645,3018211,2035273,262713918,259278145
29380860_2035371,CM021108.1,9,29380860,260678645,3018211,2035371,262714016,259278243
29380860_2049092,CM021108.1,9,29380860,260678645,3018211,2049092,262727737,259291964
29380860_2103767,CM021108.1,9,29380860,260678645,3018211,2103767,262782412,259346639
29380860_2103822,CM021108.1,9,29380860,260678645,3018211,2103822,262782467,259346694
29379614_2206779,CM021108.1,9,29379614,260678645,3226377,2206779,262885424,259449651
29379614_2206852,CM021108.1,9,29379614,260678645,3226377,2206852,262885497,259449724
29379614_2206861,CM021108.1,9,29379614,260678645,3226377,2206861,262885506,259449733
29379614_2206869,CM021108.1,9,29379614,260678645,3226377,2206869,262885514,259449741
29380860_2587579,CM021108.1,9,29380860,260678645,3018211,2587579,263266224,259830451
29377931_2618764,CM021108.1,9,29377931,260678645,4752238,2618764,263297409,259861636
29377931_2618848,CM021108.1,9,29377931,260678645,4752238,2618848,263297493,259861720
29377931_2619042,CM021108.1,9,29377931,260678645,4752238,2619042,263297687,259861914
29380860_2791937,CM021108.1,9,29380860,260678645,3018211,2791937,263470582,260034809
29380860_2791946,CM021108.1,9,29380860,260678645,3018211,2791946,263470591,260034818
29380860_2793698,CM021108.1,9,29380860,260678645,3018211,2793698,263472343,260036570
29377931_2847440,CM021108.1,9,29377931,260678645,4752238,2847440,263526085,260090312
29377931_2882643,CM021108.1,9,29377931,260678645,4752238,2882643,263561288,260125515
29377931_3134832,CM021108.1,9,29377931,260678645,4752238,3134832,263813477,260377704
29377931_3134842,CM021108.1,9,29377931,260678645,4752238,3134842,263813487,260377714
29377931_3134952,CM021108.1,9,29377931,260678645,4752238,3134952,263813597,260377824
29377931_3135115,CM021108.1,9,29377931,260678645,4752238,3135115,263813760,260377987
29377931_3135160,CM021108.1,9,29377931,260678645,4752238,3135160,263813805,260378032
29377931_3162247,CM021108.1,9,29377931,260678645,4752238,3162247,263840892,260405119
29377931_3177423,CM021108.1,9,29377931,260678645,4752238,3177423,263856068,260420295
29377931_3321977,CM021108.1,9,29377931,260678645,4752238,3321977,264000622,260564849
29377931_3524910,CM021108.1,9,29377931,260678645,4752238,3524910,264203555,260767782
29377931_3524911,CM021108.1,9,29377931,260678645,4752238,3524911,264203556,260767783
29377931_3524941,CM021108.1,9,29377931,260678645,4752238,3524941,264203586,260767813
29377931_3524944,CM021108.1,9,29377931,260678645,4752238,3524944,264203589,260767816
29377931_3524947,CM021108.1,9,29377931,260678645,4752238,3524947,264203592,260767819
29377931_3524966,CM021108.1,9,29377931,260678645,4752238,3524966,264203611,260767838
29377931_3524969,CM021108.1,9,29377931,260678645,4752238,3524969,264203614,260767841
29377931_3524970,CM021108.1,9,29377931,260678645,4752238,3524970,264203615,260767842
29377931_3524978,CM021108.1,9,29377931,260678645,4752238,3524978,264203623,260767850
29377931_3524982,CM021108.1,9,29377931,260678645,4752238,3524982,264203627,260767854
29377931_3525031,CM021108.1,9,29377931,260678645,4752238,3525031,264203676,260767903
29377931_4172600,CM021108.1,9,29377931,260678645,4752238,4172600,264851245,261415472
29377931_4172794,CM021108.1,9,29377931,260678645,4752238,4172794,264851439,261415666
29354727_88355,CM021108.1,9,29354727,266339659,186185,88355,266428014,262992241
29380753_24875,CM021108.1,9,29380753,269137631,358253,24875,269162506,265726733
29380615_90465,CM021108.1,9,29380615,269137631,3271254,90465,269228096,265792323
29380615_90518,CM021108.1,9,29380615,269137631,3271254,90518,269228149,265792376
29380615_90544,CM021108.1,9,29380615,269137631,3271254,90544,269228175,265792402
29380615_90547,CM021108.1,9,29380615,269137631,3271254,90547,269228178,265792405
29380615_90617,CM021108.1,9,29380615,269137631,3271254,90617,269228248,265792475
29380615_90618,CM021108.1,9,29380615,269137631,3271254,90618,269228249,265792476
29380615_90623,CM021108.1,9,29380615,269137631,3271254,90623,269228254,265792481
29380615_90647,CM021108.1,9,29380615,269137631,3271254,90647,269228278,265792505
29380615_90664,CM021108.1,9,29380615,269137631,3271254,90664,269228295,265792522
29380615_90668,CM021108.1,9,29380615,269137631,3271254,90668,269228299,265792526
29379267_120226,CM021108.1,9,29379267,269137619,1610201,120226,269257845,265822072
29379267_120228,CM021108.1,9,29379267,269137619,1610201,120228,269257847,265822074
29379267_120279,CM021108.1,9,29379267,269137619,1610201,120279,269257898,265822125
29377152_229813,CM021108.1,9,29377152,269137630,2626666,229813,269367443,265931670
29377152_229948,CM021108.1,9,29377152,269137630,2626666,229948,269367578,265931805
29380615_332274,CM021108.1,9,29380615,269137631,3271254,332274,269469905,266034132
29380615_332316,CM021108.1,9,29380615,269137631,3271254,332316,269469947,266034174
29380615_332331,CM021108.1,9,29380615,269137631,3271254,332331,269469962,266034189
29377535_693330,CM021108.1,9,29377535,269137631,4134940,693330,269830961,266395188
29377535_693383,CM021108.1,9,29377535,269137631,4134940,693383,269831014,266395241
29377535_715521,CM021108.1,9,29377535,269137631,4134940,715521,269853152,266417379
29377535_715677,CM021108.1,9,29377535,269137631,4134940,715677,269853308,266417535
29377747_818583,CM021108.1,9,29377747,269137628,3630654,818583,269956211,266520438
29377747_818613,CM021108.1,9,29377747,269137628,3630654,818613,269956241,266520468
29377747_818633,CM021108.1,9,29377747,269137628,3630654,818633,269956261,266520488
29377747_818856,CM021108.1,9,29377747,269137628,3630654,818856,269956484,266520711
29377747_818898,CM021108.1,9,29377747,269137628,3630654,818898,269956526,266520753
29377747_818919,CM021108.1,9,29377747,269137628,3630654,818919,269956547,266520774
29377747_818952,CM021108.1,9,29377747,269137628,3630654,818952,269956580,266520807
29379187_864391,CM021108.1,9,29379187,269137631,1764469,864391,270002022,266566249
29377152_910208,CM021108.1,9,29377152,269137630,2626666,910208,270047838,266612065
29377152_910226,CM021108.1,9,29377152,269137630,2626666,910226,270047856,266612083
29377152_910282,CM021108.1,9,29377152,269137630,2626666,910282,270047912,266612139
29377152_912197,CM021108.1,9,29377152,269137630,2626666,912197,270049827,266614054
29377152_912231,CM021108.1,9,29377152,269137630,2626666,912231,270049861,266614088
29377152_912265,CM021108.1,9,29377152,269137630,2626666,912265,270049895,266614122
29382115_1088449,CM021108.1,9,29382115,269137631,1385416,1088449,270226080,266790307
29382115_1088550,CM021108.1,9,29382115,269137631,1385416,1088550,270226181,266790408
29380615_1123070,CM021108.1,9,29380615,269137631,3271254,1123070,270260701,266824928
29377152_1198687,CM021108.1,9,29377152,269137630,2626666,1198687,270336317,266900544
29377152_1199060,CM021108.1,9,29377152,269137630,2626666,1199060,270336690,266900917
29381542_1218390,CM021108.1,9,29381542,269137630,2229075,1218390,270356020,266920247
29381542_1218773,CM021108.1,9,29381542,269137630,2229075,1218773,270356403,266920630
29381542_1218855,CM021108.1,9,29381542,269137630,2229075,1218855,270356485,266920712
29377535_1594070,CM021108.1,9,29377535,269137631,4134940,1594070,270731701,267295928
29379187_1727452,CM021108.1,9,29379187,269137631,1764469,1727452,270865083,267429310
29379187_1727501,CM021108.1,9,29379187,269137631,1764469,1727501,270865132,267429359
29377535_2321809,CM021108.1,9,29377535,269137631,4134940,2321809,271459440,268023667
29377747_2823386,CM021108.1,9,29377747,269137628,3630654,2823386,271961014,268525241
29377747_2823466,CM021108.1,9,29377747,269137628,3630654,2823466,271961094,268525321
29380615_2919493,CM021108.1,9,29380615,269137631,3271254,2919493,272057124,268621351
29380857_2977086,CM021108.1,9,29380857,269137626,6683672,2977086,272114712,268678939
29380857_2977096,CM021108.1,9,29380857,269137626,6683672,2977096,272114722,268678949
29380857_2977108,CM021108.1,9,29380857,269137626,6683672,2977108,272114734,268678961
29380857_2977118,CM021108.1,9,29380857,269137626,6683672,2977118,272114744,268678971
29380857_2977124,CM021108.1,9,29380857,269137626,6683672,2977124,272114750,268678977
29380857_2989363,CM021108.1,9,29380857,269137626,6683672,2989363,272126989,268691216
29380857_3017031,CM021108.1,9,29380857,269137626,6683672,3017031,272154657,268718884
29380857_3017117,CM021108.1,9,29380857,269137626,6683672,3017117,272154743,268718970
29380857_3017126,CM021108.1,9,29380857,269137626,6683672,3017126,272154752,268718979
29380857_3017320,CM021108.1,9,29380857,269137626,6683672,3017320,272154946,268719173
29380857_3033815,CM021108.1,9,29380857,269137626,6683672,3033815,272171441,268735668
29380857_3033955,CM021108.1,9,29380857,269137626,6683672,3033955,272171581,268735808
29380857_3034322,CM021108.1,9,29380857,269137626,6683672,3034322,272171948,268736175
29380615_3126948,CM021108.1,9,29380615,269137631,3271254,3126948,272264579,268828806
29380615_3127017,CM021108.1,9,29380615,269137631,3271254,3127017,272264648,268828875
29380857_3323856,CM021108.1,9,29380857,269137626,6683672,3323856,272461482,269025709
29377535_3510033,CM021108.1,9,29377535,269137631,4134940,3510033,272647664,269211891
29377535_3510040,CM021108.1,9,29377535,269137631,4134940,3510040,272647671,269211898
29377535_3562009,CM021108.1,9,29377535,269137631,4134940,3562009,272699640,269263867
29377535_3562329,CM021108.1,9,29377535,269137631,4134940,3562329,272699960,269264187
29377535_3562346,CM021108.1,9,29377535,269137631,4134940,3562346,272699977,269264204
29380857_3647791,CM021108.1,9,29380857,269137626,6683672,3647791,272785417,269349644
29380857_3779810,CM021108.1,9,29380857,269137626,6683672,3779810,272917436,269481663
29380857_3779846,CM021108.1,9,29380857,269137626,6683672,3779846,272917472,269481699
29380857_3779848,CM021108.1,9,29380857,269137626,6683672,3779848,272917474,269481701
29380857_3779881,CM021108.1,9,29380857,269137626,6683672,3779881,272917507,269481734
29380857_3779958,CM021108.1,9,29380857,269137626,6683672,3779958,272917584,269481811
29380857_3779983,CM021108.1,9,29380857,269137626,6683672,3779983,272917609,269481836
29380857_3780025,CM021108.1,9,29380857,269137626,6683672,3780025,272917651,269481878
29380857_4200286,CM021108.1,9,29380857,269137626,6683672,4200286,273337912,269902139
29380857_4200332,CM021108.1,9,29380857,269137626,6683672,4200332,273337958,269902185
29380857_4200387,CM021108.1,9,29380857,269137626,6683672,4200387,273338013,269902240
29380857_4240411,CM021108.1,9,29380857,269137626,6683672,4240411,273378037,269942264
29380857_4621743,CM021108.1,9,29380857,269137626,6683672,4621743,273759369,270323596
29380857_4622908,CM021108.1,9,29380857,269137626,6683672,4622908,273760534,270324761
29380857_4622914,CM021108.1,9,29380857,269137626,6683672,4622914,273760540,270324767
29380857_4941505,CM021108.1,9,29380857,269137626,6683672,4941505,274079131,270643358
29380857_4941609,CM021108.1,9,29380857,269137626,6683672,4941609,274079235,270643462
29380857_4941743,CM021108.1,9,29380857,269137626,6683672,4941743,274079369,270643596
29380857_5452302,CM021108.1,9,29380857,269137626,6683672,5452302,274589928,271154155
29380857_5452378,CM021108.1,9,29380857,269137626,6683672,5452378,274590004,271154231
29377207_14320,CM021108.1,9,29377207,283309325,2625273,14320,283323645,279887872
29377207_14605,CM021108.1,9,29377207,283309325,2625273,14605,283323930,279888157
29377207_14685,CM021108.1,9,29377207,283309325,2625273,14685,283324010,279888237
29381898_14646,CM021108.1,9,29381898,283312109,879618,14646,283326755,279890982
29377207_17451,CM021108.1,9,29377207,283309325,2625273,17451,283326776,279891003
29377207_17835,CM021108.1,9,29377207,283309325,2625273,17835,283327160,279891387
29377207_17852,CM021108.1,9,29377207,283309325,2625273,17852,283327177,279891404
29379664_19195,CM021108.1,9,29379664,283308565,423468,19195,283327760,279891987
29382040_33229,CM021108.1,9,29382040,283308568,5058076,33229,283341797,279906024
29382040_33317,CM021108.1,9,29382040,283308568,5058076,33317,283341885,279906112
29382040_33391,CM021108.1,9,29382040,283308568,5058076,33391,283341959,279906186
29382040_33407,CM021108.1,9,29382040,283308568,5058076,33407,283341975,279906202
29382040_33447,CM021108.1,9,29382040,283308568,5058076,33447,283342015,279906242
29382040_33501,CM021108.1,9,29382040,283308568,5058076,33501,283342069,279906296
29379926_38304,CM021108.1,9,29379926,283308563,462886,38304,283346867,279911094
29379926_38353,CM021108.1,9,29379926,283308563,462886,38353,283346916,279911143
29379926_40378,CM021108.1,9,29379926,283308563,462886,40378,283348941,279913168
29379926_40418,CM021108.1,9,29379926,283308563,462886,40418,283348981,279913208
29379926_40423,CM021108.1,9,29379926,283308563,462886,40423,283348986,279913213
29379926_40474,CM021108.1,9,29379926,283308563,462886,40474,283349037,279913264
29380528_47874,CM021108.1,9,29380528,283311876,286257,47874,283359750,279923977
29380528_48052,CM021108.1,9,29380528,283311876,286257,48052,283359928,279924155
29379736_59461,CM021108.1,9,29379736,283308565,5447651,59461,283368026,279932253
29379736_59492,CM021108.1,9,29379736,283308565,5447651,59492,283368057,279932284
29379736_59535,CM021108.1,9,29379736,283308565,5447651,59535,283368100,279932327
29379736_59550,CM021108.1,9,29379736,283308565,5447651,59550,283368115,279932342
29382040_74647,CM021108.1,9,29382040,283308568,5058076,74647,283383215,279947442
29379926_135244,CM021108.1,9,29379926,283308563,462886,135244,283443807,280008034
29379926_135271,CM021108.1,9,29379926,283308563,462886,135271,283443834,280008061
29381582_145320,CM021108.1,9,29381582,283308814,3239592,145320,283454134,280018361
29381582_145323,CM021108.1,9,29381582,283308814,3239592,145323,283454137,280018364
29379926_146080,CM021108.1,9,29379926,283308563,462886,146080,283454643,280018870
29379926_146157,CM021108.1,9,29379926,283308563,462886,146157,283454720,280018947
29379926_146815,CM021108.1,9,29379926,283308563,462886,146815,283455378,280019605
29379926_146896,CM021108.1,9,29379926,283308563,462886,146896,283455459,280019686
29379926_146912,CM021108.1,9,29379926,283308563,462886,146912,283455475,280019702
29377775_154162,CM021108.1,9,29377775,283308566,1645223,154162,283462728,280026955
29377775_154195,CM021108.1,9,29377775,283308566,1645223,154195,283462761,280026988
29377775_154231,CM021108.1,9,29377775,283308566,1645223,154231,283462797,280027024
29379747_164354,CM021108.1,9,29379747,283312421,3886027,164354,283476775,280041002
29379747_164428,CM021108.1,9,29379747,283312421,3886027,164428,283476849,280041076
29379747_164524,CM021108.1,9,29379747,283312421,3886027,164524,283476945,280041172
29379747_164535,CM021108.1,9,29379747,283312421,3886027,164535,283476956,280041183
29379747_164549,CM021108.1,9,29379747,283312421,3886027,164549,283476970,280041197
29379747_164564,CM021108.1,9,29379747,283312421,3886027,164564,283476985,280041212
29379747_164571,CM021108.1,9,29379747,283312421,3886027,164571,283476992,280041219
29379747_164601,CM021108.1,9,29379747,283312421,3886027,164601,283477022,280041249
29379747_164602,CM021108.1,9,29379747,283312421,3886027,164602,283477023,280041250
29379747_164627,CM021108.1,9,29379747,283312421,3886027,164627,283477048,280041275
29379747_164651,CM021108.1,9,29379747,283312421,3886027,164651,283477072,280041299
29379687_170675,CM021108.1,9,29379687,283310672,1700643,170675,283481347,280045574
29379687_170954,CM021108.1,9,29379687,283310672,1700643,170954,283481626,280045853
29379687_170981,CM021108.1,9,29379687,283310672,1700643,170981,283481653,280045880
29379926_175209,CM021108.1,9,29379926,283308563,462886,175209,283483772,280047999
29378682_180389,CM021108.1,9,29378682,283308568,11888216,180389,283488957,280053184
29381473_185501,CM021108.1,9,29381473,283311795,797927,185501,283497296,280061523
29381473_185523,CM021108.1,9,29381473,283311795,797927,185523,283497318,280061545
29381473_185531,CM021108.1,9,29381473,283311795,797927,185531,283497326,280061553
29381473_185548,CM021108.1,9,29381473,283311795,797927,185548,283497343,280061570
29381473_185622,CM021108.1,9,29381473,283311795,797927,185622,283497417,280061644
29381473_185623,CM021108.1,9,29381473,283311795,797927,185623,283497418,280061645
29381473_185626,CM021108.1,9,29381473,283311795,797927,185626,283497421,280061648
29381473_185639,CM021108.1,9,29381473,283311795,797927,185639,283497434,280061661
29381473_185642,CM021108.1,9,29381473,283311795,797927,185642,283497437,280061664
29379687_210016,CM021108.1,9,29379687,283310672,1700643,210016,283520688,280084915
29379687_210072,CM021108.1,9,29379687,283310672,1700643,210072,283520744,280084971
29379687_210317,CM021108.1,9,29379687,283310672,1700643,210317,283520989,280085216
29380528_210462,CM021108.1,9,29380528,283311876,286257,210462,283522338,280086565
29379926_217996,CM021108.1,9,29379926,283308563,462886,217996,283526559,280090786
29381473_215467,CM021108.1,9,29381473,283311795,797927,215467,283527262,280091489
29381473_215520,CM021108.1,9,29381473,283311795,797927,215520,283527315,280091542
29381473_215529,CM021108.1,9,29381473,283311795,797927,215529,283527324,280091551
29381473_215533,CM021108.1,9,29381473,283311795,797927,215533,283527328,280091555
29378682_233301,CM021108.1,9,29378682,283308568,11888216,233301,283541869,280106096
29378682_233302,CM021108.1,9,29378682,283308568,11888216,233302,283541870,280106097
29377475_240907,CM021108.1,9,29377475,283308565,499064,240907,283549472,280113699
29380528_250075,CM021108.1,9,29380528,283311876,286257,250075,283561951,280126178
29380528_250107,CM021108.1,9,29380528,283311876,286257,250107,283561983,280126210
29379664_259754,CM021108.1,9,29379664,283308565,423468,259754,283568319,280132546
29379664_259795,CM021108.1,9,29379664,283308565,423468,259795,283568360,280132587
29379687_285968,CM021108.1,9,29379687,283310672,1700643,285968,283596640,280160867
29379687_286207,CM021108.1,9,29379687,283310672,1700643,286207,283596879,280161106
29381582_309405,CM021108.1,9,29381582,283308814,3239592,309405,283618219,280182446
29381582_333334,CM021108.1,9,29381582,283308814,3239592,333334,283642148,280206375
29381582_333378,CM021108.1,9,29381582,283308814,3239592,333378,283642192,280206419
29381582_333422,CM021108.1,9,29381582,283308814,3239592,333422,283642236,280206463
29377207_335058,CM021108.1,9,29377207,283309325,2625273,335058,283644383,280208610
29377207_335079,CM021108.1,9,29377207,283309325,2625273,335079,283644404,280208631
29377207_336491,CM021108.1,9,29377207,283309325,2625273,336491,283645816,280210043
29378540_338813,CM021108.1,9,29378540,283308566,1596860,338813,283647379,280211606
29377207_339096,CM021108.1,9,29377207,283309325,2625273,339096,283648421,280212648
29377207_339196,CM021108.1,9,29377207,283309325,2625273,339196,283648521,280212748
29377207_339210,CM021108.1,9,29377207,283309325,2625273,339210,283648535,280212762
29377207_340906,CM021108.1,9,29377207,283309325,2625273,340906,283650231,280214458
29377207_340913,CM021108.1,9,29377207,283309325,2625273,340913,283650238,280214465
29377207_340937,CM021108.1,9,29377207,283309325,2625273,340937,283650262,280214489
29377207_340946,CM021108.1,9,29377207,283309325,2625273,340946,283650271,280214498
29377495_350843,CM021108.1,9,29377495,283308566,1811116,350843,283659409,280223636
29377495_350845,CM021108.1,9,29377495,283308566,1811116,350845,283659411,280223638
29377349_361303,CM021108.1,9,29377349,283308566,4101544,361303,283669869,280234096
29377349_364550,CM021108.1,9,29377349,283308566,4101544,364550,283673116,280237343
29377207_374691,CM021108.1,9,29377207,283309325,2625273,374691,283684016,280248243
29379747_373018,CM021108.1,9,29379747,283312421,3886027,373018,283685439,280249666
29379747_373106,CM021108.1,9,29379747,283312421,3886027,373106,283685527,280249754
29379687_388127,CM021108.1,9,29379687,283310672,1700643,388127,283698799,280263026
29379687_388172,CM021108.1,9,29379687,283310672,1700643,388172,283698844,280263071
29379687_388180,CM021108.1,9,29379687,283310672,1700643,388180,283698852,280263079
29378540_443969,CM021108.1,9,29378540,283308566,1596860,443969,283752535,280316762
29378540_444054,CM021108.1,9,29378540,283308566,1596860,444054,283752620,280316847
29377207_473063,CM021108.1,9,29377207,283309325,2625273,473063,283782388,280346615
29381804_494757,CM021108.1,9,29381804,283313015,6663030,494757,283807772,280371999
29381582_509988,CM021108.1,9,29381582,283308814,3239592,509988,283818802,280383029
29381582_509999,CM021108.1,9,29381582,283308814,3239592,509999,283818813,280383040
29378540_512306,CM021108.1,9,29378540,283308566,1596860,512306,283820872,280385099
29378540_512403,CM021108.1,9,29378540,283308566,1596860,512403,283820969,280385196
29381548_518976,CM021108.1,9,29381548,283308565,2399327,518976,283827541,280391768
29381548_518993,CM021108.1,9,29381548,283308565,2399327,518993,283827558,280391785
29381548_519028,CM021108.1,9,29381548,283308565,2399327,519028,283827593,280391820
29381548_519064,CM021108.1,9,29381548,283308565,2399327,519064,283827629,280391856
29381548_519065,CM021108.1,9,29381548,283308565,2399327,519065,283827630,280391857
29381548_519104,CM021108.1,9,29381548,283308565,2399327,519104,283827669,280391896
29381548_519136,CM021108.1,9,29381548,283308565,2399327,519136,283827701,280391928
29381548_519171,CM021108.1,9,29381548,283308565,2399327,519171,283827736,280391963
29381548_519178,CM021108.1,9,29381548,283308565,2399327,519178,283827743,280391970
29381548_519190,CM021108.1,9,29381548,283308565,2399327,519190,283827755,280391982
29381548_519258,CM021108.1,9,29381548,283308565,2399327,519258,283827823,280392050
29377775_543570,CM021108.1,9,29377775,283308566,1645223,543570,283852136,280416363
29381582_545693,CM021108.1,9,29381582,283308814,3239592,545693,283854507,280418734
29381582_545754,CM021108.1,9,29381582,283308814,3239592,545754,283854568,280418795
29381582_545813,CM021108.1,9,29381582,283308814,3239592,545813,283854627,280418854
29377235_549984,CM021108.1,9,29377235,283308562,1944388,549984,283858546,280422773
29377235_550025,CM021108.1,9,29377235,283308562,1944388,550025,283858587,280422814
29377235_550034,CM021108.1,9,29377235,283308562,1944388,550034,283858596,280422823
29377235_550058,CM021108.1,9,29377235,283308562,1944388,550058,283858620,280422847
29377235_550086,CM021108.1,9,29377235,283308562,1944388,550086,283858648,280422875
29377235_550092,CM021108.1,9,29377235,283308562,1944388,550092,283858654,280422881
29377235_550094,CM021108.1,9,29377235,283308562,1944388,550094,283858656,280422883
29377235_550106,CM021108.1,9,29377235,283308562,1944388,550106,283858668,280422895
29377235_550112,CM021108.1,9,29377235,283308562,1944388,550112,283858674,280422901
29377235_550125,CM021108.1,9,29377235,283308562,1944388,550125,283858687,280422914
29377235_550140,CM021108.1,9,29377235,283308562,1944388,550140,283858702,280422929
29377235_550203,CM021108.1,9,29377235,283308562,1944388,550203,283858765,280422992
29379166_581348,CM021108.1,9,29379166,283308565,910955,581348,283889913,280454140
29378540_592710,CM021108.1,9,29378540,283308566,1596860,592710,283901276,280465503
29378540_594114,CM021108.1,9,29378540,283308566,1596860,594114,283902680,280466907
29377775_597770,CM021108.1,9,29377775,283308566,1645223,597770,283906336,280470563
29377775_597799,CM021108.1,9,29377775,283308566,1645223,597799,283906365,280470592
29378540_599687,CM021108.1,9,29378540,283308566,1596860,599687,283908253,280472480
29377775_600442,CM021108.1,9,29377775,283308566,1645223,600442,283909008,280473235
29381804_603429,CM021108.1,9,29381804,283313015,6663030,603429,283916444,280480671
29381898_608786,CM021108.1,9,29381898,283312109,879618,608786,283920895,280485122
29381898_608789,CM021108.1,9,29381898,283312109,879618,608789,283920898,280485125
29381898_608915,CM021108.1,9,29381898,283312109,879618,608915,283921024,280485251
29381898_608928,CM021108.1,9,29381898,283312109,879618,608928,283921037,280485264
29381898_609078,CM021108.1,9,29381898,283312109,879618,609078,283921187,280485414
29381898_609083,CM021108.1,9,29381898,283312109,879618,609083,283921192,280485419
29378540_672811,CM021108.1,9,29378540,283308566,1596860,672811,283981377,280545604
29378540_672911,CM021108.1,9,29378540,283308566,1596860,672911,283981477,280545704
29378540_673055,CM021108.1,9,29378540,283308566,1596860,673055,283981621,280545848
29379747_680206,CM021108.1,9,29379747,283312421,3886027,680206,283992627,280556854
29379747_680279,CM021108.1,9,29379747,283312421,3886027,680279,283992700,280556927
29378540_685788,CM021108.1,9,29378540,283308566,1596860,685788,283994354,280558581
29378540_685862,CM021108.1,9,29378540,283308566,1596860,685862,283994428,280558655
29380629_682674,CM021108.1,9,29380629,283312363,3466814,682674,283995037,280559264
29380629_703052,CM021108.1,9,29380629,283312363,3466814,703052,284015415,280579642
29380629_703068,CM021108.1,9,29380629,283312363,3466814,703068,284015431,280579658
29380629_728243,CM021108.1,9,29380629,283312363,3466814,728243,284040606,280604833
29380629_734236,CM021108.1,9,29380629,283312363,3466814,734236,284046599,280610826
29380629_735018,CM021108.1,9,29380629,283312363,3466814,735018,284047381,280611608
29377791_747322,CM021108.1,9,29377791,283314241,938568,747322,284061563,280625790
29377791_747598,CM021108.1,9,29377791,283314241,938568,747598,284061839,280626066
29377818_828958,CM021108.1,9,29377818,283308566,1838431,828958,284137524,280701751
29379747_848652,CM021108.1,9,29379747,283312421,3886027,848652,284161073,280725300
29379747_848694,CM021108.1,9,29379747,283312421,3886027,848694,284161115,280725342
29379747_848784,CM021108.1,9,29379747,283312421,3886027,848784,284161205,280725432
29380629_920718,CM021108.1,9,29380629,283312363,3466814,920718,284233081,280797308
29379687_950892,CM021108.1,9,29379687,283310672,1700643,950892,284261564,280825791
29379687_950930,CM021108.1,9,29379687,283310672,1700643,950930,284261602,280825829
29379687_950945,CM021108.1,9,29379687,283310672,1700643,950945,284261617,280825844
29379687_951423,CM021108.1,9,29379687,283310672,1700643,951423,284262095,280826322
29377207_989998,CM021108.1,9,29377207,283309325,2625273,989998,284299323,280863550
29377207_989999,CM021108.1,9,29377207,283309325,2625273,989999,284299324,280863551
29379687_992147,CM021108.1,9,29379687,283310672,1700643,992147,284302819,280867046
29379687_992204,CM021108.1,9,29379687,283310672,1700643,992204,284302876,280867103
29379687_992246,CM021108.1,9,29379687,283310672,1700643,992246,284302918,280867145
29379687_1008334,CM021108.1,9,29379687,283310672,1700643,1008334,284319006,280883233
29379687_1008364,CM021108.1,9,29379687,283310672,1700643,1008364,284319036,280883263
29379687_1008560,CM021108.1,9,29379687,283310672,1700643,1008560,284319232,280883459
29382040_1011296,CM021108.1,9,29382040,283308568,5058076,1011296,284319864,280884091
29382040_1011535,CM021108.1,9,29382040,283308568,5058076,1011535,284320103,280884330
29379687_1011620,CM021108.1,9,29379687,283310672,1700643,1011620,284322292,280886519
29379687_1042501,CM021108.1,9,29379687,283310672,1700643,1042501,284353173,280917400
29379687_1045272,CM021108.1,9,29379687,283310672,1700643,1045272,284355944,280920171
29379687_1045279,CM021108.1,9,29379687,283310672,1700643,1045279,284355951,280920178
29379687_1045323,CM021108.1,9,29379687,283310672,1700643,1045323,284355995,280920222
29379687_1045325,CM021108.1,9,29379687,283310672,1700643,1045325,284355997,280920224
29379687_1046225,CM021108.1,9,29379687,283310672,1700643,1046225,284356897,280921124
29379687_1046274,CM021108.1,9,29379687,283310672,1700643,1046274,284356946,280921173
29379687_1046279,CM021108.1,9,29379687,283310672,1700643,1046279,284356951,280921178
29379687_1046293,CM021108.1,9,29379687,283310672,1700643,1046293,284356965,280921192
29378322_1058914,CM021108.1,9,29378322,283308568,2226168,1058914,284367482,280931709
29379736_1135977,CM021108.1,9,29379736,283308565,5447651,1135977,284444542,281008769
29379736_1136001,CM021108.1,9,29379736,283308565,5447651,1136001,284444566,281008793
29379736_1136047,CM021108.1,9,29379736,283308565,5447651,1136047,284444612,281008839
29378682_1173569,CM021108.1,9,29378682,283308568,11888216,1173569,284482137,281046364
29377207_1183695,CM021108.1,9,29377207,283309325,2625273,1183695,284493020,281057247
29377367_1193965,CM021108.1,9,29377367,283308565,1549885,1193965,284502530,281066757
29377349_1201555,CM021108.1,9,29377349,283308566,4101544,1201555,284510121,281074348
29377349_1201639,CM021108.1,9,29377349,283308566,4101544,1201639,284510205,281074432
29377349_1201683,CM021108.1,9,29377349,283308566,4101544,1201683,284510249,281074476
29377367_1203741,CM021108.1,9,29377367,283308565,1549885,1203741,284512306,281076533
29377367_1204266,CM021108.1,9,29377367,283308565,1549885,1204266,284512831,281077058
29382040_1226098,CM021108.1,9,29382040,283308568,5058076,1226098,284534666,281098893
29377367_1249796,CM021108.1,9,29377367,283308565,1549885,1249796,284558361,281122588
29381548_1354135,CM021108.1,9,29381548,283308565,2399327,1354135,284662700,281226927
29378540_1366423,CM021108.1,9,29378540,283308566,1596860,1366423,284674989,281239216
29378540_1366438,CM021108.1,9,29378540,283308566,1596860,1366438,284675004,281239231
29378540_1366459,CM021108.1,9,29378540,283308566,1596860,1366459,284675025,281239252
29378540_1366483,CM021108.1,9,29378540,283308566,1596860,1366483,284675049,281239276
29378540_1366511,CM021108.1,9,29378540,283308566,1596860,1366511,284675077,281239304
29378540_1366548,CM021108.1,9,29378540,283308566,1596860,1366548,284675114,281239341
29378540_1394035,CM021108.1,9,29378540,283308566,1596860,1394035,284702601,281266828
29378540_1394798,CM021108.1,9,29378540,283308566,1596860,1394798,284703364,281267591
29378540_1406198,CM021108.1,9,29378540,283308566,1596860,1406198,284714764,281278991
29378540_1406267,CM021108.1,9,29378540,283308566,1596860,1406267,284714833,281279060
29378540_1406382,CM021108.1,9,29378540,283308566,1596860,1406382,284714948,281279175
29381548_1445205,CM021108.1,9,29381548,283308565,2399327,1445205,284753770,281317997
29381548_1445467,CM021108.1,9,29381548,283308565,2399327,1445467,284754032,281318259
29381548_1445487,CM021108.1,9,29381548,283308565,2399327,1445487,284754052,281318279
29381548_1445490,CM021108.1,9,29381548,283308565,2399327,1445490,284754055,281318282
29381548_1456864,CM021108.1,9,29381548,283308565,2399327,1456864,284765429,281329656
29378540_1466468,CM021108.1,9,29378540,283308566,1596860,1466468,284775034,281339261
29377349_1531483,CM021108.1,9,29377349,283308566,4101544,1531483,284840049,281404276
29378540_1533076,CM021108.1,9,29378540,283308566,1596860,1533076,284841642,281405869
29378540_1533097,CM021108.1,9,29378540,283308566,1596860,1533097,284841663,281405890
29378540_1533118,CM021108.1,9,29378540,283308566,1596860,1533118,284841684,281405911
29378540_1533127,CM021108.1,9,29378540,283308566,1596860,1533127,284841693,281405920
29377207_1648699,CM021108.1,9,29377207,283309325,2625273,1648699,284958024,281522251
29380415_1731050,CM021108.1,9,29380415,283308559,4603624,1731050,285039609,281603836
29380415_1731082,CM021108.1,9,29380415,283308559,4603624,1731082,285039641,281603868
29380415_1731092,CM021108.1,9,29380415,283308559,4603624,1731092,285039651,281603878
29380415_1731167,CM021108.1,9,29380415,283308559,4603624,1731167,285039726,281603953
29380415_1731239,CM021108.1,9,29380415,283308559,4603624,1731239,285039798,281604025
29380415_1735144,CM021108.1,9,29380415,283308559,4603624,1735144,285043703,281607930
29380415_1735156,CM021108.1,9,29380415,283308559,4603624,1735156,285043715,281607942
29380415_1735164,CM021108.1,9,29380415,283308559,4603624,1735164,285043723,281607950
29380415_1735186,CM021108.1,9,29380415,283308559,4603624,1735186,285043745,281607972
29380415_1735223,CM021108.1,9,29380415,283308559,4603624,1735223,285043782,281608009
29380415_1735972,CM021108.1,9,29380415,283308559,4603624,1735972,285044531,281608758
29380415_1736006,CM021108.1,9,29380415,283308559,4603624,1736006,285044565,281608792
29380415_1736065,CM021108.1,9,29380415,283308559,4603624,1736065,285044624,281608851
29380415_1736131,CM021108.1,9,29380415,283308559,4603624,1736131,285044690,281608917
29377207_1801632,CM021108.1,9,29377207,283309325,2625273,1801632,285110957,281675184
29377207_1801843,CM021108.1,9,29377207,283309325,2625273,1801843,285111168,281675395
29380629_1838476,CM021108.1,9,29380629,283312363,3466814,1838476,285150839,281715066
29381548_1912923,CM021108.1,9,29381548,283308565,2399327,1912923,285221488,281785715
29377349_1941774,CM021108.1,9,29377349,283308566,4101544,1941774,285250340,281814567
29377349_1942848,CM021108.1,9,29377349,283308566,4101544,1942848,285251414,281815641
29381548_1947045,CM021108.1,9,29381548,283308565,2399327,1947045,285255610,281819837
29377349_1951116,CM021108.1,9,29377349,283308566,4101544,1951116,285259682,281823909
29381804_1980159,CM021108.1,9,29381804,283313015,6663030,1980159,285293174,281857401
29381804_1980284,CM021108.1,9,29381804,283313015,6663030,1980284,285293299,281857526
29381548_1989008,CM021108.1,9,29381548,283308565,2399327,1989008,285297573,281861800
29377207_1997960,CM021108.1,9,29377207,283309325,2625273,1997960,285307285,281871512
29377207_2000913,CM021108.1,9,29377207,283309325,2625273,2000913,285310238,281874465
29378682_2070047,CM021108.1,9,29378682,283308568,11888216,2070047,285378615,281942842
29380736_2160314,CM021108.1,9,29380736,283312407,4482601,2160314,285472721,282036948
29379736_2209331,CM021108.1,9,29379736,283308565,5447651,2209331,285517896,282082123
29381804_2318038,CM021108.1,9,29381804,283313015,6663030,2318038,285631053,282195280
29381804_2318066,CM021108.1,9,29381804,283313015,6663030,2318066,285631081,282195308
29381804_2318073,CM021108.1,9,29381804,283313015,6663030,2318073,285631088,282195315
29381804_2318101,CM021108.1,9,29381804,283313015,6663030,2318101,285631116,282195343
29381804_2318105,CM021108.1,9,29381804,283313015,6663030,2318105,285631120,282195347
29381804_2318110,CM021108.1,9,29381804,283313015,6663030,2318110,285631125,282195352
29381804_2318120,CM021108.1,9,29381804,283313015,6663030,2318120,285631135,282195362
29378682_2324205,CM021108.1,9,29378682,283308568,11888216,2324205,285632773,282197000
29378682_2324262,CM021108.1,9,29378682,283308568,11888216,2324262,285632830,282197057
29378682_2324455,CM021108.1,9,29378682,283308568,11888216,2324455,285633023,282197250
29377349_2441021,CM021108.1,9,29377349,283308566,4101544,2441021,285749587,282313814
29377207_2566046,CM021108.1,9,29377207,283309325,2625273,2566046,285875371,282439598
29377207_2566125,CM021108.1,9,29377207,283309325,2625273,2566125,285875450,282439677
29377207_2566165,CM021108.1,9,29377207,283309325,2625273,2566165,285875490,282439717
29379736_2585377,CM021108.1,9,29379736,283308565,5447651,2585377,285893942,282458169
29379736_2585481,CM021108.1,9,29379736,283308565,5447651,2585481,285894046,282458273
29379736_2585482,CM021108.1,9,29379736,283308565,5447651,2585482,285894047,282458274
29379736_2585526,CM021108.1,9,29379736,283308565,5447651,2585526,285894091,282458318
29379736_2585540,CM021108.1,9,29379736,283308565,5447651,2585540,285894105,282458332
29377207_2595981,CM021108.1,9,29377207,283309325,2625273,2595981,285905306,282469533
29380629_2616273,CM021108.1,9,29380629,283312363,3466814,2616273,285928636,282492863
29378118_2687018,CM021108.1,9,29378118,283311829,2759047,2687018,285998847,282563074
29381804_2905061,CM021108.1,9,29381804,283313015,6663030,2905061,286218076,282782303
29381804_2905155,CM021108.1,9,29381804,283313015,6663030,2905155,286218170,282782397
29381804_2905156,CM021108.1,9,29381804,283313015,6663030,2905156,286218171,282782398
29381804_2905275,CM021108.1,9,29381804,283313015,6663030,2905275,286218290,282782517
29378682_2923289,CM021108.1,9,29378682,283308568,11888216,2923289,286231857,282796084
29378682_2923343,CM021108.1,9,29378682,283308568,11888216,2923343,286231911,282796138
29378682_2932547,CM021108.1,9,29378682,283308568,11888216,2932547,286241115,282805342
29378682_2953562,CM021108.1,9,29378682,283308568,11888216,2953562,286262130,282826357
29378682_2965396,CM021108.1,9,29378682,283308568,11888216,2965396,286273964,282838191
29378682_3004886,CM021108.1,9,29378682,283308568,11888216,3004886,286313454,282877681
29378682_3004929,CM021108.1,9,29378682,283308568,11888216,3004929,286313497,282877724
29378682_3005019,CM021108.1,9,29378682,283308568,11888216,3005019,286313587,282877814
29378682_3005235,CM021108.1,9,29378682,283308568,11888216,3005235,286313803,282878030
29381804_3073582,CM021108.1,9,29381804,283313015,6663030,3073582,286386597,282950824
29381804_3073674,CM021108.1,9,29381804,283313015,6663030,3073674,286386689,282950916
29381804_3073707,CM021108.1,9,29381804,283313015,6663030,3073707,286386722,282950949
29381804_3073741,CM021108.1,9,29381804,283313015,6663030,3073741,286386756,282950983
29381804_3073745,CM021108.1,9,29381804,283313015,6663030,3073745,286386760,282950987
29381804_3073784,CM021108.1,9,29381804,283313015,6663030,3073784,286386799,282951026
29380736_3281008,CM021108.1,9,29380736,283312407,4482601,3281008,286593415,283157642
29382040_3387769,CM021108.1,9,29382040,283308568,5058076,3387769,286696337,283260564
29382040_3387771,CM021108.1,9,29382040,283308568,5058076,3387771,286696339,283260566
29382040_3387815,CM021108.1,9,29382040,283308568,5058076,3387815,286696383,283260610
29382040_3387816,CM021108.1,9,29382040,283308568,5058076,3387816,286696384,283260611
29382040_3388091,CM021108.1,9,29382040,283308568,5058076,3388091,286696659,283260886
29382040_3388118,CM021108.1,9,29382040,283308568,5058076,3388118,286696686,283260913
29377349_3455829,CM021108.1,9,29377349,283308566,4101544,3455829,286764395,283328622
29377349_3455850,CM021108.1,9,29377349,283308566,4101544,3455850,286764416,283328643
29377349_3455861,CM021108.1,9,29377349,283308566,4101544,3455861,286764427,283328654
29377349_3455864,CM021108.1,9,29377349,283308566,4101544,3455864,286764430,283328657
29377349_3455874,CM021108.1,9,29377349,283308566,4101544,3455874,286764440,283328667
29377349_3455915,CM021108.1,9,29377349,283308566,4101544,3455915,286764481,283328708
29377349_3455928,CM021108.1,9,29377349,283308566,4101544,3455928,286764494,283328721
29377349_3455943,CM021108.1,9,29377349,283308566,4101544,3455943,286764509,283328736
29377349_3455945,CM021108.1,9,29377349,283308566,4101544,3455945,286764511,283328738
29377349_3455974,CM021108.1,9,29377349,283308566,4101544,3455974,286764540,283328767
29377349_3455980,CM021108.1,9,29377349,283308566,4101544,3455980,286764546,283328773
29377349_3456011,CM021108.1,9,29377349,283308566,4101544,3456011,286764577,283328804
29382040_3558073,CM021108.1,9,29382040,283308568,5058076,3558073,286866641,283430868
29382040_3558114,CM021108.1,9,29382040,283308568,5058076,3558114,286866682,283430909
29382040_3558117,CM021108.1,9,29382040,283308568,5058076,3558117,286866685,283430912
29382040_3558148,CM021108.1,9,29382040,283308568,5058076,3558148,286866716,283430943
29382040_3558156,CM021108.1,9,29382040,283308568,5058076,3558156,286866724,283430951
29382040_3641099,CM021108.1,9,29382040,283308568,5058076,3641099,286949667,283513894
29382040_3653432,CM021108.1,9,29382040,283308568,5058076,3653432,286962000,283526227
29382040_3685980,CM021108.1,9,29382040,283308568,5058076,3685980,286994548,283558775
29380415_3694611,CM021108.1,9,29380415,283308559,4603624,3694611,287003170,283567397
29380415_3694634,CM021108.1,9,29380415,283308559,4603624,3694634,287003193,283567420
29380415_3694669,CM021108.1,9,29380415,283308559,4603624,3694669,287003228,283567455
29378682_3747160,CM021108.1,9,29378682,283308568,11888216,3747160,287055728,283619955
29380415_3759556,CM021108.1,9,29380415,283308559,4603624,3759556,287068115,283632342
29378682_3772947,CM021108.1,9,29378682,283308568,11888216,3772947,287081515,283645742
29378682_3773063,CM021108.1,9,29378682,283308568,11888216,3773063,287081631,283645858
29379736_3773753,CM021108.1,9,29379736,283308565,5447651,3773753,287082318,283646545
29379736_3773792,CM021108.1,9,29379736,283308565,5447651,3773792,287082357,283646584
29378682_3798668,CM021108.1,9,29378682,283308568,11888216,3798668,287107236,283671463
29378682_3799051,CM021108.1,9,29378682,283308568,11888216,3799051,287107619,283671846
29378682_3799072,CM021108.1,9,29378682,283308568,11888216,3799072,287107640,283671867
29378682_3832177,CM021108.1,9,29378682,283308568,11888216,3832177,287140745,283704972
29381692_4019456,CM021108.1,9,29381692,283308561,4596791,4019456,287328017,283892244
29380736_4016232,CM021108.1,9,29380736,283312407,4482601,4016232,287328639,283892866
29380415_4033439,CM021108.1,9,29380415,283308559,4603624,4033439,287341998,283906225
29380415_4033469,CM021108.1,9,29380415,283308559,4603624,4033469,287342028,283906255
29377349_4071490,CM021108.1,9,29377349,283308566,4101544,4071490,287380056,283944283
29377349_4071893,CM021108.1,9,29377349,283308566,4101544,4071893,287380459,283944686
29377349_4071957,CM021108.1,9,29377349,283308566,4101544,4071957,287380523,283944750
29377349_4072025,CM021108.1,9,29377349,283308566,4101544,4072025,287380591,283944818
29379736_4265560,CM021108.1,9,29379736,283308565,5447651,4265560,287574125,284138352
29379736_4265584,CM021108.1,9,29379736,283308565,5447651,4265584,287574149,284138376
29379736_4265639,CM021108.1,9,29379736,283308565,5447651,4265639,287574204,284138431
29379736_4265659,CM021108.1,9,29379736,283308565,5447651,4265659,287574224,284138451
29379736_4309349,CM021108.1,9,29379736,283308565,5447651,4309349,287617914,284182141
29379736_4309355,CM021108.1,9,29379736,283308565,5447651,4309355,287617920,284182147
29379736_4309420,CM021108.1,9,29379736,283308565,5447651,4309420,287617985,284182212
29379736_4309597,CM021108.1,9,29379736,283308565,5447651,4309597,287618162,284182389
29379736_4309608,CM021108.1,9,29379736,283308565,5447651,4309608,287618173,284182400
29379736_4309677,CM021108.1,9,29379736,283308565,5447651,4309677,287618242,284182469
29382040_4346594,CM021108.1,9,29382040,283308568,5058076,4346594,287655162,284219389
29381804_4373401,CM021108.1,9,29381804,283313015,6663030,4373401,287686416,284250643
29381804_4373418,CM021108.1,9,29381804,283313015,6663030,4373418,287686433,284250660
29379736_4437190,CM021108.1,9,29379736,283308565,5447651,4437190,287745755,284309982
29379736_4437213,CM021108.1,9,29379736,283308565,5447651,4437213,287745778,284310005
29381804_4507802,CM021108.1,9,29381804,283313015,6663030,4507802,287820817,284385044
29381804_4507816,CM021108.1,9,29381804,283313015,6663030,4507816,287820831,284385058
29381804_4507878,CM021108.1,9,29381804,283313015,6663030,4507878,287820893,284385120
29381804_4508033,CM021108.1,9,29381804,283313015,6663030,4508033,287821048,284385275
29381804_4508116,CM021108.1,9,29381804,283313015,6663030,4508116,287821131,284385358
29381804_4508173,CM021108.1,9,29381804,283313015,6663030,4508173,287821188,284385415
29381804_4508227,CM021108.1,9,29381804,283313015,6663030,4508227,287821242,284385469
29379736_4544032,CM021108.1,9,29379736,283308565,5447651,4544032,287852597,284416824
29379736_4544033,CM021108.1,9,29379736,283308565,5447651,4544033,287852598,284416825
29379736_4544091,CM021108.1,9,29379736,283308565,5447651,4544091,287852656,284416883
29379736_4560772,CM021108.1,9,29379736,283308565,5447651,4560772,287869337,284433564
29379736_4583063,CM021108.1,9,29379736,283308565,5447651,4583063,287891628,284455855
29379736_4604206,CM021108.1,9,29379736,283308565,5447651,4604206,287912771,284476998
29379736_4634118,CM021108.1,9,29379736,283308565,5447651,4634118,287942683,284506910
29379736_4634130,CM021108.1,9,29379736,283308565,5447651,4634130,287942695,284506922
29379736_4634138,CM021108.1,9,29379736,283308565,5447651,4634138,287942703,284506930
29379736_4634172,CM021108.1,9,29379736,283308565,5447651,4634172,287942737,284506964
29381804_4733819,CM021108.1,9,29381804,283313015,6663030,4733819,288046834,284611061
29381804_4733844,CM021108.1,9,29381804,283313015,6663030,4733844,288046859,284611086
29381804_4733888,CM021108.1,9,29381804,283313015,6663030,4733888,288046903,284611130
29381804_4733921,CM021108.1,9,29381804,283313015,6663030,4733921,288046936,284611163
29381804_4733972,CM021108.1,9,29381804,283313015,6663030,4733972,288046987,284611214
29381804_4733976,CM021108.1,9,29381804,283313015,6663030,4733976,288046991,284611218
29381804_4733983,CM021108.1,9,29381804,283313015,6663030,4733983,288046998,284611225
29381804_4733988,CM021108.1,9,29381804,283313015,6663030,4733988,288047003,284611230
29381804_4739561,CM021108.1,9,29381804,283313015,6663030,4739561,288052576,284616803
29377398_4815467,CM021108.1,9,29377398,283309394,4903829,4815467,288124861,284689088
29377398_4815484,CM021108.1,9,29377398,283309394,4903829,4815484,288124878,284689105
29381804_4883213,CM021108.1,9,29381804,283313015,6663030,4883213,288196228,284760455
29381804_4904646,CM021108.1,9,29381804,283313015,6663030,4904646,288217661,284781888
29381804_5196148,CM021108.1,9,29381804,283313015,6663030,5196148,288509163,285073390
29381804_5196212,CM021108.1,9,29381804,283313015,6663030,5196212,288509227,285073454
29381804_5224054,CM021108.1,9,29381804,283313015,6663030,5224054,288537069,285101296
29381804_5224137,CM021108.1,9,29381804,283313015,6663030,5224137,288537152,285101379
29379736_5309352,CM021108.1,9,29379736,283308565,5447651,5309352,288617917,285182144
29379736_5309867,CM021108.1,9,29379736,283308565,5447651,5309867,288618432,285182659
29379736_5309909,CM021108.1,9,29379736,283308565,5447651,5309909,288618474,285182701
29379736_5331811,CM021108.1,9,29379736,283308565,5447651,5331811,288640376,285204603
29381804_5345795,CM021108.1,9,29381804,283313015,6663030,5345795,288658810,285223037
29381804_5345857,CM021108.1,9,29381804,283313015,6663030,5345857,288658872,285223099
29381804_5345859,CM021108.1,9,29381804,283313015,6663030,5345859,288658874,285223101
29381804_5356431,CM021108.1,9,29381804,283313015,6663030,5356431,288669446,285233673
29381804_5356510,CM021108.1,9,29381804,283313015,6663030,5356510,288669525,285233752
29381804_5356511,CM021108.1,9,29381804,283313015,6663030,5356511,288669526,285233753
29381804_5356553,CM021108.1,9,29381804,283313015,6663030,5356553,288669568,285233795
29378682_8755795,CM021108.1,9,29378682,283308568,11888216,8755795,292064363,288628590
29378682_8755831,CM021108.1,9,29378682,283308568,11888216,8755831,292064399,288628626
29378682_8755844,CM021108.1,9,29378682,283308568,11888216,8755844,292064412,288628639
29378682_9001109,CM021108.1,9,29378682,283308568,11888216,9001109,292309677,288873904
29378682_9002940,CM021108.1,9,29378682,283308568,11888216,9002940,292311508,288875735
29378682_9002947,CM021108.1,9,29378682,283308568,11888216,9002947,292311515,288875742
29378682_9002948,CM021108.1,9,29378682,283308568,11888216,9002948,292311516,288875743
29378682_9002971,CM021108.1,9,29378682,283308568,11888216,9002971,292311539,288875766
29378682_9003212,CM021108.1,9,29378682,283308568,11888216,9003212,292311780,288876007
29378682_11343716,CM021108.1,9,29378682,283308568,11888216,11343716,294652284,291216511
29378682_11499496,CM021108.1,9,29378682,283308568,11888216,11499496,294808064,291372291
29344878_451,CM021108.1,9,29344878,297155724,98444,451,297156175,293720402
29344878_480,CM021108.1,9,29344878,297155724,98444,480,297156204,293720431
29344878_534,CM021108.1,9,29344878,297155724,98444,534,297156258,293720485
29344878_588,CM021108.1,9,29344878,297155724,98444,588,297156312,293720539
29344878_605,CM021108.1,9,29344878,297155724,98444,605,297156329,293720556
29339070_4575,CM021108.1,9,29339070,297158367,31854,4575,297162942,293727169
29339070_4663,CM021108.1,9,29339070,297158367,31854,4663,297163030,293727257
29378558_11261,CM021108.1,9,29378558,297155724,3984627,11261,297166985,293731212
29378558_11306,CM021108.1,9,29378558,297155724,3984627,11306,297167030,293731257
29382473_24763,CM021108.1,9,29382473,297155724,2234960,24763,297180487,293744714
29382473_50121,CM021108.1,9,29382473,297155724,2234960,50121,297205845,293770072
29382473_50160,CM021108.1,9,29382473,297155724,2234960,50160,297205884,293770111
29382473_50529,CM021108.1,9,29382473,297155724,2234960,50529,297206253,293770480
29378558_77554,CM021108.1,9,29378558,297155724,3984627,77554,297233278,293797505
29378558_77556,CM021108.1,9,29378558,297155724,3984627,77556,297233280,293797507
29379663_106732,CM021108.1,9,29379663,297155723,364019,106732,297262455,293826682
29377033_107763,CM021108.1,9,29377033,297155723,543434,107763,297263486,293827713
29377033_107768,CM021108.1,9,29377033,297155723,543434,107768,297263491,293827718
29380220_135814,CM021108.1,9,29380220,297155722,1616786,135814,297291536,293855763
29380220_135964,CM021108.1,9,29380220,297155722,1616786,135964,297291686,293855913
29380220_136010,CM021108.1,9,29380220,297155722,1616786,136010,297291732,293855959
29380220_137118,CM021108.1,9,29380220,297155722,1616786,137118,297292840,293857067
29380220_137155,CM021108.1,9,29380220,297155722,1616786,137155,297292877,293857104
29380220_137503,CM021108.1,9,29380220,297155722,1616786,137503,297293225,293857452
29380220_137555,CM021108.1,9,29380220,297155722,1616786,137555,297293277,293857504
29380220_137578,CM021108.1,9,29380220,297155722,1616786,137578,297293300,293857527
29380220_137587,CM021108.1,9,29380220,297155722,1616786,137587,297293309,293857536
29380220_137588,CM021108.1,9,29380220,297155722,1616786,137588,297293310,293857537
29380220_137609,CM021108.1,9,29380220,297155722,1616786,137609,297293331,293857558
29380220_137610,CM021108.1,9,29380220,297155722,1616786,137610,297293332,293857559
29380220_137623,CM021108.1,9,29380220,297155722,1616786,137623,297293345,293857572
29377594_172641,CM021108.1,9,29377594,297155722,235479,172641,297328363,293892590
29377594_172782,CM021108.1,9,29377594,297155722,235479,172782,297328504,293892731
29378471_209515,CM021108.1,9,29378471,297155723,1523389,209515,297365238,293929465
29378471_209597,CM021108.1,9,29378471,297155723,1523389,209597,297365320,293929547
29377033_209671,CM021108.1,9,29377033,297155723,543434,209671,297365394,293929621
29380324_249364,CM021108.1,9,29380324,297156295,2468731,249364,297405659,293969886
29380324_249458,CM021108.1,9,29380324,297156295,2468731,249458,297405753,293969980
29381739_279648,CM021108.1,9,29381739,297155722,733529,279648,297435370,293999597
29378772_385759,CM021108.1,9,29378772,297155723,2555090,385759,297541482,294105709
29382401_387629,CM021108.1,9,29382401,297155717,5714467,387629,297543346,294107573
29377118_403552,CM021108.1,9,29377118,297155723,2392103,403552,297559275,294123502
29377118_403579,CM021108.1,9,29377118,297155723,2392103,403579,297559302,294123529
29380965_407154,CM021108.1,9,29380965,297155723,5040944,407154,297562877,294127104
29382473_410675,CM021108.1,9,29382473,297155724,2234960,410675,297566399,294130626
29377118_424870,CM021108.1,9,29377118,297155723,2392103,424870,297580593,294144820
29377118_424896,CM021108.1,9,29377118,297155723,2392103,424896,297580619,294144846
29379849_444530,CM021108.1,9,29379849,297155723,1079830,444530,297600253,294164480
29378681_449084,CM021108.1,9,29378681,297155717,968378,449084,297604801,294169028
29378681_449152,CM021108.1,9,29378681,297155717,968378,449152,297604869,294169096
29378681_449169,CM021108.1,9,29378681,297155717,968378,449169,297604886,294169113
29380965_461818,CM021108.1,9,29380965,297155723,5040944,461818,297617541,294181768
29380965_461836,CM021108.1,9,29380965,297155723,5040944,461836,297617559,294181786
29380965_462099,CM021108.1,9,29380965,297155723,5040944,462099,297617822,294182049
29378772_466888,CM021108.1,9,29378772,297155723,2555090,466888,297622611,294186838
29378772_466891,CM021108.1,9,29378772,297155723,2555090,466891,297622614,294186841
29378772_466892,CM021108.1,9,29378772,297155723,2555090,466892,297622615,294186842
29378772_466928,CM021108.1,9,29378772,297155723,2555090,466928,297622651,294186878
29378772_466972,CM021108.1,9,29378772,297155723,2555090,466972,297622695,294186922
29378772_467021,CM021108.1,9,29378772,297155723,2555090,467021,297622744,294186971
29378772_467054,CM021108.1,9,29378772,297155723,2555090,467054,297622777,294187004
29378772_467362,CM021108.1,9,29378772,297155723,2555090,467362,297623085,294187312
29378772_467422,CM021108.1,9,29378772,297155723,2555090,467422,297623145,294187372
29378772_467478,CM021108.1,9,29378772,297155723,2555090,467478,297623201,294187428
29379064_498344,CM021108.1,9,29379064,297155723,1598741,498344,297654067,294218294
29378772_509291,CM021108.1,9,29378772,297155723,2555090,509291,297665014,294229241
29378772_509714,CM021108.1,9,29378772,297155723,2555090,509714,297665437,294229664
29378772_509801,CM021108.1,9,29378772,297155723,2555090,509801,297665524,294229751
29378772_511802,CM021108.1,9,29378772,297155723,2555090,511802,297667525,294231752
29378772_511830,CM021108.1,9,29378772,297155723,2555090,511830,297667553,294231780
29378772_511850,CM021108.1,9,29378772,297155723,2555090,511850,297667573,294231800
29378772_511924,CM021108.1,9,29378772,297155723,2555090,511924,297667647,294231874
29378772_511953,CM021108.1,9,29378772,297155723,2555090,511953,297667676,294231903
29381518_547936,CM021108.1,9,29381518,297155724,5064316,547936,297703660,294267887
29381518_549356,CM021108.1,9,29381518,297155724,5064316,549356,297705080,294269307
29381518_549458,CM021108.1,9,29381518,297155724,5064316,549458,297705182,294269409
29381739_551629,CM021108.1,9,29381739,297155722,733529,551629,297707351,294271578
29381739_551746,CM021108.1,9,29381739,297155722,733529,551746,297707468,294271695
29381126_620268,CM021108.1,9,29381126,297155723,2558528,620268,297775991,294340218
29381126_622622,CM021108.1,9,29381126,297155723,2558528,622622,297778345,294342572
29381739_630658,CM021108.1,9,29381739,297155722,733529,630658,297786380,294350607
29381739_630725,CM021108.1,9,29381739,297155722,733529,630725,297786447,294350674
29377118_631117,CM021108.1,9,29377118,297155723,2392103,631117,297786840,294351067
29381000_677211,CM021108.1,9,29381000,297155724,1376248,677211,297832935,294397162
29381000_677674,CM021108.1,9,29381000,297155724,1376248,677674,297833398,294397625
29381000_677691,CM021108.1,9,29381000,297155724,1376248,677691,297833415,294397642
29381000_679219,CM021108.1,9,29381000,297155724,1376248,679219,297834943,294399170
29381000_679256,CM021108.1,9,29381000,297155724,1376248,679256,297834980,294399207
29381000_679260,CM021108.1,9,29381000,297155724,1376248,679260,297834984,294399211
29381000_679315,CM021108.1,9,29381000,297155724,1376248,679315,297835039,294399266
29380354_683869,CM021108.1,9,29380354,297158929,685973,683869,297842798,294407025
29380354_683902,CM021108.1,9,29380354,297158929,685973,683902,297842831,294407058
29380354_683952,CM021108.1,9,29380354,297158929,685973,683952,297842881,294407108
29377118_705645,CM021108.1,9,29377118,297155723,2392103,705645,297861368,294425595
29377118_705710,CM021108.1,9,29377118,297155723,2392103,705710,297861433,294425660
29378772_716935,CM021108.1,9,29378772,297155723,2555090,716935,297872658,294436885
29378772_716985,CM021108.1,9,29378772,297155723,2555090,716985,297872708,294436935
29378772_716993,CM021108.1,9,29378772,297155723,2555090,716993,297872716,294436943
29378681_780089,CM021108.1,9,29378681,297155717,968378,780089,297935806,294500033
29378681_780174,CM021108.1,9,29378681,297155717,968378,780174,297935891,294500118
29378681_780178,CM021108.1,9,29378681,297155717,968378,780178,297935895,294500122
29378681_780237,CM021108.1,9,29378681,297155717,968378,780237,297935954,294500181
29378424_782112,CM021108.1,9,29378424,297158411,2246581,782112,297940523,294504750
29378424_782218,CM021108.1,9,29378424,297158411,2246581,782218,297940629,294504856
29377707_807946,CM021108.1,9,29377707,297155723,4296607,807946,297963669,294527896
29377707_807951,CM021108.1,9,29377707,297155723,4296607,807951,297963674,294527901
29377707_807996,CM021108.1,9,29377707,297155723,4296607,807996,297963719,294527946
29377707_808019,CM021108.1,9,29377707,297155723,4296607,808019,297963742,294527969
29378772_808583,CM021108.1,9,29378772,297155723,2555090,808583,297964306,294528533
29378772_808640,CM021108.1,9,29378772,297155723,2555090,808640,297964363,294528590
29381126_819085,CM021108.1,9,29381126,297155723,2558528,819085,297974808,294539035
29381126_820826,CM021108.1,9,29381126,297155723,2558528,820826,297976549,294540776
29378772_834867,CM021108.1,9,29378772,297155723,2555090,834867,297990590,294554817
29378772_834915,CM021108.1,9,29378772,297155723,2555090,834915,297990638,294554865
29378772_856201,CM021108.1,9,29378772,297155723,2555090,856201,298011924,294576151
29378558_903557,CM021108.1,9,29378558,297155724,3984627,903557,298059281,294623508
29378558_903994,CM021108.1,9,29378558,297155724,3984627,903994,298059718,294623945
29379560_916255,CM021108.1,9,29379560,297156040,2908261,916255,298072295,294636522
29379560_916283,CM021108.1,9,29379560,297156040,2908261,916283,298072323,294636550
29379560_916337,CM021108.1,9,29379560,297156040,2908261,916337,298072377,294636604
29379560_916340,CM021108.1,9,29379560,297156040,2908261,916340,298072380,294636607
29382401_972351,CM021108.1,9,29382401,297155717,5714467,972351,298128068,294692295
29377118_973220,CM021108.1,9,29377118,297155723,2392103,973220,298128943,294693170
29377118_973623,CM021108.1,9,29377118,297155723,2392103,973623,298129346,294693573
29377118_973628,CM021108.1,9,29377118,297155723,2392103,973628,298129351,294693578
29377118_973672,CM021108.1,9,29377118,297155723,2392103,973672,298129395,294693622
29377118_973742,CM021108.1,9,29377118,297155723,2392103,973742,298129465,294693692
29377118_973743,CM021108.1,9,29377118,297155723,2392103,973743,298129466,294693693
29377118_973774,CM021108.1,9,29377118,297155723,2392103,973774,298129497,294693724
29377118_973777,CM021108.1,9,29377118,297155723,2392103,973777,298129500,294693727
29377118_973781,CM021108.1,9,29377118,297155723,2392103,973781,298129504,294693731
29377118_973797,CM021108.1,9,29377118,297155723,2392103,973797,298129520,294693747
29377118_973830,CM021108.1,9,29377118,297155723,2392103,973830,298129553,294693780
29377118_973848,CM021108.1,9,29377118,297155723,2392103,973848,298129571,294693798
29379763_983552,CM021108.1,9,29379763,297155859,3753541,983552,298139411,294703638
29379763_983622,CM021108.1,9,29379763,297155859,3753541,983622,298139481,294703708
29379763_983793,CM021108.1,9,29379763,297155859,3753541,983793,298139652,294703879
29381518_987494,CM021108.1,9,29381518,297155724,5064316,987494,298143218,294707445
29381518_987505,CM021108.1,9,29381518,297155724,5064316,987505,298143229,294707456
29381518_987651,CM021108.1,9,29381518,297155724,5064316,987651,298143375,294707602
29381518_987653,CM021108.1,9,29381518,297155724,5064316,987653,298143377,294707604
29381518_987654,CM021108.1,9,29381518,297155724,5064316,987654,298143378,294707605
29381518_987702,CM021108.1,9,29381518,297155724,5064316,987702,298143426,294707653
29379064_1037592,CM021108.1,9,29379064,297155723,1598741,1037592,298193315,294757542
29380184_1072365,CM021108.1,9,29380184,297156903,1249054,1072365,298229268,294793495
29380184_1072473,CM021108.1,9,29380184,297156903,1249054,1072473,298229376,294793603
29380184_1073411,CM021108.1,9,29380184,297156903,1249054,1073411,298230314,294794541
29380184_1073513,CM021108.1,9,29380184,297156903,1249054,1073513,298230416,294794643
29380184_1073514,CM021108.1,9,29380184,297156903,1249054,1073514,298230417,294794644
29379831_1092731,CM021108.1,9,29379831,297156084,3319383,1092731,298248815,294813042
29380324_1157032,CM021108.1,9,29380324,297156295,2468731,1157032,298313327,294877554
29380184_1174433,CM021108.1,9,29380184,297156903,1249054,1174433,298331336,294895563
29380184_1174456,CM021108.1,9,29380184,297156903,1249054,1174456,298331359,294895586
29380184_1174653,CM021108.1,9,29380184,297156903,1249054,1174653,298331556,294895783
29380184_1174716,CM021108.1,9,29380184,297156903,1249054,1174716,298331619,294895846
29380184_1174719,CM021108.1,9,29380184,297156903,1249054,1174719,298331622,294895849
29382473_1209194,CM021108.1,9,29382473,297155724,2234960,1209194,298364918,294929145
29382473_1209287,CM021108.1,9,29382473,297155724,2234960,1209287,298365011,294929238
29380965_1210179,CM021108.1,9,29380965,297155723,5040944,1210179,298365902,294930129
29380965_1210209,CM021108.1,9,29380965,297155723,5040944,1210209,298365932,294930159
29380965_1212406,CM021108.1,9,29380965,297155723,5040944,1212406,298368129,294932356
29381518_1215913,CM021108.1,9,29381518,297155724,5064316,1215913,298371637,294935864
29381518_1215964,CM021108.1,9,29381518,297155724,5064316,1215964,298371688,294935915
29381518_1215989,CM021108.1,9,29381518,297155724,5064316,1215989,298371713,294935940
29379064_1276583,CM021108.1,9,29379064,297155723,1598741,1276583,298432306,294996533
29379064_1276651,CM021108.1,9,29379064,297155723,1598741,1276651,298432374,294996601
29379064_1276676,CM021108.1,9,29379064,297155723,1598741,1276676,298432399,294996626
29380965_1285951,CM021108.1,9,29380965,297155723,5040944,1285951,298441674,295005901
29380965_1286128,CM021108.1,9,29380965,297155723,5040944,1286128,298441851,295006078
29380965_1286218,CM021108.1,9,29380965,297155723,5040944,1286218,298441941,295006168
29381518_1304579,CM021108.1,9,29381518,297155724,5064316,1304579,298460303,295024530
29377661_1310938,CM021108.1,9,29377661,297155722,1440399,1310938,298466660,295030887
29381000_1324327,CM021108.1,9,29381000,297155724,1376248,1324327,298480051,295044278
29381000_1324900,CM021108.1,9,29381000,297155724,1376248,1324900,298480624,295044851
29381000_1324965,CM021108.1,9,29381000,297155724,1376248,1324965,298480689,295044916
29379064_1335167,CM021108.1,9,29379064,297155723,1598741,1335167,298490890,295055117
29379064_1335239,CM021108.1,9,29379064,297155723,1598741,1335239,298490962,295055189
29379064_1335252,CM021108.1,9,29379064,297155723,1598741,1335252,298490975,295055202
29381518_1357626,CM021108.1,9,29381518,297155724,5064316,1357626,298513350,295077577
29377118_1408354,CM021108.1,9,29377118,297155723,2392103,1408354,298564077,295128304
29377118_1408414,CM021108.1,9,29377118,297155723,2392103,1408414,298564137,295128364
29381126_1495403,CM021108.1,9,29381126,297155723,2558528,1495403,298651126,295215353
29381126_1495648,CM021108.1,9,29381126,297155723,2558528,1495648,298651371,295215598
29381126_1506640,CM021108.1,9,29381126,297155723,2558528,1506640,298662363,295226590
29379948_1506984,CM021108.1,9,29379948,297155723,5015150,1506984,298662707,295226934
29379948_1506986,CM021108.1,9,29379948,297155723,5015150,1506986,298662709,295226936
29379948_1507000,CM021108.1,9,29379948,297155723,5015150,1507000,298662723,295226950
29379948_1507012,CM021108.1,9,29379948,297155723,5015150,1507012,298662735,295226962
29379948_1507024,CM021108.1,9,29379948,297155723,5015150,1507024,298662747,295226974
29379948_1507039,CM021108.1,9,29379948,297155723,5015150,1507039,298662762,295226989
29379948_1507070,CM021108.1,9,29379948,297155723,5015150,1507070,298662793,295227020
29379948_1507071,CM021108.1,9,29379948,297155723,5015150,1507071,298662794,295227021
29379948_1507115,CM021108.1,9,29379948,297155723,5015150,1507115,298662838,295227065
29379948_1507132,CM021108.1,9,29379948,297155723,5015150,1507132,298662855,295227082
29379948_1507134,CM021108.1,9,29379948,297155723,5015150,1507134,298662857,295227084
29381126_1507912,CM021108.1,9,29381126,297155723,2558528,1507912,298663635,295227862
29378424_1521679,CM021108.1,9,29378424,297158411,2246581,1521679,298680090,295244317
29381126_1533289,CM021108.1,9,29381126,297155723,2558528,1533289,298689012,295253239
29381126_1534976,CM021108.1,9,29381126,297155723,2558528,1534976,298690699,295254926
29381126_1592157,CM021108.1,9,29381126,297155723,2558528,1592157,298747880,295312107
29379560_1608539,CM021108.1,9,29379560,297156040,2908261,1608539,298764579,295328806
29378424_1627432,CM021108.1,9,29378424,297158411,2246581,1627432,298785843,295350070
29380965_1651923,CM021108.1,9,29380965,297155723,5040944,1651923,298807646,295371873
29380688_1680953,CM021108.1,9,29380688,297155723,3830176,1680953,298836676,295400903
29381518_1702061,CM021108.1,9,29381518,297155724,5064316,1702061,298857785,295422012
29377554_1749118,CM021108.1,9,29377554,297155715,3801411,1749118,298904833,295469060
29377554_1749179,CM021108.1,9,29377554,297155715,3801411,1749179,298904894,295469121
29382473_1776027,CM021108.1,9,29382473,297155724,2234960,1776027,298931751,295495978
29382473_1776038,CM021108.1,9,29382473,297155724,2234960,1776038,298931762,295495989
29382473_1776076,CM021108.1,9,29382473,297155724,2234960,1776076,298931800,295496027
29379831_1775883,CM021108.1,9,29379831,297156084,3319383,1775883,298931967,295496194
29379831_1788341,CM021108.1,9,29379831,297156084,3319383,1788341,298944425,295508652
29379831_1788347,CM021108.1,9,29379831,297156084,3319383,1788347,298944431,295508658
29379831_1788497,CM021108.1,9,29379831,297156084,3319383,1788497,298944581,295508808
29379831_1814055,CM021108.1,9,29379831,297156084,3319383,1814055,298970139,295534366
29379831_1814321,CM021108.1,9,29379831,297156084,3319383,1814321,298970405,295534632
29379831_1814418,CM021108.1,9,29379831,297156084,3319383,1814418,298970502,295534729
29379763_1838519,CM021108.1,9,29379763,297155859,3753541,1838519,298994378,295558605
29379763_1838562,CM021108.1,9,29379763,297155859,3753541,1838562,298994421,295558648
29379763_1838605,CM021108.1,9,29379763,297155859,3753541,1838605,298994464,295558691
29378424_1885343,CM021108.1,9,29378424,297158411,2246581,1885343,299043754,295607981
29378424_1885417,CM021108.1,9,29378424,297158411,2246581,1885417,299043828,295608055
29378424_1890178,CM021108.1,9,29378424,297158411,2246581,1890178,299048589,295612816
29382473_1905672,CM021108.1,9,29382473,297155724,2234960,1905672,299061396,295625623
29382473_1905682,CM021108.1,9,29382473,297155724,2234960,1905682,299061406,295625633
29382473_1907848,CM021108.1,9,29382473,297155724,2234960,1907848,299063572,295627799
29382473_1907865,CM021108.1,9,29382473,297155724,2234960,1907865,299063589,295627816
29382473_1908132,CM021108.1,9,29382473,297155724,2234960,1908132,299063856,295628083
29382473_1908314,CM021108.1,9,29382473,297155724,2234960,1908314,299064038,295628265
29378558_1935714,CM021108.1,9,29378558,297155724,3984627,1935714,299091438,295655665
29378558_2006008,CM021108.1,9,29378558,297155724,3984627,2006008,299161732,295725959
29378558_2006078,CM021108.1,9,29378558,297155724,3984627,2006078,299161802,295726029
29378558_2006104,CM021108.1,9,29378558,297155724,3984627,2006104,299161828,295726055
29380618_2104340,CM021108.1,9,29380618,297155699,2946080,2104340,299260039,295824266
29380324_2166664,CM021108.1,9,29380324,297156295,2468731,2166664,299322959,295887186
29382473_2177559,CM021108.1,9,29382473,297155724,2234960,2177559,299333283,295897510
29379831_2244508,CM021108.1,9,29379831,297156084,3319383,2244508,299400592,295964819
29379831_2244554,CM021108.1,9,29379831,297156084,3319383,2244554,299400638,295964865
29379831_2244590,CM021108.1,9,29379831,297156084,3319383,2244590,299400674,295964901
29378558_2390406,CM021108.1,9,29378558,297155724,3984627,2390406,299546130,296110357
29380688_2518041,CM021108.1,9,29380688,297155723,3830176,2518041,299673764,296237991
29379831_2563132,CM021108.1,9,29379831,297156084,3319383,2563132,299719216,296283443
29379948_2582366,CM021108.1,9,29379948,297155723,5015150,2582366,299738089,296302316
29379948_2607563,CM021108.1,9,29379948,297155723,5015150,2607563,299763286,296327513
29379560_2650643,CM021108.1,9,29379560,297156040,2908261,2650643,299806683,296370910
29379560_2650656,CM021108.1,9,29379560,297156040,2908261,2650656,299806696,296370923
29379560_2650819,CM021108.1,9,29379560,297156040,2908261,2650819,299806859,296371086
29379560_2650825,CM021108.1,9,29379560,297156040,2908261,2650825,299806865,296371092
29379560_2656124,CM021108.1,9,29379560,297156040,2908261,2656124,299812164,296376391
29379560_2657577,CM021108.1,9,29379560,297156040,2908261,2657577,299813617,296377844
29379560_2657657,CM021108.1,9,29379560,297156040,2908261,2657657,299813697,296377924
29378558_2702478,CM021108.1,9,29378558,297155724,3984627,2702478,299858202,296422429
29378558_2702550,CM021108.1,9,29378558,297155724,3984627,2702550,299858274,296422501
29378558_2702593,CM021108.1,9,29378558,297155724,3984627,2702593,299858317,296422544
29378558_2704033,CM021108.1,9,29378558,297155724,3984627,2704033,299859757,296423984
29378558_2704092,CM021108.1,9,29378558,297155724,3984627,2704092,299859816,296424043
29379763_3236203,CM021108.1,9,29379763,297155859,3753541,3236203,300392062,296956289
29379763_3236218,CM021108.1,9,29379763,297155859,3753541,3236218,300392077,296956304
29379831_3262367,CM021108.1,9,29379831,297156084,3319383,3262367,300418451,296982678
29377707_3337908,CM021108.1,9,29377707,297155723,4296607,3337908,300493631,297057858
29377707_3345171,CM021108.1,9,29377707,297155723,4296607,3345171,300500894,297065121
29377707_3345244,CM021108.1,9,29377707,297155723,4296607,3345244,300500967,297065194
29377707_3345255,CM021108.1,9,29377707,297155723,4296607,3345255,300500978,297065205
29379164_3373473,CM021108.1,9,29379164,297155723,4848746,3373473,300529196,297093423
29379164_3373552,CM021108.1,9,29379164,297155723,4848746,3373552,300529275,297093502
29377652_3498036,CM021108.1,9,29377652,297155724,3533555,3498036,300653760,297217987
29379948_3552943,CM021108.1,9,29379948,297155723,5015150,3552943,300708666,297272893
29379948_3553412,CM021108.1,9,29379948,297155723,5015150,3553412,300709135,297273362
29382401_3565069,CM021108.1,9,29382401,297155717,5714467,3565069,300720786,297285013
29379948_3640953,CM021108.1,9,29379948,297155723,5015150,3640953,300796676,297360903
29379948_3640977,CM021108.1,9,29379948,297155723,5015150,3640977,300796700,297360927
29379948_3641184,CM021108.1,9,29379948,297155723,5015150,3641184,300796907,297361134
29379948_3641246,CM021108.1,9,29379948,297155723,5015150,3641246,300796969,297361196
29378558_3663303,CM021108.1,9,29378558,297155724,3984627,3663303,300819027,297383254
29380965_3720078,CM021108.1,9,29380965,297155723,5040944,3720078,300875801,297440028
29380965_3720154,CM021108.1,9,29380965,297155723,5040944,3720154,300875877,297440104
29378558_3732161,CM021108.1,9,29378558,297155724,3984627,3732161,300887885,297452112
29377042_3984040,CM021108.1,9,29377042,297155723,7815155,3984040,301139763,297703990
29377042_3984059,CM021108.1,9,29377042,297155723,7815155,3984059,301139782,297704009
29377042_3984126,CM021108.1,9,29377042,297155723,7815155,3984126,301139849,297704076
29377042_3984176,CM021108.1,9,29377042,297155723,7815155,3984176,301139899,297704126
29380965_3999517,CM021108.1,9,29380965,297155723,5040944,3999517,301155240,297719467
29380965_3999548,CM021108.1,9,29380965,297155723,5040944,3999548,301155271,297719498
29380965_3999572,CM021108.1,9,29380965,297155723,5040944,3999572,301155295,297719522
29380965_4023582,CM021108.1,9,29380965,297155723,5040944,4023582,301179305,297743532
29377042_4163109,CM021108.1,9,29377042,297155723,7815155,4163109,301318832,297883059
29379948_4286386,CM021108.1,9,29379948,297155723,5015150,4286386,301442109,298006336
29380965_4391811,CM021108.1,9,29380965,297155723,5040944,4391811,301547534,298111761
29380965_4393639,CM021108.1,9,29380965,297155723,5040944,4393639,301549362,298113589
29380965_4393744,CM021108.1,9,29380965,297155723,5040944,4393744,301549467,298113694
29380965_4401477,CM021108.1,9,29380965,297155723,5040944,4401477,301557200,298121427
29379948_4403412,CM021108.1,9,29379948,297155723,5015150,4403412,301559135,298123362
29379948_4403535,CM021108.1,9,29379948,297155723,5015150,4403535,301559258,298123485
29379948_4403636,CM021108.1,9,29379948,297155723,5015150,4403636,301559359,298123586
29379948_4498480,CM021108.1,9,29379948,297155723,5015150,4498480,301654203,298218430
29379948_4498543,CM021108.1,9,29379948,297155723,5015150,4498543,301654266,298218493
29379948_4498589,CM021108.1,9,29379948,297155723,5015150,4498589,301654312,298218539
29377042_4586681,CM021108.1,9,29377042,297155723,7815155,4586681,301742404,298306631
29377042_4586793,CM021108.1,9,29377042,297155723,7815155,4586793,301742516,298306743
29377042_4588021,CM021108.1,9,29377042,297155723,7815155,4588021,301743744,298307971
29377042_4588023,CM021108.1,9,29377042,297155723,7815155,4588023,301743746,298307973
29377042_4588033,CM021108.1,9,29377042,297155723,7815155,4588033,301743756,298307983
29377042_4588051,CM021108.1,9,29377042,297155723,7815155,4588051,301743774,298308001
29377042_4591755,CM021108.1,9,29377042,297155723,7815155,4591755,301747478,298311705
29379948_4663182,CM021108.1,9,29379948,297155723,5015150,4663182,301818905,298383132
29379948_4696376,CM021108.1,9,29379948,297155723,5015150,4696376,301852099,298416326
29379948_4696610,CM021108.1,9,29379948,297155723,5015150,4696610,301852333,298416560
29379948_4696659,CM021108.1,9,29379948,297155723,5015150,4696659,301852382,298416609
29377042_5415820,CM021108.1,9,29377042,297155723,7815155,5415820,302571543,299135770
29382501_464140,CM021108.1,9,29382501,313280267,532949,464140,313744407,310308634
29382501_464141,CM021108.1,9,29382501,313280267,532949,464141,313744408,310308635
29382501_466084,CM021108.1,9,29382501,313280267,532949,466084,313746351,310310578
29382501_466187,CM021108.1,9,29382501,313280267,532949,466187,313746454,310310681
29382501_467243,CM021108.1,9,29382501,313280267,532949,467243,313747510,310311737
29343671_478,CM021108.1,9,29343671,341390274,14693,478,341390752,337954979
29380294_74572,CM021108.1,9,29380294,341390196,449148,74572,341464768,338028995
29380294_74668,CM021108.1,9,29380294,341390196,449148,74668,341464864,338029091
29380294_74678,CM021108.1,9,29380294,341390196,449148,74678,341464874,338029101
29380294_74724,CM021108.1,9,29380294,341390196,449148,74724,341464920,338029147
29380294_74755,CM021108.1,9,29380294,341390196,449148,74755,341464951,338029178
29380294_74757,CM021108.1,9,29380294,341390196,449148,74757,341464953,338029180
29378731_75068,CM021108.1,9,29378731,341390200,215061,75068,341465268,338029495
29378731_75070,CM021108.1,9,29378731,341390200,215061,75070,341465270,338029497
29378731_75097,CM021108.1,9,29378731,341390200,215061,75097,341465297,338029524
29378731_75134,CM021108.1,9,29378731,341390200,215061,75134,341465334,338029561
29378731_75148,CM021108.1,9,29378731,341390200,215061,75148,341465348,338029575
29377325_139948,CM021108.1,9,29377325,341390200,291271,139948,341530148,338094375
29380294_154921,CM021108.1,9,29380294,341390196,449148,154921,341545117,338109344
29337586_227326,CM021108.1,9,29337586,341390194,239560,227326,341617520,338181747
29337586_227351,CM021108.1,9,29337586,341390194,239560,227351,341617545,338181772
29381043_373892,CM021108.1,9,29381043,341390528,414862,373892,341764420,338328647
29381731_54715,CM021108.1,9,29381731,350560884,1069499,54715,350615599,347179826
29379841_56941,CM021108.1,9,29379841,350560884,304517,56941,350617825,347182052
29379841_65074,CM021108.1,9,29379841,350560884,304517,65074,350625958,347190185
29379841_78655,CM021108.1,9,29379841,350560884,304517,78655,350639539,347203766
29379841_78660,CM021108.1,9,29379841,350560884,304517,78660,350639544,347203771
29379841_78715,CM021108.1,9,29379841,350560884,304517,78715,350639599,347203826
29379841_79462,CM021108.1,9,29379841,350560884,304517,79462,350640346,347204573
29377221_154963,CM021108.1,9,29377221,350560884,959228,154963,350715847,347280074
29381304_167216,CM021108.1,9,29381304,350561937,783347,167216,350729153,347293380
29381304_167295,CM021108.1,9,29381304,350561937,783347,167295,350729232,347293459
29380920_169208,CM021108.1,9,29380920,350563247,909408,169208,350732455,347296682
29381731_184890,CM021108.1,9,29381731,350560884,1069499,184890,350745774,347310001
29381731_184902,CM021108.1,9,29381731,350560884,1069499,184902,350745786,347310013
29381731_184919,CM021108.1,9,29381731,350560884,1069499,184919,350745803,347310030
29381731_185297,CM021108.1,9,29381731,350560884,1069499,185297,350746181,347310408
29381731_185307,CM021108.1,9,29381731,350560884,1069499,185307,350746191,347310418
29379910_205281,CM021108.1,9,29379910,350560876,907216,205281,350766157,347330384
29379910_205321,CM021108.1,9,29379910,350560876,907216,205321,350766197,347330424
29381731_208749,CM021108.1,9,29381731,350560884,1069499,208749,350769633,347333860
29379910_211656,CM021108.1,9,29379910,350560876,907216,211656,350772532,347336759
29381304_221411,CM021108.1,9,29381304,350561937,783347,221411,350783348,347347575
29381304_221518,CM021108.1,9,29381304,350561937,783347,221518,350783455,347347682
29381731_228706,CM021108.1,9,29381731,350560884,1069499,228706,350789590,347353817
29381731_228766,CM021108.1,9,29381731,350560884,1069499,228766,350789650,347353877
29380920_228063,CM021108.1,9,29380920,350563247,909408,228063,350791310,347355537
29380920_228080,CM021108.1,9,29380920,350563247,909408,228080,350791327,347355554
29379243_246470,CM021108.1,9,29379243,350560880,500845,246470,350807350,347371577
29381304_263439,CM021108.1,9,29381304,350561937,783347,263439,350825376,347389603
29381304_263495,CM021108.1,9,29381304,350561937,783347,263495,350825432,347389659
29382002_276969,CM021108.1,9,29382002,350564459,278564,276969,350841428,347405655
29382002_277010,CM021108.1,9,29382002,350564459,278564,277010,350841469,347405696
29381304_284271,CM021108.1,9,29381304,350561937,783347,284271,350846208,347410435
29381304_284367,CM021108.1,9,29381304,350561937,783347,284367,350846304,347410531
29381304_284402,CM021108.1,9,29381304,350561937,783347,284402,350846339,347410566
29381304_284441,CM021108.1,9,29381304,350561937,783347,284441,350846378,347410605
29381304_284450,CM021108.1,9,29381304,350561937,783347,284450,350846387,347410614
29381304_284749,CM021108.1,9,29381304,350561937,783347,284749,350846686,347410913
29381304_284830,CM021108.1,9,29381304,350561937,783347,284830,350846767,347410994
29379243_301126,CM021108.1,9,29379243,350560880,500845,301126,350862006,347426233
29379910_443635,CM021108.1,9,29379910,350560876,907216,443635,351004511,347568738
29379910_443695,CM021108.1,9,29379910,350560876,907216,443695,351004571,347568798
29379910_568188,CM021108.1,9,29379910,350560876,907216,568188,351129064,347693291
29379910_568272,CM021108.1,9,29379910,350560876,907216,568272,351129148,347693375
29379910_568273,CM021108.1,9,29379910,350560876,907216,568273,351129149,347693376
29379910_642174,CM021108.1,9,29379910,350560876,907216,642174,351203050,347767277
29379910_642230,CM021108.1,9,29379910,350560876,907216,642230,351203106,347767333
29381731_647785,CM021108.1,9,29381731,350560884,1069499,647785,351208669,347772896
29381731_647978,CM021108.1,9,29381731,350560884,1069499,647978,351208862,347773089
29381731_648023,CM021108.1,9,29381731,350560884,1069499,648023,351208907,347773134
29381731_648058,CM021108.1,9,29381731,350560884,1069499,648058,351208942,347773169
29381731_648078,CM021108.1,9,29381731,350560884,1069499,648078,351208962,347773189
29381731_648114,CM021108.1,9,29381731,350560884,1069499,648114,351208998,347773225
29381731_648115,CM021108.1,9,29381731,350560884,1069499,648115,351208999,347773226
29381304_652355,CM021108.1,9,29381304,350561937,783347,652355,351214292,347778519
29381304_652399,CM021108.1,9,29381304,350561937,783347,652399,351214336,347778563
29381304_682091,CM021108.1,9,29381304,350561937,783347,682091,351244028,347808255
29379910_706980,CM021108.1,9,29379910,350560876,907216,706980,351267856,347832083
29379910_706998,CM021108.1,9,29379910,350560876,907216,706998,351267874,347832101
29379910_707080,CM021108.1,9,29379910,350560876,907216,707080,351267956,347832183
29379910_707223,CM021108.1,9,29379910,350560876,907216,707223,351268099,347832326
29381304_711056,CM021108.1,9,29381304,350561937,783347,711056,351272993,347837220
29381304_711060,CM021108.1,9,29381304,350561937,783347,711060,351272997,347837224
29381731_730717,CM021108.1,9,29381731,350560884,1069499,730717,351291601,347855828
29381731_730778,CM021108.1,9,29381731,350560884,1069499,730778,351291662,347855889
29381731_731813,CM021108.1,9,29381731,350560884,1069499,731813,351292697,347856924
29381731_749846,CM021108.1,9,29381731,350560884,1069499,749846,351310730,347874957
29381731_749858,CM021108.1,9,29381731,350560884,1069499,749858,351310742,347874969
29381731_749894,CM021108.1,9,29381731,350560884,1069499,749894,351310778,347875005
29381731_749918,CM021108.1,9,29381731,350560884,1069499,749918,351310802,347875029
29379784_789567,CM021108.1,9,29379784,350560882,1191960,789567,351350449,347914676
29379784_789770,CM021108.1,9,29379784,350560882,1191960,789770,351350652,347914879
29379784_789771,CM021108.1,9,29379784,350560882,1191960,789771,351350653,347914880
29379784_791041,CM021108.1,9,29379784,350560882,1191960,791041,351351923,347916150
29379784_791615,CM021108.1,9,29379784,350560882,1191960,791615,351352497,347916724
29379784_791674,CM021108.1,9,29379784,350560882,1191960,791674,351352556,347916783
29379784_791682,CM021108.1,9,29379784,350560882,1191960,791682,351352564,347916791
29379784_791744,CM021108.1,9,29379784,350560882,1191960,791744,351352626,347916853
29379784_791801,CM021108.1,9,29379784,350560882,1191960,791801,351352683,347916910
29381731_833983,CM021108.1,9,29381731,350560884,1069499,833983,351394867,347959094
29377749_1018705,CM021108.1,9,29377749,350560882,8331922,1018705,351579587,348143814
29377749_1018878,CM021108.1,9,29377749,350560882,8331922,1018878,351579760,348143987
29377749_1230045,CM021108.1,9,29377749,350560882,8331922,1230045,351790927,348355154
29382315_149360,CM021108.1,9,29382315,354173385,410678,149360,354322745,350886972
29377749_3829018,CM021108.1,9,29377749,350560882,8331922,3829018,354389900,350954127
29382315_373308,CM021108.1,9,29382315,354173385,410678,373308,354546693,351110920
29382315_373345,CM021108.1,9,29382315,354173385,410678,373345,354546730,351110957
29382315_373382,CM021108.1,9,29382315,354173385,410678,373382,354546767,351110994
29382315_391171,CM021108.1,9,29382315,354173385,410678,391171,354564556,351128783
29382315_401149,CM021108.1,9,29382315,354173385,410678,401149,354574534,351138761
29382315_401223,CM021108.1,9,29382315,354173385,410678,401223,354574608,351138835
29382315_401248,CM021108.1,9,29382315,354173385,410678,401248,354574633,351138860
29380961_426201,CM021108.1,9,29380961,354173384,815368,426201,354599585,351163812
29380961_426207,CM021108.1,9,29380961,354173384,815368,426207,354599591,351163818
29380961_426222,CM021108.1,9,29380961,354173384,815368,426222,354599606,351163833
29380961_426226,CM021108.1,9,29380961,354173384,815368,426226,354599610,351163837
29380961_426234,CM021108.1,9,29380961,354173384,815368,426234,354599618,351163845
29380961_426240,CM021108.1,9,29380961,354173384,815368,426240,354599624,351163851
29380961_426254,CM021108.1,9,29380961,354173384,815368,426254,354599638,351163865
29380961_426262,CM021108.1,9,29380961,354173384,815368,426262,354599646,351163873
29377180_433057,CM021108.1,9,29377180,354173385,490401,433057,354606442,351170669
29377180_433060,CM021108.1,9,29377180,354173385,490401,433060,354606445,351170672
29377180_433096,CM021108.1,9,29377180,354173385,490401,433096,354606481,351170708
29380961_546006,CM021108.1,9,29380961,354173384,815368,546006,354719390,351283617
29380961_566949,CM021108.1,9,29380961,354173384,815368,566949,354740333,351304560
29380961_566970,CM021108.1,9,29380961,354173384,815368,566970,354740354,351304581
29380961_566991,CM021108.1,9,29380961,354173384,815368,566991,354740375,351304602
29377376_1082795,CM021108.1,9,29377376,354173545,4174497,1082795,355256340,351820567
29377376_1082820,CM021108.1,9,29377376,354173545,4174497,1082820,355256365,351820592
29377376_1082891,CM021108.1,9,29377376,354173545,4174497,1082891,355256436,351820663
29377376_1083144,CM021108.1,9,29377376,354173545,4174497,1083144,355256689,351820916
29377376_1083214,CM021108.1,9,29377376,354173545,4174497,1083214,355256759,351820986
29377376_1102710,CM021108.1,9,29377376,354173545,4174497,1102710,355276255,351840482
29377376_1102780,CM021108.1,9,29377376,354173545,4174497,1102780,355276325,351840552
29377376_1102857,CM021108.1,9,29377376,354173545,4174497,1102857,355276402,351840629
29377376_1119410,CM021108.1,9,29377376,354173545,4174497,1119410,355292955,351857182
29377376_1119422,CM021108.1,9,29377376,354173545,4174497,1119422,355292967,351857194
29377376_1119676,CM021108.1,9,29377376,354173545,4174497,1119676,355293221,351857448
29377376_1119737,CM021108.1,9,29377376,354173545,4174497,1119737,355293282,351857509
29377376_1119798,CM021108.1,9,29377376,354173545,4174497,1119798,355293343,351857570
29377376_1119813,CM021108.1,9,29377376,354173545,4174497,1119813,355293358,351857585
29377376_1124527,CM021108.1,9,29377376,354173545,4174497,1124527,355298072,351862299
29381246_1504381,CM021108.1,9,29381246,354173388,1837395,1504381,355677769,352241996
29381246_1504395,CM021108.1,9,29381246,354173388,1837395,1504395,355677783,352242010
29381246_1504442,CM021108.1,9,29381246,354173388,1837395,1504442,355677830,352242057
29377749_5448621,CM021108.1,9,29377749,350560882,8331922,5448621,356009503,352573730
29377749_5448648,CM021108.1,9,29377749,350560882,8331922,5448648,356009530,352573757
29377749_5448649,CM021108.1,9,29377749,350560882,8331922,5448649,356009531,352573758
29377749_5448662,CM021108.1,9,29377749,350560882,8331922,5448662,356009544,352573771
29377376_2477175,CM021108.1,9,29377376,354173545,4174497,2477175,356650720,353214947
29377749_6114245,CM021108.1,9,29377749,350560882,8331922,6114245,356675127,353239354
29377749_6114341,CM021108.1,9,29377749,350560882,8331922,6114341,356675223,353239450
29377749_6114367,CM021108.1,9,29377749,350560882,8331922,6114367,356675249,353239476
29377749_6114496,CM021108.1,9,29377749,350560882,8331922,6114496,356675378,353239605
29377749_6114599,CM021108.1,9,29377749,350560882,8331922,6114599,356675481,353239708
29377376_2522342,CM021108.1,9,29377376,354173545,4174497,2522342,356695887,353260114
29377376_2733886,CM021108.1,9,29377376,354173545,4174497,2733886,356907431,353471658
29377376_2845625,CM021108.1,9,29377376,354173545,4174497,2845625,357019170,353583397
29377376_2845660,CM021108.1,9,29377376,354173545,4174497,2845660,357019205,353583432
29377376_2845702,CM021108.1,9,29377376,354173545,4174497,2845702,357019247,353583474
29377376_2846929,CM021108.1,9,29377376,354173545,4174497,2846929,357020474,353584701
29377376_3084903,CM021108.1,9,29377376,354173545,4174497,3084903,357258448,353822675
29377376_3104115,CM021108.1,9,29377376,354173545,4174497,3104115,357277660,353841887
29377376_3104176,CM021108.1,9,29377376,354173545,4174497,3104176,357277721,353841948
29377376_3104179,CM021108.1,9,29377376,354173545,4174497,3104179,357277724,353841951
29377376_3104181,CM021108.1,9,29377376,354173545,4174497,3104181,357277726,353841953
29377376_3104191,CM021108.1,9,29377376,354173545,4174497,3104191,357277736,353841963
29377376_3104231,CM021108.1,9,29377376,354173545,4174497,3104231,357277776,353842003
29377376_3104237,CM021108.1,9,29377376,354173545,4174497,3104237,357277782,353842009
29377376_3104257,CM021108.1,9,29377376,354173545,4174497,3104257,357277802,353842029
29377376_3214624,CM021108.1,9,29377376,354173545,4174497,3214624,357388169,353952396
29377376_3214675,CM021108.1,9,29377376,354173545,4174497,3214675,357388220,353952447
29377376_3214724,CM021108.1,9,29377376,354173545,4174497,3214724,357388269,353952496
29377376_3214733,CM021108.1,9,29377376,354173545,4174497,3214733,357388278,353952505
29377376_3214775,CM021108.1,9,29377376,354173545,4174497,3214775,357388320,353952547
29377376_3214787,CM021108.1,9,29377376,354173545,4174497,3214787,357388332,353952559
29377376_3214791,CM021108.1,9,29377376,354173545,4174497,3214791,357388336,353952563
29377376_3214802,CM021108.1,9,29377376,354173545,4174497,3214802,357388347,353952574
29377376_3214822,CM021108.1,9,29377376,354173545,4174497,3214822,357388367,353952594
29377376_3215594,CM021108.1,9,29377376,354173545,4174497,3215594,357389139,353953366
29377376_3215596,CM021108.1,9,29377376,354173545,4174497,3215596,357389141,353953368
29377376_3215605,CM021108.1,9,29377376,354173545,4174497,3215605,357389150,353953377
29377376_3215616,CM021108.1,9,29377376,354173545,4174497,3215616,357389161,353953388
29377376_3215620,CM021108.1,9,29377376,354173545,4174497,3215620,357389165,353953392
29377376_3215640,CM021108.1,9,29377376,354173545,4174497,3215640,357389185,353953412
29377376_3215642,CM021108.1,9,29377376,354173545,4174497,3215642,357389187,353953414
29377376_3215643,CM021108.1,9,29377376,354173545,4174497,3215643,357389188,353953415
29377376_3215647,CM021108.1,9,29377376,354173545,4174497,3215647,357389192,353953419
29377376_3215687,CM021108.1,9,29377376,354173545,4174497,3215687,357389232,353953459
29377376_3215810,CM021108.1,9,29377376,354173545,4174497,3215810,357389355,353953582
29377749_8080523,CM021108.1,9,29377749,350560882,8331922,8080523,358641405,355205632
29377749_8080703,CM021108.1,9,29377749,350560882,8331922,8080703,358641585,355205812
29377749_8082936,CM021108.1,9,29377749,350560882,8331922,8082936,358643818,355208045
29348763_54910,CM021108.1,9,29348763,372199108,151936,54910,372254018,368818245
29348763_54923,CM021108.1,9,29348763,372199108,151936,54923,372254031,368818258
29348763_55094,CM021108.1,9,29348763,372199108,151936,55094,372254202,368818429
29348763_55106,CM021108.1,9,29348763,372199108,151936,55106,372254214,368818441
29348763_55139,CM021108.1,9,29348763,372199108,151936,55139,372254247,368818474
29348763_55142,CM021108.1,9,29348763,372199108,151936,55142,372254250,368818477
29382337_70657,CM021108.1,9,29382337,382905380,771596,70657,382976037,379540264
29382337_70717,CM021108.1,9,29382337,382905380,771596,70717,382976097,379540324
29382337_70718,CM021108.1,9,29382337,382905380,771596,70718,382976098,379540325
29382337_70733,CM021108.1,9,29382337,382905380,771596,70733,382976113,379540340
29382337_70737,CM021108.1,9,29382337,382905380,771596,70737,382976117,379540344
29382337_70745,CM021108.1,9,29382337,382905380,771596,70745,382976125,379540352
29382337_70762,CM021108.1,9,29382337,382905380,771596,70762,382976142,379540369
29382337_70768,CM021108.1,9,29382337,382905380,771596,70768,382976148,379540375
29382337_70792,CM021108.1,9,29382337,382905380,771596,70792,382976172,379540399
29382337_70799,CM021108.1,9,29382337,382905380,771596,70799,382976179,379540406
29382337_70808,CM021108.1,9,29382337,382905380,771596,70808,382976188,379540415
29382337_70850,CM021108.1,9,29382337,382905380,771596,70850,382976230,379540457
29382337_70854,CM021108.1,9,29382337,382905380,771596,70854,382976234,379540461
29382337_70856,CM021108.1,9,29382337,382905380,771596,70856,382976236,379540463
29382337_70861,CM021108.1,9,29382337,382905380,771596,70861,382976241,379540468
29382337_70870,CM021108.1,9,29382337,382905380,771596,70870,382976250,379540477
29382337_70879,CM021108.1,9,29382337,382905380,771596,70879,382976259,379540486
29378612_105882,CM021108.1,9,29378612,410082804,369847,105882,410188686,406752913
29378612_105919,CM021108.1,9,29378612,410082804,369847,105919,410188723,406752950
29378612_105933,CM021108.1,9,29378612,410082804,369847,105933,410188737,406752964
29382303_1009979,CM021108.1,9,29382303,410082799,1015894,1009979,411092778,407657005
29379355_17892,CM021108.1,9,29379355,422634982,602554,17892,422652874,419217101
29379355_449795,CM021108.1,9,29379355,422634982,602554,449795,423084777,419649004
29379355_449856,CM021108.1,9,29379355,422634982,602554,449856,423084838,419649065
29379355_450672,CM021108.1,9,29379355,422634982,602554,450672,423085654,419649881
29381528_129003,CM021108.1,9,29381528,433578355,732490,129003,433707358,430271585
29377418_211310,CM021108.1,9,29377418,433578848,4318584,211310,433790158,430354385
29381528_340946,CM021108.1,9,29381528,433578355,732490,340946,433919301,430483528
29380359_404070,CM021108.1,9,29380359,433578319,1552230,404070,433982389,430546616
29381528_486709,CM021108.1,9,29381528,433578355,732490,486709,434065064,430629291
29381528_486732,CM021108.1,9,29381528,433578355,732490,486732,434065087,430629314
29381528_579993,CM021108.1,9,29381528,433578355,732490,579993,434158348,430722575
29381706_596745,CM021108.1,9,29381706,433578811,2603452,596745,434175556,430739783
29381706_596754,CM021108.1,9,29381706,433578811,2603452,596754,434175565,430739792
29381528_612976,CM021108.1,9,29381528,433578355,732490,612976,434191331,430755558
29381528_613142,CM021108.1,9,29381528,433578355,732490,613142,434191497,430755724
29381528_613406,CM021108.1,9,29381528,433578355,732490,613406,434191761,430755988
29381528_613440,CM021108.1,9,29381528,433578355,732490,613440,434191795,430756022
29381362_786346,CM021108.1,9,29381362,433578314,1716816,786346,434364660,430928887
29381362_786365,CM021108.1,9,29381362,433578314,1716816,786365,434364679,430928906
29381362_786372,CM021108.1,9,29381362,433578314,1716816,786372,434364686,430928913
29381362_786397,CM021108.1,9,29381362,433578314,1716816,786397,434364711,430928938
29381362_786408,CM021108.1,9,29381362,433578314,1716816,786408,434364722,430928949
29381362_786410,CM021108.1,9,29381362,433578314,1716816,786410,434364724,430928951
29381362_786422,CM021108.1,9,29381362,433578314,1716816,786422,434364736,430928963
29381362_786428,CM021108.1,9,29381362,433578314,1716816,786428,434364742,430928969
29381362_786429,CM021108.1,9,29381362,433578314,1716816,786429,434364743,430928970
29381362_786435,CM021108.1,9,29381362,433578314,1716816,786435,434364749,430928976
29381362_786443,CM021108.1,9,29381362,433578314,1716816,786443,434364757,430928984
29381362_786447,CM021108.1,9,29381362,433578314,1716816,786447,434364761,430928988
29380359_873788,CM021108.1,9,29380359,433578319,1552230,873788,434452107,431016334
29380359_873790,CM021108.1,9,29380359,433578319,1552230,873790,434452109,431016336
29380359_873791,CM021108.1,9,29380359,433578319,1552230,873791,434452110,431016337
29380359_873887,CM021108.1,9,29380359,433578319,1552230,873887,434452206,431016433
29380359_873890,CM021108.1,9,29380359,433578319,1552230,873890,434452209,431016436
29380359_873891,CM021108.1,9,29380359,433578319,1552230,873891,434452210,431016437
29381121_886294,CM021108.1,9,29381121,433580159,1049496,886294,434466453,431030680
29380359_942376,CM021108.1,9,29380359,433578319,1552230,942376,434520695,431084922
29380359_942377,CM021108.1,9,29380359,433578319,1552230,942377,434520696,431084923
29380359_942422,CM021108.1,9,29380359,433578319,1552230,942422,434520741,431084968
29380359_942442,CM021108.1,9,29380359,433578319,1552230,942442,434520761,431084988
29381706_967424,CM021108.1,9,29381706,433578811,2603452,967424,434546235,431110462
29381706_967495,CM021108.1,9,29381706,433578811,2603452,967495,434546306,431110533
29381384_1042560,CM021108.1,9,29381384,433578315,1878101,1042560,434620875,431185102
29381384_1042628,CM021108.1,9,29381384,433578315,1878101,1042628,434620943,431185170
29381706_1067114,CM021108.1,9,29381706,433578811,2603452,1067114,434645925,431210152
29381706_1067208,CM021108.1,9,29381706,433578811,2603452,1067208,434646019,431210246
29381706_1090773,CM021108.1,9,29381706,433578811,2603452,1090773,434669584,431233811
29382308_1210234,CM021108.1,9,29382308,433579342,3938017,1210234,434789576,431353803
29382308_1210748,CM021108.1,9,29382308,433579342,3938017,1210748,434790090,431354317
29382308_1210809,CM021108.1,9,29382308,433579342,3938017,1210809,434790151,431354378
29382308_1215784,CM021108.1,9,29382308,433579342,3938017,1215784,434795126,431359353
29382308_1215823,CM021108.1,9,29382308,433579342,3938017,1215823,434795165,431359392
29382308_1215886,CM021108.1,9,29382308,433579342,3938017,1215886,434795228,431359455
29382308_1215898,CM021108.1,9,29382308,433579342,3938017,1215898,434795240,431359467
29381706_1323137,CM021108.1,9,29381706,433578811,2603452,1323137,434901948,431466175
29381706_1355828,CM021108.1,9,29381706,433578811,2603452,1355828,434934639,431498866
29381362_1366548,CM021108.1,9,29381362,433578314,1716816,1366548,434944862,431509089
29381362_1366639,CM021108.1,9,29381362,433578314,1716816,1366639,434944953,431509180
29381362_1366700,CM021108.1,9,29381362,433578314,1716816,1366700,434945014,431509241
29381362_1366701,CM021108.1,9,29381362,433578314,1716816,1366701,434945015,431509242
29381362_1366708,CM021108.1,9,29381362,433578314,1716816,1366708,434945022,431509249
29381362_1366748,CM021108.1,9,29381362,433578314,1716816,1366748,434945062,431509289
29381148_1394455,CM021108.1,9,29381148,433578319,2279201,1394455,434972774,431537001
29382464_1462022,CM021108.1,9,29382464,433579316,2804077,1462022,435041338,431605565
29381148_1477051,CM021108.1,9,29381148,433578319,2279201,1477051,435055370,431619597
29381148_1477460,CM021108.1,9,29381148,433578319,2279201,1477460,435055779,431620006
29381148_1477549,CM021108.1,9,29381148,433578319,2279201,1477549,435055868,431620095
29382308_1603067,CM021108.1,9,29382308,433579342,3938017,1603067,435182409,431746636
29381824_1667403,CM021108.1,9,29381824,433578649,1667848,1667403,435246052,431810279
29381824_1667459,CM021108.1,9,29381824,433578649,1667848,1667459,435246108,431810335
29381824_1667460,CM021108.1,9,29381824,433578649,1667848,1667460,435246109,431810336
29381824_1667467,CM021108.1,9,29381824,433578649,1667848,1667467,435246116,431810343
29381824_1667495,CM021108.1,9,29381824,433578649,1667848,1667495,435246144,431810371
29381824_1667499,CM021108.1,9,29381824,433578649,1667848,1667499,435246148,431810375
29381824_1667516,CM021108.1,9,29381824,433578649,1667848,1667516,435246165,431810392
29381824_1667522,CM021108.1,9,29381824,433578649,1667848,1667522,435246171,431810398
29381824_1667523,CM021108.1,9,29381824,433578649,1667848,1667523,435246172,431810399
29381824_1667571,CM021108.1,9,29381824,433578649,1667848,1667571,435246220,431810447
29381824_1667576,CM021108.1,9,29381824,433578649,1667848,1667576,435246225,431810452
29381824_1667593,CM021108.1,9,29381824,433578649,1667848,1667593,435246242,431810469
29382308_1737099,CM021108.1,9,29382308,433579342,3938017,1737099,435316441,431880668
29382308_1737137,CM021108.1,9,29382308,433579342,3938017,1737137,435316479,431880706
29381148_1813746,CM021108.1,9,29381148,433578319,2279201,1813746,435392065,431956292
29377418_2103244,CM021108.1,9,29377418,433578848,4318584,2103244,435682092,432246319
29377418_2103264,CM021108.1,9,29377418,433578848,4318584,2103264,435682112,432246339
29377418_2103555,CM021108.1,9,29377418,433578848,4318584,2103555,435682403,432246630
29377418_2103587,CM021108.1,9,29377418,433578848,4318584,2103587,435682435,432246662
29377418_2103604,CM021108.1,9,29377418,433578848,4318584,2103604,435682452,432246679
29382308_2146757,CM021108.1,9,29382308,433579342,3938017,2146757,435726099,432290326
29382308_2671579,CM021108.1,9,29382308,433579342,3938017,2671579,436250921,432815148
29382308_2679689,CM021108.1,9,29382308,433579342,3938017,2679689,436259031,432823258
29382308_2679698,CM021108.1,9,29382308,433579342,3938017,2679698,436259040,432823267
29382308_2760501,CM021108.1,9,29382308,433579342,3938017,2760501,436339843,432904070
29382308_2760586,CM021108.1,9,29382308,433579342,3938017,2760586,436339928,432904155
29377418_2844927,CM021108.1,9,29377418,433578848,4318584,2844927,436423775,432988002
29382308_2886261,CM021108.1,9,29382308,433579342,3938017,2886261,436465603,433029830
29382308_3039907,CM021108.1,9,29382308,433579342,3938017,3039907,436619249,433183476
29382308_3040926,CM021108.1,9,29382308,433579342,3938017,3040926,436620268,433184495
29377418_3452258,CM021108.1,9,29377418,433578848,4318584,3452258,437031106,433595333
29377418_3452396,CM021108.1,9,29377418,433578848,4318584,3452396,437031244,433595471
29377418_3452454,CM021108.1,9,29377418,433578848,4318584,3452454,437031302,433595529
29377418_3474374,CM021108.1,9,29377418,433578848,4318584,3474374,437053222,433617449
29377418_3474389,CM021108.1,9,29377418,433578848,4318584,3474389,437053237,433617464
29379587_43701,CM021108.1,9,29379587,452538413,4468406,43701,452582114,449146341
29378990_52482,CM021108.1,9,29378990,452538411,1157424,52482,452590893,449155120
29379401_53813,CM021108.1,9,29379401,452543246,1476069,53813,452597059,449161286
29379401_53911,CM021108.1,9,29379401,452543246,1476069,53911,452597157,449161384
29379401_53949,CM021108.1,9,29379401,452543246,1476069,53949,452597195,449161422
29379401_53965,CM021108.1,9,29379401,452543246,1476069,53965,452597211,449161438
29379401_54126,CM021108.1,9,29379401,452543246,1476069,54126,452597372,449161599
29378915_65180,CM021108.1,9,29378915,452538408,1143943,65180,452603588,449167815
29378915_65183,CM021108.1,9,29378915,452538408,1143943,65183,452603591,449167818
29378915_65202,CM021108.1,9,29378915,452538408,1143943,65202,452603610,449167837
29377742_82646,CM021108.1,9,29377742,452538399,3104451,82646,452621045,449185272
29377742_82725,CM021108.1,9,29377742,452538399,3104451,82725,452621124,449185351
29377742_106487,CM021108.1,9,29377742,452538399,3104451,106487,452644886,449209113
29379401_105084,CM021108.1,9,29379401,452543246,1476069,105084,452648330,449212557
29379401_134824,CM021108.1,9,29379401,452543246,1476069,134824,452678070,449242297
29379401_134901,CM021108.1,9,29379401,452543246,1476069,134901,452678147,449242374
29379401_134902,CM021108.1,9,29379401,452543246,1476069,134902,452678148,449242375
29378990_213956,CM021108.1,9,29378990,452538411,1157424,213956,452752367,449316594
29378915_258508,CM021108.1,9,29378915,452538408,1143943,258508,452796916,449361143
29377742_307959,CM021108.1,9,29377742,452538399,3104451,307959,452846358,449410585
29377742_308004,CM021108.1,9,29377742,452538399,3104451,308004,452846403,449410630
29377742_308069,CM021108.1,9,29377742,452538399,3104451,308069,452846468,449410695
29377742_308097,CM021108.1,9,29377742,452538399,3104451,308097,452846496,449410723
29377742_310112,CM021108.1,9,29377742,452538399,3104451,310112,452848511,449412738
29382178_330016,CM021108.1,9,29382178,452538409,4863877,330016,452868425,449432652
29381464_356017,CM021108.1,9,29381464,452554033,7899477,356017,452910050,449474277
29381464_356072,CM021108.1,9,29381464,452554033,7899477,356072,452910105,449474332
29381312_398196,CM021108.1,9,29381312,452538409,818448,398196,452936605,449500832
29378499_428812,CM021108.1,9,29378499,452542393,4601384,428812,452971205,449535432
29378499_437393,CM021108.1,9,29378499,452542393,4601384,437393,452979786,449544013
29379401_475714,CM021108.1,9,29379401,452543246,1476069,475714,453018960,449583187
29377742_550129,CM021108.1,9,29377742,452538399,3104451,550129,453088528,449652755
29377742_550204,CM021108.1,9,29377742,452538399,3104451,550204,453088603,449652830
29377742_550996,CM021108.1,9,29377742,452538399,3104451,550996,453089395,449653622
29381464_628809,CM021108.1,9,29381464,452554033,7899477,628809,453182842,449747069
29382178_661420,CM021108.1,9,29382178,452538409,4863877,661420,453199829,449764056
29382178_661442,CM021108.1,9,29382178,452538409,4863877,661442,453199851,449764078
29378499_659379,CM021108.1,9,29378499,452542393,4601384,659379,453201772,449765999
29378499_659406,CM021108.1,9,29378499,452542393,4601384,659406,453201799,449766026
29379587_744618,CM021108.1,9,29379587,452538413,4468406,744618,453283031,449847258
29379587_750683,CM021108.1,9,29379587,452538413,4468406,750683,453289096,449853323
29382373_759206,CM021108.1,9,29382373,452554287,3094751,759206,453313493,449877720
29382373_759208,CM021108.1,9,29382373,452554287,3094751,759208,453313495,449877722
29382373_759251,CM021108.1,9,29382373,452554287,3094751,759251,453313538,449877765
29382373_759274,CM021108.1,9,29382373,452554287,3094751,759274,453313561,449877788
29382373_759552,CM021108.1,9,29382373,452554287,3094751,759552,453313839,449878066
29378915_796776,CM021108.1,9,29378915,452538408,1143943,796776,453335184,449899411
29378915_796805,CM021108.1,9,29378915,452538408,1143943,796805,453335213,449899440
29377483_819932,CM021108.1,9,29377483,452556043,1089327,819932,453375975,449940202
29377483_820017,CM021108.1,9,29377483,452556043,1089327,820017,453376060,449940287
29377803_839649,CM021108.1,9,29377803,452550277,4709335,839649,453389926,449954153
29377803_840899,CM021108.1,9,29377803,452550277,4709335,840899,453391176,449955403
29377803_840988,CM021108.1,9,29377803,452550277,4709335,840988,453391265,449955492
29377803_849312,CM021108.1,9,29377803,452550277,4709335,849312,453399589,449963816
29377803_849359,CM021108.1,9,29377803,452550277,4709335,849359,453399636,449963863
29377803_874987,CM021108.1,9,29377803,452550277,4709335,874987,453425264,449989491
29377803_875007,CM021108.1,9,29377803,452550277,4709335,875007,453425284,449989511
29377803_875065,CM021108.1,9,29377803,452550277,4709335,875065,453425342,449989569
29377803_875136,CM021108.1,9,29377803,452550277,4709335,875136,453425413,449989640
29378381_937596,CM021108.1,9,29378381,452538411,1428363,937596,453476007,450040234
29378381_937700,CM021108.1,9,29378381,452538411,1428363,937700,453476111,450040338
29377483_962684,CM021108.1,9,29377483,452556043,1089327,962684,453518727,450082954
29377483_962952,CM021108.1,9,29377483,452556043,1089327,962952,453518995,450083222
29377483_962970,CM021108.1,9,29377483,452556043,1089327,962970,453519013,450083240
29380592_1024388,CM021108.1,9,29380592,452538409,1818555,1024388,453562797,450127024
29380592_1047480,CM021108.1,9,29380592,452538409,1818555,1047480,453585889,450150116
29380592_1047499,CM021108.1,9,29380592,452538409,1818555,1047499,453585908,450150135
29380592_1047689,CM021108.1,9,29380592,452538409,1818555,1047689,453586098,450150325
29378381_1317128,CM021108.1,9,29378381,452538411,1428363,1317128,453855539,450419766
29378381_1317261,CM021108.1,9,29378381,452538411,1428363,1317261,453855672,450419899
29378381_1317365,CM021108.1,9,29378381,452538411,1428363,1317365,453855776,450420003
29377803_1351337,CM021108.1,9,29377803,452550277,4709335,1351337,453901614,450465841
29377803_1351368,CM021108.1,9,29377803,452550277,4709335,1351368,453901645,450465872
29377742_1376199,CM021108.1,9,29377742,452538399,3104451,1376199,453914598,450478825
29377742_1376227,CM021108.1,9,29377742,452538399,3104451,1376227,453914626,450478853
29377742_1376344,CM021108.1,9,29377742,452538399,3104451,1376344,453914743,450478970
29378499_1376202,CM021108.1,9,29378499,452542393,4601384,1376202,453918595,450482822
29378499_1376279,CM021108.1,9,29378499,452542393,4601384,1376279,453918672,450482899
29378289_1658188,CM021108.1,9,29378289,452538410,1887686,1658188,454196598,450760825
29378289_1662463,CM021108.1,9,29378289,452538410,1887686,1662463,454200873,450765100
29378499_1673502,CM021108.1,9,29378499,452542393,4601384,1673502,454215895,450780122
29378499_1673651,CM021108.1,9,29378499,452542393,4601384,1673651,454216044,450780271
29377742_1732263,CM021108.1,9,29377742,452538399,3104451,1732263,454270662,450834889
29377742_1732369,CM021108.1,9,29377742,452538399,3104451,1732369,454270768,450834995
29377742_1732417,CM021108.1,9,29377742,452538399,3104451,1732417,454270816,450835043
29380592_1749328,CM021108.1,9,29380592,452538409,1818555,1749328,454287737,450851964
29377742_1866131,CM021108.1,9,29377742,452538399,3104451,1866131,454404530,450968757
29377742_1866166,CM021108.1,9,29377742,452538399,3104451,1866166,454404565,450968792
29377742_1866256,CM021108.1,9,29377742,452538399,3104451,1866256,454404655,450968882
29377742_1866262,CM021108.1,9,29377742,452538399,3104451,1866262,454404661,450968888
29377742_1866269,CM021108.1,9,29377742,452538399,3104451,1866269,454404668,450968895
29377742_1866319,CM021108.1,9,29377742,452538399,3104451,1866319,454404718,450968945
29377803_2067796,CM021108.1,9,29377803,452550277,4709335,2067796,454618073,451182300
29377803_2067838,CM021108.1,9,29377803,452550277,4709335,2067838,454618115,451182342
29377803_2067880,CM021108.1,9,29377803,452550277,4709335,2067880,454618157,451182384
29377742_2374004,CM021108.1,9,29377742,452538399,3104451,2374004,454912403,451476630
29377742_2374025,CM021108.1,9,29377742,452538399,3104451,2374025,454912424,451476651
29377742_2374033,CM021108.1,9,29377742,452538399,3104451,2374033,454912432,451476659
29377742_2374101,CM021108.1,9,29377742,452538399,3104451,2374101,454912500,451476727
29377742_2376974,CM021108.1,9,29377742,452538399,3104451,2376974,454915373,451479600
29377742_2377021,CM021108.1,9,29377742,452538399,3104451,2377021,454915420,451479647
29377742_2405235,CM021108.1,9,29377742,452538399,3104451,2405235,454943634,451507861
29377742_2405282,CM021108.1,9,29377742,452538399,3104451,2405282,454943681,451507908
29378499_2462648,CM021108.1,9,29378499,452542393,4601384,2462648,455005041,451569268
29378499_2463033,CM021108.1,9,29378499,452542393,4601384,2463033,455005426,451569653
29378499_2463047,CM021108.1,9,29378499,452542393,4601384,2463047,455005440,451569667
29378499_2463086,CM021108.1,9,29378499,452542393,4601384,2463086,455005479,451569706
29378499_2595932,CM021108.1,9,29378499,452542393,4601384,2595932,455138325,451702552
29379587_2957035,CM021108.1,9,29379587,452538413,4468406,2957035,455495448,452059675
29379587_3440432,CM021108.1,9,29379587,452538413,4468406,3440432,455978845,452543072
29379587_3516973,CM021108.1,9,29379587,452538413,4468406,3516973,456055386,452619613
29377803_4014079,CM021108.1,9,29377803,452550277,4709335,4014079,456564356,453128583
29377803_4015254,CM021108.1,9,29377803,452550277,4709335,4015254,456565531,453129758
29377803_4398724,CM021108.1,9,29377803,452550277,4709335,4398724,456949001,453513228
29378300_132353,CM021108.1,9,29378300,457012177,257376,132353,457144530,453708757
29378300_132354,CM021108.1,9,29378300,457012177,257376,132354,457144531,453708758
29378300_132401,CM021108.1,9,29378300,457012177,257376,132401,457144578,453708805
29378300_132413,CM021108.1,9,29378300,457012177,257376,132413,457144590,453708817
29381464_7045939,CM021108.1,9,29381464,452554033,7899477,7045939,459599972,456164199
29381464_7389740,CM021108.1,9,29381464,452554033,7899477,7389740,459943773,456508000
29381464_7389750,CM021108.1,9,29381464,452554033,7899477,7389750,459943783,456508010
29381464_7389864,CM021108.1,9,29381464,452554033,7899477,7389864,459943897,456508124
29381464_7389877,CM021108.1,9,29381464,452554033,7899477,7389877,459943910,456508137
29381464_7389946,CM021108.1,9,29381464,452554033,7899477,7389946,459943979,456508206
29381464_7444327,CM021108.1,9,29381464,452554033,7899477,7444327,459998360,456562587
29381464_7445139,CM021108.1,9,29381464,452554033,7899477,7445139,459999172,456563399
29381464_7445182,CM021108.1,9,29381464,452554033,7899477,7445182,459999215,456563442
29381464_7513337,CM021108.1,9,29381464,452554033,7899477,7513337,460067370,456631597
29381499_8470,CM021108.1,9,29381499,463855968,1466295,8470,463864438,460428665
29379031_176240,CM021108.1,9,29379031,463861829,663093,176240,464038069,460602296
29379031_176292,CM021108.1,9,29379031,463861829,663093,176292,464038121,460602348
29379031_176613,CM021108.1,9,29379031,463861829,663093,176613,464038442,460602669
29379031_186143,CM021108.1,9,29379031,463861829,663093,186143,464047972,460612199
29379031_187918,CM021108.1,9,29379031,463861829,663093,187918,464049747,460613974
29379031_191045,CM021108.1,9,29379031,463861829,663093,191045,464052874,460617101
29379031_191108,CM021108.1,9,29379031,463861829,663093,191108,464052937,460617164
29379031_202448,CM021108.1,9,29379031,463861829,663093,202448,464064277,460628504
29379031_202464,CM021108.1,9,29379031,463861829,663093,202464,464064293,460628520
29379031_202557,CM021108.1,9,29379031,463861829,663093,202557,464064386,460628613
29381575_208105,CM021108.1,9,29381575,463860699,417613,208105,464068804,460633031
29378253_209367,CM021108.1,9,29378253,463859655,2335135,209367,464069022,460633249
29381575_255543,CM021108.1,9,29381575,463860699,417613,255543,464116242,460680469
29381575_255545,CM021108.1,9,29381575,463860699,417613,255545,464116244,460680471
29378253_261327,CM021108.1,9,29378253,463859655,2335135,261327,464120982,460685209
29379121_365815,CM021108.1,9,29379121,463861411,4054982,365815,464227226,460791453
29380686_366866,CM021108.1,9,29380686,463860393,1734917,366866,464227259,460791486
29380686_366893,CM021108.1,9,29380686,463860393,1734917,366893,464227286,460791513
29380686_367012,CM021108.1,9,29380686,463860393,1734917,367012,464227405,460791632
29380686_367150,CM021108.1,9,29380686,463860393,1734917,367150,464227543,460791770
29379121_367086,CM021108.1,9,29379121,463861411,4054982,367086,464228497,460792724
29380123_384452,CM021108.1,9,29380123,463847187,1274710,384452,464231639,460795866
29381037_372418,CM021108.1,9,29381037,463860365,2516033,372418,464232783,460797010
29380686_383975,CM021108.1,9,29380686,463860393,1734917,383975,464244368,460808595
29381037_413808,CM021108.1,9,29381037,463860365,2516033,413808,464274173,460838400
29379121_440178,CM021108.1,9,29379121,463861411,4054982,440178,464301589,460865816
29379252_523890,CM021108.1,9,29379252,463859262,3887775,523890,464383152,460947379
29379252_524215,CM021108.1,9,29379252,463859262,3887775,524215,464383477,460947704
29380027_553462,CM021108.1,9,29380027,463847187,4132915,553462,464400649,460964876
29379252_558110,CM021108.1,9,29379252,463859262,3887775,558110,464417372,460981599
29380686_674536,CM021108.1,9,29380686,463860393,1734917,674536,464534929,461099156
29380686_674555,CM021108.1,9,29380686,463860393,1734917,674555,464534948,461099175
29380686_674658,CM021108.1,9,29380686,463860393,1734917,674658,464535051,461099278
29378253_683594,CM021108.1,9,29378253,463859655,2335135,683594,464543249,461107476
29379252_721866,CM021108.1,9,29379252,463859262,3887775,721866,464581128,461145355
29379252_721980,CM021108.1,9,29379252,463859262,3887775,721980,464581242,461145469
29381499_742115,CM021108.1,9,29381499,463855968,1466295,742115,464598083,461162310
29381499_742187,CM021108.1,9,29381499,463855968,1466295,742187,464598155,461162382
29381499_742220,CM021108.1,9,29381499,463855968,1466295,742220,464598188,461162415
29381037_749677,CM021108.1,9,29381037,463860365,2516033,749677,464610042,461174269
29381037_749707,CM021108.1,9,29381037,463860365,2516033,749707,464610072,461174299
29381499_781989,CM021108.1,9,29381499,463855968,1466295,781989,464637957,461202184
29378072_789069,CM021108.1,9,29378072,463861386,3530593,789069,464650455,461214682
29381499_811934,CM021108.1,9,29381499,463855968,1466295,811934,464667902,461232129
29381499_812020,CM021108.1,9,29381499,463855968,1466295,812020,464667988,461232215
29380686_811882,CM021108.1,9,29380686,463860393,1734917,811882,464672275,461236502
29380686_811921,CM021108.1,9,29380686,463860393,1734917,811921,464672314,461236541
29380686_812017,CM021108.1,9,29380686,463860393,1734917,812017,464672410,461236637
29378072_821628,CM021108.1,9,29378072,463861386,3530593,821628,464683014,461247241
29380686_859721,CM021108.1,9,29380686,463860393,1734917,859721,464720114,461284341
29380686_859838,CM021108.1,9,29380686,463860393,1734917,859838,464720231,461284458
29380686_859916,CM021108.1,9,29380686,463860393,1734917,859916,464720309,461284536
29381740_881012,CM021108.1,9,29381740,463860382,1050500,881012,464741394,461305621
29380686_910065,CM021108.1,9,29380686,463860393,1734917,910065,464770458,461334685
29380686_910081,CM021108.1,9,29380686,463860393,1734917,910081,464770474,461334701
29380686_910092,CM021108.1,9,29380686,463860393,1734917,910092,464770485,461334712
29380686_910103,CM021108.1,9,29380686,463860393,1734917,910103,464770496,461334723
29380686_910106,CM021108.1,9,29380686,463860393,1734917,910106,464770499,461334726
29380686_910141,CM021108.1,9,29380686,463860393,1734917,910141,464770534,461334761
29378072_920336,CM021108.1,9,29378072,463861386,3530593,920336,464781722,461345949
29378072_920345,CM021108.1,9,29378072,463861386,3530593,920345,464781731,461345958
29380027_967191,CM021108.1,9,29380027,463847187,4132915,967191,464814378,461378605
29380686_982880,CM021108.1,9,29380686,463860393,1734917,982880,464843273,461407500
29380686_987440,CM021108.1,9,29380686,463860393,1734917,987440,464847833,461412060
29380686_987457,CM021108.1,9,29380686,463860393,1734917,987457,464847850,461412077
29381037_1031428,CM021108.1,9,29381037,463860365,2516033,1031428,464891793,461456020
29381037_1031468,CM021108.1,9,29381037,463860365,2516033,1031468,464891833,461456060
29381037_1031535,CM021108.1,9,29381037,463860365,2516033,1031535,464891900,461456127
29381037_1066131,CM021108.1,9,29381037,463860365,2516033,1066131,464926496,461490723
29381037_1066271,CM021108.1,9,29381037,463860365,2516033,1066271,464926636,461490863
29381037_1068824,CM021108.1,9,29381037,463860365,2516033,1068824,464929189,461493416
29378253_1156155,CM021108.1,9,29378253,463859655,2335135,1156155,465015810,461580037
29378253_1156225,CM021108.1,9,29378253,463859655,2335135,1156225,465015880,461580107
29378253_1156259,CM021108.1,9,29378253,463859655,2335135,1156259,465015914,461580141
29380686_1225142,CM021108.1,9,29380686,463860393,1734917,1225142,465085535,461649762
29380686_1264754,CM021108.1,9,29380686,463860393,1734917,1264754,465125147,461689374
29380686_1264864,CM021108.1,9,29380686,463860393,1734917,1264864,465125257,461689484
29380686_1265140,CM021108.1,9,29380686,463860393,1734917,1265140,465125533,461689760
29380686_1265145,CM021108.1,9,29380686,463860393,1734917,1265145,465125538,461689765
29380686_1265147,CM021108.1,9,29380686,463860393,1734917,1265147,465125540,461689767
29379252_1328184,CM021108.1,9,29379252,463859262,3887775,1328184,465187446,461751673
29378072_1466814,CM021108.1,9,29378072,463861386,3530593,1466814,465328200,461892427
29378052_1717497,CM021108.1,9,29378052,463857039,4121677,1717497,465574536,462138763
29378052_1717556,CM021108.1,9,29378052,463857039,4121677,1717556,465574595,462138822
29378052_1717596,CM021108.1,9,29378052,463857039,4121677,1717596,465574635,462138862
29378052_1717601,CM021108.1,9,29378052,463857039,4121677,1717601,465574640,462138867
29378052_1717604,CM021108.1,9,29378052,463857039,4121677,1717604,465574643,462138870
29378052_1717606,CM021108.1,9,29378052,463857039,4121677,1717606,465574645,462138872
29378253_1755615,CM021108.1,9,29378253,463859655,2335135,1755615,465615270,462179497
29379121_1797815,CM021108.1,9,29379121,463861411,4054982,1797815,465659226,462223453
29379121_1797832,CM021108.1,9,29379121,463861411,4054982,1797832,465659243,462223470
29379121_1797920,CM021108.1,9,29379121,463861411,4054982,1797920,465659331,462223558
29377971_1840399,CM021108.1,9,29377971,463847187,2131649,1840399,465687586,462251813
29377971_1841449,CM021108.1,9,29377971,463847187,2131649,1841449,465688636,462252863
29377971_1850751,CM021108.1,9,29377971,463847187,2131649,1850751,465697938,462262165
29377971_1850752,CM021108.1,9,29377971,463847187,2131649,1850752,465697939,462262166
29380027_1858419,CM021108.1,9,29380027,463847187,4132915,1858419,465705606,462269833
29381037_1929693,CM021108.1,9,29381037,463860365,2516033,1929693,465790058,462354285
29381037_1929694,CM021108.1,9,29381037,463860365,2516033,1929694,465790059,462354286
29379121_2071491,CM021108.1,9,29379121,463861411,4054982,2071491,465932902,462497129
29379121_2071496,CM021108.1,9,29379121,463861411,4054982,2071496,465932907,462497134
29378052_2079356,CM021108.1,9,29378052,463857039,4121677,2079356,465936395,462500622
29379121_2089622,CM021108.1,9,29379121,463861411,4054982,2089622,465951033,462515260
29379121_2092642,CM021108.1,9,29379121,463861411,4054982,2092642,465954053,462518280
29379121_2095421,CM021108.1,9,29379121,463861411,4054982,2095421,465956832,462521059
29377971_2125711,CM021108.1,9,29377971,463847187,2131649,2125711,465972898,462537125
29377971_2125799,CM021108.1,9,29377971,463847187,2131649,2125799,465972986,462537213
29379121_2250719,CM021108.1,9,29379121,463861411,4054982,2250719,466112130,462676357
29379121_2250781,CM021108.1,9,29379121,463861411,4054982,2250781,466112192,462676419
29379121_2250841,CM021108.1,9,29379121,463861411,4054982,2250841,466112252,462676479
29379121_2250933,CM021108.1,9,29379121,463861411,4054982,2250933,466112344,462676571
29379121_2251014,CM021108.1,9,29379121,463861411,4054982,2251014,466112425,462676652
29379121_2259187,CM021108.1,9,29379121,463861411,4054982,2259187,466120598,462684825
29379121_2367489,CM021108.1,9,29379121,463861411,4054982,2367489,466228900,462793127
29379121_2367498,CM021108.1,9,29379121,463861411,4054982,2367498,466228909,462793136
29379121_2367508,CM021108.1,9,29379121,463861411,4054982,2367508,466228919,462793146
29379121_2367542,CM021108.1,9,29379121,463861411,4054982,2367542,466228953,462793180
29379121_2368684,CM021108.1,9,29379121,463861411,4054982,2368684,466230095,462794322
29378052_2653873,CM021108.1,9,29378052,463857039,4121677,2653873,466510912,463075139
29378052_2728122,CM021108.1,9,29378052,463857039,4121677,2728122,466585161,463149388
29378052_2961335,CM021108.1,9,29378052,463857039,4121677,2961335,466818374,463382601
29379270_3038977,CM021108.1,9,29379270,463860534,7667140,3038977,466899511,463463738
29378052_3174163,CM021108.1,9,29378052,463857039,4121677,3174163,467031202,463595429
29378052_3174232,CM021108.1,9,29378052,463857039,4121677,3174232,467031271,463595498
29378052_3290147,CM021108.1,9,29378052,463857039,4121677,3290147,467147186,463711413
29378052_3290320,CM021108.1,9,29378052,463857039,4121677,3290320,467147359,463711586
29378052_3372588,CM021108.1,9,29378052,463857039,4121677,3372588,467229627,463793854
29378052_3400621,CM021108.1,9,29378052,463857039,4121677,3400621,467257660,463821887
29380027_3731107,CM021108.1,9,29380027,463847187,4132915,3731107,467578294,464142521
29380027_3731134,CM021108.1,9,29380027,463847187,4132915,3731134,467578321,464142548
29380027_3731176,CM021108.1,9,29380027,463847187,4132915,3731176,467578363,464142590
29380027_3731204,CM021108.1,9,29380027,463847187,4132915,3731204,467578391,464142618
29378052_3818459,CM021108.1,9,29378052,463857039,4121677,3818459,467675498,464239725
29378052_3846122,CM021108.1,9,29378052,463857039,4121677,3846122,467703161,464267388
29379270_3875893,CM021108.1,9,29379270,463860534,7667140,3875893,467736427,464300654
29379270_4018736,CM021108.1,9,29379270,463860534,7667140,4018736,467879270,464443497
29380027_4087427,CM021108.1,9,29380027,463847187,4132915,4087427,467934614,464498841
29380027_4087440,CM021108.1,9,29380027,463847187,4132915,4087440,467934627,464498854
29380027_4087590,CM021108.1,9,29380027,463847187,4132915,4087590,467934777,464499004
29379270_4408661,CM021108.1,9,29379270,463860534,7667140,4408661,468269195,464833422
29379270_4408845,CM021108.1,9,29379270,463860534,7667140,4408845,468269379,464833606
29379270_4408854,CM021108.1,9,29379270,463860534,7667140,4408854,468269388,464833615
29379270_4408869,CM021108.1,9,29379270,463860534,7667140,4408869,468269403,464833630
29379270_4408882,CM021108.1,9,29379270,463860534,7667140,4408882,468269416,464833643
29379270_4408883,CM021108.1,9,29379270,463860534,7667140,4408883,468269417,464833644
29379270_4408884,CM021108.1,9,29379270,463860534,7667140,4408884,468269418,464833645
29379270_4408890,CM021108.1,9,29379270,463860534,7667140,4408890,468269424,464833651
29379270_4983678,CM021108.1,9,29379270,463860534,7667140,4983678,468844212,465408439
29379270_4983687,CM021108.1,9,29379270,463860534,7667140,4983687,468844221,465408448
29379270_6432078,CM021108.1,9,29379270,463860534,7667140,6432078,470292612,466856839
29379270_6432128,CM021108.1,9,29379270,463860534,7667140,6432128,470292662,466856889
29379270_6443015,CM021108.1,9,29379270,463860534,7667140,6443015,470303549,466867776
29379270_6862479,CM021108.1,9,29379270,463860534,7667140,6862479,470723013,467287240
29379270_6862977,CM021108.1,9,29379270,463860534,7667140,6862977,470723511,467287738
29379270_7203026,CM021108.1,9,29379270,463860534,7667140,7203026,471063560,467627787
29378744_186217,CM021108.1,9,29378744,476728466,694463,186217,476914683,473478910
29378744_186311,CM021108.1,9,29378744,476728466,694463,186311,476914777,473479004
29379722_587203,CM021108.1,9,29379722,476728469,2565556,587203,477315672,473879899
29378356_818399,CM021108.1,9,29378356,476728463,1280419,818399,477546862,474111089
29378356_818460,CM021108.1,9,29378356,476728463,1280419,818460,477546923,474111150
29379722_1916188,CM021108.1,9,29379722,476728469,2565556,1916188,478644657,475208884
29379722_1916252,CM021108.1,9,29379722,476728469,2565556,1916252,478644721,475208948
29380620_2798,CM021108.1,9,29380620,499015530,7270831,2798,499018328,495582555
29380620_875248,CM021108.1,9,29380620,499015530,7270831,875248,499890778,496455005
29378801_1120533,CM021108.1,9,29378801,499014492,1267224,1120533,500135025,496699252
29378801_1120606,CM021108.1,9,29378801,499014492,1267224,1120606,500135098,496699325
29381775_1160199,CM021108.1,9,29381775,499014630,4730901,1160199,500174829,496739056
29381775_1458393,CM021108.1,9,29381775,499014630,4730901,1458393,500473023,497037250
29381775_1458539,CM021108.1,9,29381775,499014630,4730901,1458539,500473169,497037396
29381775_1458551,CM021108.1,9,29381775,499014630,4730901,1458551,500473181,497037408
29380620_2415752,CM021108.1,9,29380620,499015530,7270831,2415752,501431282,497995509
29380620_2455998,CM021108.1,9,29380620,499015530,7270831,2455998,501471528,498035755
29380620_2456062,CM021108.1,9,29380620,499015530,7270831,2456062,501471592,498035819
29380620_2461661,CM021108.1,9,29380620,499015530,7270831,2461661,501477191,498041418
29380620_2461666,CM021108.1,9,29380620,499015530,7270831,2461666,501477196,498041423
29380620_2477627,CM021108.1,9,29380620,499015530,7270831,2477627,501493157,498057384
29380620_2546377,CM021108.1,9,29380620,499015530,7270831,2546377,501561907,498126134
29380620_2546401,CM021108.1,9,29380620,499015530,7270831,2546401,501561931,498126158
29380620_2546443,CM021108.1,9,29380620,499015530,7270831,2546443,501561973,498126200
29380620_2555880,CM021108.1,9,29380620,499015530,7270831,2555880,501571410,498135637
29381775_2592622,CM021108.1,9,29381775,499014630,4730901,2592622,501607252,498171479
29381775_2592637,CM021108.1,9,29381775,499014630,4730901,2592637,501607267,498171494
29380620_2847721,CM021108.1,9,29380620,499015530,7270831,2847721,501863251,498427478
29380620_2847814,CM021108.1,9,29380620,499015530,7270831,2847814,501863344,498427571
29380620_2847816,CM021108.1,9,29380620,499015530,7270831,2847816,501863346,498427573
29380620_2847859,CM021108.1,9,29380620,499015530,7270831,2847859,501863389,498427616
29380620_2847863,CM021108.1,9,29380620,499015530,7270831,2847863,501863393,498427620
29380620_2847870,CM021108.1,9,29380620,499015530,7270831,2847870,501863400,498427627
29380620_2847877,CM021108.1,9,29380620,499015530,7270831,2847877,501863407,498427634
29380620_2849503,CM021108.1,9,29380620,499015530,7270831,2849503,501865033,498429260
29380804_2949319,CM021108.1,9,29380804,499014698,4901349,2949319,501964017,498528244
29380804_2949322,CM021108.1,9,29380804,499014698,4901349,2949322,501964020,498528247
29380804_2980489,CM021108.1,9,29380804,499014698,4901349,2980489,501995187,498559414
29380804_3011671,CM021108.1,9,29380804,499014698,4901349,3011671,502026369,498590596
29380620_3528886,CM021108.1,9,29380620,499015530,7270831,3528886,502544416,499108643
29381775_3608457,CM021108.1,9,29381775,499014630,4730901,3608457,502623087,499187314
29381775_3608494,CM021108.1,9,29381775,499014630,4730901,3608494,502623124,499187351
29381775_3608529,CM021108.1,9,29381775,499014630,4730901,3608529,502623159,499187386
29381775_3608589,CM021108.1,9,29381775,499014630,4730901,3608589,502623219,499187446
29380620_3695016,CM021108.1,9,29380620,499015530,7270831,3695016,502710546,499274773
29380620_3695019,CM021108.1,9,29380620,499015530,7270831,3695019,502710549,499274776
29380620_3695047,CM021108.1,9,29380620,499015530,7270831,3695047,502710577,499274804
29380620_3695101,CM021108.1,9,29380620,499015530,7270831,3695101,502710631,499274858
29380804_3880162,CM021108.1,9,29380804,499014698,4901349,3880162,502894860,499459087
29380804_3880181,CM021108.1,9,29380804,499014698,4901349,3880181,502894879,499459106
29380804_3880309,CM021108.1,9,29380804,499014698,4901349,3880309,502895007,499459234
29380804_3880322,CM021108.1,9,29380804,499014698,4901349,3880322,502895020,499459247
29380804_3880350,CM021108.1,9,29380804,499014698,4901349,3880350,502895048,499459275
29380620_3947819,CM021108.1,9,29380620,499015530,7270831,3947819,502963349,499527576
29380620_3947883,CM021108.1,9,29380620,499015530,7270831,3947883,502963413,499527640
29380620_3947892,CM021108.1,9,29380620,499015530,7270831,3947892,502963422,499527649
29380620_3947932,CM021108.1,9,29380620,499015530,7270831,3947932,502963462,499527689
29380620_3947936,CM021108.1,9,29380620,499015530,7270831,3947936,502963466,499527693
29380620_3948235,CM021108.1,9,29380620,499015530,7270831,3948235,502963765,499527992
29380620_3948262,CM021108.1,9,29380620,499015530,7270831,3948262,502963792,499528019
29380620_3948349,CM021108.1,9,29380620,499015530,7270831,3948349,502963879,499528106
29380804_4697337,CM021108.1,9,29380804,499014698,4901349,4697337,503712035,500276262
29380804_4699926,CM021108.1,9,29380804,499014698,4901349,4699926,503714624,500278851
29380804_4699947,CM021108.1,9,29380804,499014698,4901349,4699947,503714645,500278872
29380804_4700073,CM021108.1,9,29380804,499014698,4901349,4700073,503714771,500278998
29380804_4732877,CM021108.1,9,29380804,499014698,4901349,4732877,503747575,500311802
29380804_4732894,CM021108.1,9,29380804,499014698,4901349,4732894,503747592,500311819
29380804_4732905,CM021108.1,9,29380804,499014698,4901349,4732905,503747603,500311830
29380804_4733909,CM021108.1,9,29380804,499014698,4901349,4733909,503748607,500312834
29380804_4734872,CM021108.1,9,29380804,499014698,4901349,4734872,503749570,500313797
29380804_4734926,CM021108.1,9,29380804,499014698,4901349,4734926,503749624,500313851
29380804_4735070,CM021108.1,9,29380804,499014698,4901349,4735070,503749768,500313995
29380804_4735110,CM021108.1,9,29380804,499014698,4901349,4735110,503749808,500314035
29380804_4735112,CM021108.1,9,29380804,499014698,4901349,4735112,503749810,500314037
29380804_4735160,CM021108.1,9,29380804,499014698,4901349,4735160,503749858,500314085
29380804_4772192,CM021108.1,9,29380804,499014698,4901349,4772192,503786890,500351117
29380804_4772198,CM021108.1,9,29380804,499014698,4901349,4772198,503786896,500351123
29380804_4772233,CM021108.1,9,29380804,499014698,4901349,4772233,503786931,500351158
29380804_4772289,CM021108.1,9,29380804,499014698,4901349,4772289,503786987,500351214
29380804_4772292,CM021108.1,9,29380804,499014698,4901349,4772292,503786990,500351217
29380804_4772301,CM021108.1,9,29380804,499014698,4901349,4772301,503786999,500351226
29380620_5913491,CM021108.1,9,29380620,499015530,7270831,5913491,504929021,501493248
29380898_9590,CM021108.1,9,29380898,526851598,2448001,9590,526861188,523425415
29380898_9598,CM021108.1,9,29380898,526851598,2448001,9598,526861196,523425423
29365288_10199,CM021108.1,9,29365288,526851595,17296,10199,526861794,523426021
29365288_10212,CM021108.1,9,29365288,526851595,17296,10212,526861807,523426034
29365288_10215,CM021108.1,9,29365288,526851595,17296,10215,526861810,523426037
29378036_25692,CM021108.1,9,29378036,526854994,468949,25692,526880686,523444913
29378036_27097,CM021108.1,9,29378036,526854994,468949,27097,526882091,523446318
29378036_27146,CM021108.1,9,29378036,526854994,468949,27146,526882140,523446367
29379071_47103,CM021108.1,9,29379071,526853618,2048981,47103,526900721,523464948
29379071_47137,CM021108.1,9,29379071,526853618,2048981,47137,526900755,523464982
29379179_170790,CM021108.1,9,29379179,526851597,3977892,170790,527022387,523586614
29379179_209996,CM021108.1,9,29379179,526851597,3977892,209996,527061593,523625820
29377085_395672,CM021108.1,9,29377085,526851598,464058,395672,527247270,523811497
29378036_412896,CM021108.1,9,29378036,526854994,468949,412896,527267890,523832117
29378036_413141,CM021108.1,9,29378036,526854994,468949,413141,527268135,523832362
29378036_413144,CM021108.1,9,29378036,526854994,468949,413144,527268138,523832365
29378036_413161,CM021108.1,9,29378036,526854994,468949,413161,527268155,523832382
29378036_413186,CM021108.1,9,29378036,526854994,468949,413186,527268180,523832407
29378036_413248,CM021108.1,9,29378036,526854994,468949,413248,527268242,523832469
29379617_724816,CM021108.1,9,29379617,526853646,1346577,724816,527578462,524142689
29379071_866498,CM021108.1,9,29379071,526853618,2048981,866498,527720116,524284343
29379179_967656,CM021108.1,9,29379179,526851597,3977892,967656,527819253,524383480
29380898_1197134,CM021108.1,9,29380898,526851598,2448001,1197134,528048732,524612959
29380898_1203920,CM021108.1,9,29380898,526851598,2448001,1203920,528055518,524619745
29379179_1300334,CM021108.1,9,29379179,526851597,3977892,1300334,528151931,524716158
29379071_1307381,CM021108.1,9,29379071,526853618,2048981,1307381,528160999,524725226
29379617_1344715,CM021108.1,9,29379617,526853646,1346577,1344715,528198361,524762588
29379617_1345348,CM021108.1,9,29379617,526853646,1346577,1345348,528198994,524763221
29379617_1345381,CM021108.1,9,29379617,526853646,1346577,1345381,528199027,524763254
29379617_1345438,CM021108.1,9,29379617,526853646,1346577,1345438,528199084,524763311
29379617_1345443,CM021108.1,9,29379617,526853646,1346577,1345443,528199089,524763316
29379617_1345473,CM021108.1,9,29379617,526853646,1346577,1345473,528199119,524763346
29380898_1357021,CM021108.1,9,29380898,526851598,2448001,1357021,528208619,524772846
29379179_2657932,CM021108.1,9,29379179,526851597,3977892,2657932,529509529,526073756
29379179_2657949,CM021108.1,9,29379179,526851597,3977892,2657949,529509546,526073773
29379179_2657978,CM021108.1,9,29379179,526851597,3977892,2657978,529509575,526073802
29379179_2658001,CM021108.1,9,29379179,526851597,3977892,2658001,529509598,526073825
29379179_3489677,CM021108.1,9,29379179,526851597,3977892,3489677,530341274,526905501
29379179_3489857,CM021108.1,9,29379179,526851597,3977892,3489857,530341454,526905681
29380215_107709,CM021108.1,9,29380215,532078323,244471,107709,532186032,528750259
29380215_107757,CM021108.1,9,29380215,532078323,244471,107757,532186080,528750307
29378547_21563,CM021108.1,9,29378547,539850808,1404528,21563,539872371,536436598
29378547_21593,CM021108.1,9,29378547,539850808,1404528,21593,539872401,536436628
29378547_21655,CM021108.1,9,29378547,539850808,1404528,21655,539872463,536436690
29378547_444890,CM021108.1,9,29378547,539850808,1404528,444890,540295698,536859925
29378547_444993,CM021108.1,9,29378547,539850808,1404528,444993,540295801,536860028
29378547_445014,CM021108.1,9,29378547,539850808,1404528,445014,540295822,536860049
29378547_445028,CM021108.1,9,29378547,539850808,1404528,445028,540295836,536860063
29378547_445037,CM021108.1,9,29378547,539850808,1404528,445037,540295845,536860072
29378547_593937,CM021108.1,9,29378547,539850808,1404528,593937,540444745,537008972
29378547_905966,CM021108.1,9,29378547,539850808,1404528,905966,540756774,537321001
29367679_10543,CM021108.1,9,29367679,550305022,18640,10543,550315565,546879792
29379800_153030,CM021108.1,9,29379800,583699128,791114,153030,583852158,580416385
29379800_153046,CM021108.1,9,29379800,583699128,791114,153046,583852174,580416401
29379800_153064,CM021108.1,9,29379800,583699128,791114,153064,583852192,580416419
29379800_153261,CM021108.1,9,29379800,583699128,791114,153261,583852389,580416616
29379800_153385,CM021108.1,9,29379800,583699128,791114,153385,583852513,580416740
29379800_153409,CM021108.1,9,29379800,583699128,791114,153409,583852537,580416764
29379800_153419,CM021108.1,9,29379800,583699128,791114,153419,583852547,580416774
29379800_153516,CM021108.1,9,29379800,583699128,791114,153516,583852644,580416871
29379800_153519,CM021108.1,9,29379800,583699128,791114,153519,583852647,580416874
29379800_153520,CM021108.1,9,29379800,583699128,791114,153520,583852648,580416875
29373633_342374,CM021108.1,9,29373633,583699974,420075,342374,584042348,580606575
29373633_342425,CM021108.1,9,29373633,583699974,420075,342425,584042399,580606626
29373633_360841,CM021108.1,9,29373633,583699974,420075,360841,584060815,580625042
29373633_367509,CM021108.1,9,29373633,583699974,420075,367509,584067483,580631710
29373633_367558,CM021108.1,9,29373633,583699974,420075,367558,584067532,580631759
29379800_549954,CM021108.1,9,29379800,583699128,791114,549954,584249082,580813309
29379800_549967,CM021108.1,9,29379800,583699128,791114,549967,584249095,580813322
29381992_3330,CM021108.1,9,29381992,613998153,4203016,3330,614001483,610565710
29381988_135946,CM021108.1,9,29381988,613997602,1004004,135946,614133548,610697775
29381988_136085,CM021108.1,9,29381988,613997602,1004004,136085,614133687,610697914
29381992_146003,CM021108.1,9,29381992,613998153,4203016,146003,614144156,610708383
29381988_193940,CM021108.1,9,29381988,613997602,1004004,193940,614191542,610755769
29381988_193961,CM021108.1,9,29381988,613997602,1004004,193961,614191563,610755790
29381988_194229,CM021108.1,9,29381988,613997602,1004004,194229,614191831,610756058
29381988_194304,CM021108.1,9,29381988,613997602,1004004,194304,614191906,610756133
29381988_194431,CM021108.1,9,29381988,613997602,1004004,194431,614192033,610756260
29379459_271486,CM021108.1,9,29379459,613997658,2700209,271486,614269144,610833371
29379459_271534,CM021108.1,9,29379459,613997658,2700209,271534,614269192,610833419
29381992_376380,CM021108.1,9,29381992,613998153,4203016,376380,614374533,610938760
29381992_376421,CM021108.1,9,29381992,613998153,4203016,376421,614374574,610938801
29381992_376447,CM021108.1,9,29381992,613998153,4203016,376447,614374600,610938827
29381992_376456,CM021108.1,9,29381992,613998153,4203016,376456,614374609,610938836
29381992_376471,CM021108.1,9,29381992,613998153,4203016,376471,614374624,610938851
29381992_376472,CM021108.1,9,29381992,613998153,4203016,376472,614374625,610938852
29381992_376501,CM021108.1,9,29381992,613998153,4203016,376501,614374654,610938881
29381992_848481,CM021108.1,9,29381992,613998153,4203016,848481,614846634,611410861
29381992_1137754,CM021108.1,9,29381992,613998153,4203016,1137754,615135907,611700134
29381992_1137761,CM021108.1,9,29381992,613998153,4203016,1137761,615135914,611700141
29381992_1359112,CM021108.1,9,29381992,613998153,4203016,1359112,615357265,611921492
29381992_1359118,CM021108.1,9,29381992,613998153,4203016,1359118,615357271,611921498
29381992_1359214,CM021108.1,9,29381992,613998153,4203016,1359214,615357367,611921594
29381992_1359277,CM021108.1,9,29381992,613998153,4203016,1359277,615357430,611921657
29379459_1432269,CM021108.1,9,29379459,613997658,2700209,1432269,615429927,611994154
29379459_2128843,CM021108.1,9,29379459,613997658,2700209,2128843,616126501,612690728
28173112_1790,CM021108.1,9,28173112,625438445,7325,1790,625440235,622004462
29358448_16012,CM021109.1,10,29358448,9256041,24903,16012,9272053,16012
29358448_16033,CM021109.1,10,29358448,9256041,24903,16033,9272074,16033
29381947_6915,CM021109.1,10,29381947,51070840,756229,6915,51077755,41821714
29381289_96814,CM021109.1,10,29381289,51068700,662247,96814,51165514,41909473
29381289_97464,CM021109.1,10,29381289,51068700,662247,97464,51166164,41910123
29381289_97498,CM021109.1,10,29381289,51068700,662247,97498,51166198,41910157
29381969_135128,CM021109.1,10,29381969,51068710,141416,135128,51203838,41947797
29381969_135198,CM021109.1,10,29381969,51068710,141416,135198,51203908,41947867
29381289_346282,CM021109.1,10,29381289,51068700,662247,346282,51414982,42158941
29381289_557477,CM021109.1,10,29381289,51068700,662247,557477,51626177,42370136
29381289_557501,CM021109.1,10,29381289,51068700,662247,557501,51626201,42370160
29381289_587439,CM021109.1,10,29381289,51068700,662247,587439,51656139,42400098
29381289_587904,CM021109.1,10,29381289,51068700,662247,587904,51656604,42400563
29381289_628179,CM021109.1,10,29381289,51068700,662247,628179,51696879,42440838
29381289_628308,CM021109.1,10,29381289,51068700,662247,628308,51697008,42440967
29381512_780036,CM021109.1,10,29381512,51068709,1973736,780036,51848745,42592704
29381512_780064,CM021109.1,10,29381512,51068709,1973736,780064,51848773,42592732
29379113_142006,CM021109.1,10,29379113,69078891,625692,142006,69220897,59964856
29379113_142017,CM021109.1,10,29379113,69078891,625692,142017,69220908,59964867
29379113_142892,CM021109.1,10,29379113,69078891,625692,142892,69221783,59965742
29379113_142916,CM021109.1,10,29379113,69078891,625692,142916,69221807,59965766
29334532_14739,CM021109.1,10,29334532,87442152,136902,14739,87456891,78200850
29381793_158821,CM021109.1,10,29381793,87442871,165515,158821,87601692,78345651
29381793_158914,CM021109.1,10,29381793,87442871,165515,158914,87601785,78345744
29381793_158933,CM021109.1,10,29381793,87442871,165515,158933,87601804,78345763
29381793_158944,CM021109.1,10,29381793,87442871,165515,158944,87601815,78345774
29381793_158950,CM021109.1,10,29381793,87442871,165515,158950,87601821,78345780
29381793_158958,CM021109.1,10,29381793,87442871,165515,158958,87601829,78345788
29347062_4052,CM021109.1,10,29347062,88770417,6828,4052,88774469,79518428
29347062_4142,CM021109.1,10,29347062,88770417,6828,4142,88774559,79518518
29347062_4155,CM021109.1,10,29347062,88770417,6828,4155,88774572,79518531
29347062_4202,CM021109.1,10,29347062,88770417,6828,4202,88774619,79518578
29362248_12152,CM021109.1,10,29362248,102565052,294759,12152,102577204,93321163
29362248_12178,CM021109.1,10,29362248,102565052,294759,12178,102577230,93321189
29362248_12217,CM021109.1,10,29362248,102565052,294759,12217,102577269,93321228
29382158_125894,CM021109.1,10,29382158,102565054,1934000,125894,102690948,93434907
29379775_247291,CM021109.1,10,29379775,102565052,922733,247291,102812343,93556302
29379775_267643,CM021109.1,10,29379775,102565052,922733,267643,102832695,93576654
29379775_267649,CM021109.1,10,29379775,102565052,922733,267649,102832701,93576660
29379490_267026,CM021109.1,10,29379490,102570253,1235756,267026,102837279,93581238
29379490_267033,CM021109.1,10,29379490,102570253,1235756,267033,102837286,93581245
29379363_282504,CM021109.1,10,29379363,102565049,1031850,282504,102847553,93591512
29382195_299746,CM021109.1,10,29382195,102569349,6480296,299746,102869095,93613054
29379490_299166,CM021109.1,10,29379490,102570253,1235756,299166,102869419,93613378
29379490_299207,CM021109.1,10,29379490,102570253,1235756,299207,102869460,93613419
29382158_308460,CM021109.1,10,29382158,102565054,1934000,308460,102873514,93617473
29382158_308473,CM021109.1,10,29382158,102565054,1934000,308473,102873527,93617486
29379775_324374,CM021109.1,10,29379775,102565052,922733,324374,102889426,93633385
29379775_360565,CM021109.1,10,29379775,102565052,922733,360565,102925617,93669576
29379775_360661,CM021109.1,10,29379775,102565052,922733,360661,102925713,93669672
29379775_381723,CM021109.1,10,29379775,102565052,922733,381723,102946775,93690734
29379775_381760,CM021109.1,10,29379775,102565052,922733,381760,102946812,93690771
29379775_441052,CM021109.1,10,29379775,102565052,922733,441052,103006104,93750063
29379775_441060,CM021109.1,10,29379775,102565052,922733,441060,103006112,93750071
29379775_441122,CM021109.1,10,29379775,102565052,922733,441122,103006174,93750133
29379775_441377,CM021109.1,10,29379775,102565052,922733,441377,103006429,93750388
29379775_441406,CM021109.1,10,29379775,102565052,922733,441406,103006458,93750417
29379775_441543,CM021109.1,10,29379775,102565052,922733,441543,103006595,93750554
29382195_509802,CM021109.1,10,29382195,102569349,6480296,509802,103079151,93823110
29377328_546748,CM021109.1,10,29377328,102568018,3172653,546748,103114766,93858725
29377328_546839,CM021109.1,10,29377328,102568018,3172653,546839,103114857,93858816
29377328_546991,CM021109.1,10,29377328,102568018,3172653,546991,103115009,93858968
29379775_550880,CM021109.1,10,29379775,102565052,922733,550880,103115932,93859891
29379775_550901,CM021109.1,10,29379775,102565052,922733,550901,103115953,93859912
29345140_552287,CM021109.1,10,29345140,102570358,565468,552287,103122645,93866604
29379775_597709,CM021109.1,10,29379775,102565052,922733,597709,103162761,93906720
29379775_597738,CM021109.1,10,29379775,102565052,922733,597738,103162790,93906749
29381397_599443,CM021109.1,10,29381397,102565054,3213139,599443,103164497,93908456
29381397_599483,CM021109.1,10,29381397,102565054,3213139,599483,103164537,93908496
29377402_751123,CM021109.1,10,29377402,102565049,6893483,751123,103316172,94060131
29377402_751164,CM021109.1,10,29377402,102565049,6893483,751164,103316213,94060172
29377402_751285,CM021109.1,10,29377402,102565049,6893483,751285,103316334,94060293
29377402_751948,CM021109.1,10,29377402,102565049,6893483,751948,103316997,94060956
29377328_778953,CM021109.1,10,29377328,102568018,3172653,778953,103346971,94090930
29377328_778992,CM021109.1,10,29377328,102568018,3172653,778992,103347010,94090969
29377328_779024,CM021109.1,10,29377328,102568018,3172653,779024,103347042,94091001
29382195_827135,CM021109.1,10,29382195,102569349,6480296,827135,103396484,94140443
29382195_827163,CM021109.1,10,29382195,102569349,6480296,827163,103396512,94140471
29382195_827301,CM021109.1,10,29382195,102569349,6480296,827301,103396650,94140609
29382195_831218,CM021109.1,10,29382195,102569349,6480296,831218,103400567,94144526
29382195_831282,CM021109.1,10,29382195,102569349,6480296,831282,103400631,94144590
29382008_855736,CM021109.1,10,29382008,102565045,1626703,855736,103420781,94164740
29382008_860648,CM021109.1,10,29382008,102565045,1626703,860648,103425693,94169652
29382008_860690,CM021109.1,10,29382008,102565045,1626703,860690,103425735,94169694
29382008_860733,CM021109.1,10,29382008,102565045,1626703,860733,103425778,94169737
29382008_860772,CM021109.1,10,29382008,102565045,1626703,860772,103425817,94169776
29382008_861076,CM021109.1,10,29382008,102565045,1626703,861076,103426121,94170080
29382008_861108,CM021109.1,10,29382008,102565045,1626703,861108,103426153,94170112
29382008_861141,CM021109.1,10,29382008,102565045,1626703,861141,103426186,94170145
29381397_880595,CM021109.1,10,29381397,102565054,3213139,880595,103445649,94189608
29382008_962118,CM021109.1,10,29382008,102565045,1626703,962118,103527163,94271122
29382008_962172,CM021109.1,10,29382008,102565045,1626703,962172,103527217,94271176
29382008_962239,CM021109.1,10,29382008,102565045,1626703,962239,103527284,94271243
29382008_962240,CM021109.1,10,29382008,102565045,1626703,962240,103527285,94271244
29382008_972955,CM021109.1,10,29382008,102565045,1626703,972955,103538000,94281959
29379490_1007628,CM021109.1,10,29379490,102570253,1235756,1007628,103577881,94321840
29379490_1007668,CM021109.1,10,29379490,102570253,1235756,1007668,103577921,94321880
29379490_1007742,CM021109.1,10,29379490,102570253,1235756,1007742,103577995,94321954
29382008_1017194,CM021109.1,10,29382008,102565045,1626703,1017194,103582239,94326198
29382008_1018198,CM021109.1,10,29382008,102565045,1626703,1018198,103583243,94327202
29382008_1057368,CM021109.1,10,29382008,102565045,1626703,1057368,103622413,94366372
29382008_1057403,CM021109.1,10,29382008,102565045,1626703,1057403,103622448,94366407
29382008_1059950,CM021109.1,10,29382008,102565045,1626703,1059950,103624995,94368954
29382008_1059983,CM021109.1,10,29382008,102565045,1626703,1059983,103625028,94368987
29382195_1084207,CM021109.1,10,29382195,102569349,6480296,1084207,103653556,94397515
29382008_1115329,CM021109.1,10,29382008,102565045,1626703,1115329,103680374,94424333
29382008_1115379,CM021109.1,10,29382008,102565045,1626703,1115379,103680424,94424383
29382008_1132668,CM021109.1,10,29382008,102565045,1626703,1132668,103697713,94441672
29382008_1132687,CM021109.1,10,29382008,102565045,1626703,1132687,103697732,94441691
29382008_1132757,CM021109.1,10,29382008,102565045,1626703,1132757,103697802,94441761
29382008_1132872,CM021109.1,10,29382008,102565045,1626703,1132872,103697917,94441876
29382008_1132878,CM021109.1,10,29382008,102565045,1626703,1132878,103697923,94441882
29382008_1132883,CM021109.1,10,29382008,102565045,1626703,1132883,103697928,94441887
29382008_1132886,CM021109.1,10,29382008,102565045,1626703,1132886,103697931,94441890
29382008_1132901,CM021109.1,10,29382008,102565045,1626703,1132901,103697946,94441905
29382008_1132904,CM021109.1,10,29382008,102565045,1626703,1132904,103697949,94441908
29382008_1132913,CM021109.1,10,29382008,102565045,1626703,1132913,103697958,94441917
29382195_1248623,CM021109.1,10,29382195,102569349,6480296,1248623,103817972,94561931
29382195_1248667,CM021109.1,10,29382195,102569349,6480296,1248667,103818016,94561975
29382195_1248704,CM021109.1,10,29382195,102569349,6480296,1248704,103818053,94562012
29378861_1297832,CM021109.1,10,29378861,102565051,1590172,1297832,103862883,94606842
29381397_1976144,CM021109.1,10,29381397,102565054,3213139,1976144,104541198,95285157
29381397_1976172,CM021109.1,10,29381397,102565054,3213139,1976172,104541226,95285185
29381397_1976174,CM021109.1,10,29381397,102565054,3213139,1976174,104541228,95285187
29381397_1976179,CM021109.1,10,29381397,102565054,3213139,1976179,104541233,95285192
29380510_2039661,CM021109.1,10,29380510,102568057,3682231,2039661,104607718,95351677
29380510_2039923,CM021109.1,10,29380510,102568057,3682231,2039923,104607980,95351939
29381397_2189339,CM021109.1,10,29381397,102565054,3213139,2189339,104754393,95498352
29381397_2189380,CM021109.1,10,29381397,102565054,3213139,2189380,104754434,95498393
29381397_2238336,CM021109.1,10,29381397,102565054,3213139,2238336,104803390,95547349
29381397_2238614,CM021109.1,10,29381397,102565054,3213139,2238614,104803668,95547627
29381397_2238615,CM021109.1,10,29381397,102565054,3213139,2238615,104803669,95547628
29377402_2600106,CM021109.1,10,29377402,102565049,6893483,2600106,105165155,95909114
29377402_2600108,CM021109.1,10,29377402,102565049,6893483,2600108,105165157,95909116
29377402_2600163,CM021109.1,10,29377402,102565049,6893483,2600163,105165212,95909171
29377402_2600715,CM021109.1,10,29377402,102565049,6893483,2600715,105165764,95909723
29377402_2600799,CM021109.1,10,29377402,102565049,6893483,2600799,105165848,95909807
29377402_2600824,CM021109.1,10,29377402,102565049,6893483,2600824,105165873,95909832
29377402_2658418,CM021109.1,10,29377402,102565049,6893483,2658418,105223467,95967426
29377402_2658439,CM021109.1,10,29377402,102565049,6893483,2658439,105223488,95967447
29377402_2658461,CM021109.1,10,29377402,102565049,6893483,2658461,105223510,95967469
29377402_2658556,CM021109.1,10,29377402,102565049,6893483,2658556,105223605,95967564
29377402_2658580,CM021109.1,10,29377402,102565049,6893483,2658580,105223629,95967588
29377402_2658638,CM021109.1,10,29377402,102565049,6893483,2658638,105223687,95967646
29377402_2658683,CM021109.1,10,29377402,102565049,6893483,2658683,105223732,95967691
29377402_2658706,CM021109.1,10,29377402,102565049,6893483,2658706,105223755,95967714
29377402_2658722,CM021109.1,10,29377402,102565049,6893483,2658722,105223771,95967730
29377402_2658723,CM021109.1,10,29377402,102565049,6893483,2658723,105223772,95967731
29377328_2689775,CM021109.1,10,29377328,102568018,3172653,2689775,105257793,96001752
29377328_2986692,CM021109.1,10,29377328,102568018,3172653,2986692,105554710,96298669
29377328_2986957,CM021109.1,10,29377328,102568018,3172653,2986957,105554975,96298934
29380510_3066664,CM021109.1,10,29380510,102568057,3682231,3066664,105634721,96378680
29381397_3085181,CM021109.1,10,29381397,102565054,3213139,3085181,105650235,96394194
29381397_3085195,CM021109.1,10,29381397,102565054,3213139,3085195,105650249,96394208
29381397_3085243,CM021109.1,10,29381397,102565054,3213139,3085243,105650297,96394256
29377402_3198167,CM021109.1,10,29377402,102565049,6893483,3198167,105763216,96507175
29382195_3649183,CM021109.1,10,29382195,102569349,6480296,3649183,106218532,96962491
29380049_4164007,CM021109.1,10,29380049,102565053,6097075,4164007,106729060,97473019
29380049_4164183,CM021109.1,10,29380049,102565053,6097075,4164183,106729236,97473195
29377402_4227045,CM021109.1,10,29377402,102565049,6893483,4227045,106792094,97536053
29377402_4227078,CM021109.1,10,29377402,102565049,6893483,4227078,106792127,97536086
29380049_4291186,CM021109.1,10,29380049,102565053,6097075,4291186,106856239,97600198
29380049_4291214,CM021109.1,10,29380049,102565053,6097075,4291214,106856267,97600226
29380049_4291217,CM021109.1,10,29380049,102565053,6097075,4291217,106856270,97600229
29377402_4312604,CM021109.1,10,29377402,102565049,6893483,4312604,106877653,97621612
29377402_4312689,CM021109.1,10,29377402,102565049,6893483,4312689,106877738,97621697
29382195_4350476,CM021109.1,10,29382195,102569349,6480296,4350476,106919825,97663784
29382195_4350477,CM021109.1,10,29382195,102569349,6480296,4350477,106919826,97663785
29382195_4350873,CM021109.1,10,29382195,102569349,6480296,4350873,106920222,97664181
29382195_4350934,CM021109.1,10,29382195,102569349,6480296,4350934,106920283,97664242
29377402_4444838,CM021109.1,10,29377402,102565049,6893483,4444838,107009887,97753846
29380049_5181874,CM021109.1,10,29380049,102565053,6097075,5181874,107746927,98490886
29380049_5181939,CM021109.1,10,29380049,102565053,6097075,5181939,107746992,98490951
29380049_5181966,CM021109.1,10,29380049,102565053,6097075,5181966,107747019,98490978
29382195_5707387,CM021109.1,10,29382195,102569349,6480296,5707387,108276736,99020695
29382195_5717522,CM021109.1,10,29382195,102569349,6480296,5717522,108286871,99030830
29378738_311377,CM021109.1,10,29378738,108136220,466141,311377,108447597,99191556
29378738_334998,CM021109.1,10,29378738,108136220,466141,334998,108471218,99215177
29377402_5918865,CM021109.1,10,29377402,102565049,6893483,5918865,108483914,99227873
29377402_5918867,CM021109.1,10,29377402,102565049,6893483,5918867,108483916,99227875
29377317_361312,CM021109.1,10,29377317,108136117,2836781,361312,108497429,99241388
29379801_416516,CM021109.1,10,29379801,108137255,1121379,416516,108553771,99297730
29379801_416536,CM021109.1,10,29379801,108137255,1121379,416536,108553791,99297750
29379801_416538,CM021109.1,10,29379801,108137255,1121379,416538,108553793,99297752
29379801_416574,CM021109.1,10,29379801,108137255,1121379,416574,108553829,99297788
29379801_416635,CM021109.1,10,29379801,108137255,1121379,416635,108553890,99297849
29379801_416653,CM021109.1,10,29379801,108137255,1121379,416653,108553908,99297867
29379801_416654,CM021109.1,10,29379801,108137255,1121379,416654,108553909,99297868
29379801_416670,CM021109.1,10,29379801,108137255,1121379,416670,108553925,99297884
29379801_416706,CM021109.1,10,29379801,108137255,1121379,416706,108553961,99297920
29379801_416764,CM021109.1,10,29379801,108137255,1121379,416764,108554019,99297978
29379801_416849,CM021109.1,10,29379801,108137255,1121379,416849,108554104,99298063
29379801_416863,CM021109.1,10,29379801,108137255,1121379,416863,108554118,99298077
29379801_416899,CM021109.1,10,29379801,108137255,1121379,416899,108554154,99298113
29380870_445237,CM021109.1,10,29380870,108136939,5812067,445237,108582176,99326135
29380870_459907,CM021109.1,10,29380870,108136939,5812067,459907,108596846,99340805
29382195_6028234,CM021109.1,10,29382195,102569349,6480296,6028234,108597583,99341542
29382418_485721,CM021109.1,10,29382418,108136504,4967799,485721,108622225,99366184
29382418_485722,CM021109.1,10,29382418,108136504,4967799,485722,108622226,99366185
29382418_486454,CM021109.1,10,29382418,108136504,4967799,486454,108622958,99366917
29382418_486759,CM021109.1,10,29382418,108136504,4967799,486759,108623263,99367222
29382418_486780,CM021109.1,10,29382418,108136504,4967799,486780,108623284,99367243
29382418_486870,CM021109.1,10,29382418,108136504,4967799,486870,108623374,99367333
29382418_486903,CM021109.1,10,29382418,108136504,4967799,486903,108623407,99367366
29382418_513817,CM021109.1,10,29382418,108136504,4967799,513817,108650321,99394280
29382418_514019,CM021109.1,10,29382418,108136504,4967799,514019,108650523,99394482
29378419_677644,CM021109.1,10,29378419,108136761,5428620,677644,108814405,99558364
29380870_755844,CM021109.1,10,29380870,108136939,5812067,755844,108892783,99636742
29380870_763391,CM021109.1,10,29380870,108136939,5812067,763391,108900330,99644289
29380870_763658,CM021109.1,10,29380870,108136939,5812067,763658,108900597,99644556
29377317_861011,CM021109.1,10,29377317,108136117,2836781,861011,108997128,99741087
29377402_6509376,CM021109.1,10,29377402,102565049,6893483,6509376,109074425,99818384
29377402_6519390,CM021109.1,10,29377402,102565049,6893483,6519390,109084439,99828398
29377402_6676847,CM021109.1,10,29377402,102565049,6893483,6676847,109241896,99985855
29377402_6682690,CM021109.1,10,29377402,102565049,6893483,6682690,109247739,99991698
29377402_6682700,CM021109.1,10,29377402,102565049,6893483,6682700,109247749,99991708
29377402_6697879,CM021109.1,10,29377402,102565049,6893483,6697879,109262928,100006887
29378419_1222009,CM021109.1,10,29378419,108136761,5428620,1222009,109358770,100102729
29378419_1222055,CM021109.1,10,29378419,108136761,5428620,1222055,109358816,100102775
29381743_1314504,CM021109.1,10,29381743,108136945,3165330,1314504,109451449,100195408
29380870_1317841,CM021109.1,10,29380870,108136939,5812067,1317841,109454780,100198739
29382418_1485678,CM021109.1,10,29382418,108136504,4967799,1485678,109622182,100366141
29382418_1485719,CM021109.1,10,29382418,108136504,4967799,1485719,109622223,100366182
29380870_1533138,CM021109.1,10,29380870,108136939,5812067,1533138,109670077,100414036
29380870_1533172,CM021109.1,10,29380870,108136939,5812067,1533172,109670111,100414070
29381743_1756464,CM021109.1,10,29381743,108136945,3165330,1756464,109893409,100637368
29381743_1756479,CM021109.1,10,29381743,108136945,3165330,1756479,109893424,100637383
29381743_1756980,CM021109.1,10,29381743,108136945,3165330,1756980,109893925,100637884
29381743_1781509,CM021109.1,10,29381743,108136945,3165330,1781509,109918454,100662413
29381743_1920983,CM021109.1,10,29381743,108136945,3165330,1920983,110057928,100801887
29381743_1921009,CM021109.1,10,29381743,108136945,3165330,1921009,110057954,100801913
29381743_1921015,CM021109.1,10,29381743,108136945,3165330,1921015,110057960,100801919
29381743_1921064,CM021109.1,10,29381743,108136945,3165330,1921064,110058009,100801968
29381743_1921142,CM021109.1,10,29381743,108136945,3165330,1921142,110058087,100802046
29382418_1945534,CM021109.1,10,29382418,108136504,4967799,1945534,110082038,100825997
29382418_1945565,CM021109.1,10,29382418,108136504,4967799,1945565,110082069,100826028
29382418_1945715,CM021109.1,10,29382418,108136504,4967799,1945715,110082219,100826178
29380870_2226920,CM021109.1,10,29380870,108136939,5812067,2226920,110363859,101107818
29378419_2294348,CM021109.1,10,29378419,108136761,5428620,2294348,110431109,101175068
29381743_2362819,CM021109.1,10,29381743,108136945,3165330,2362819,110499764,101243723
29381743_2422095,CM021109.1,10,29381743,108136945,3165330,2422095,110559040,101302999
29381743_2509432,CM021109.1,10,29381743,108136945,3165330,2509432,110646377,101390336
29381743_2509462,CM021109.1,10,29381743,108136945,3165330,2509462,110646407,101390366
29381743_2698401,CM021109.1,10,29381743,108136945,3165330,2698401,110835346,101579305
29381743_2698429,CM021109.1,10,29381743,108136945,3165330,2698429,110835374,101579333
29381743_2698498,CM021109.1,10,29381743,108136945,3165330,2698498,110835443,101579402
29381743_2698499,CM021109.1,10,29381743,108136945,3165330,2698499,110835444,101579403
29380870_2701525,CM021109.1,10,29380870,108136939,5812067,2701525,110838464,101582423
29380870_2701545,CM021109.1,10,29380870,108136939,5812067,2701545,110838484,101582443
29381743_2766220,CM021109.1,10,29381743,108136945,3165330,2766220,110903165,101647124
29381743_2766239,CM021109.1,10,29381743,108136945,3165330,2766239,110903184,101647143
29381743_2766274,CM021109.1,10,29381743,108136945,3165330,2766274,110903219,101647178
29381743_2766312,CM021109.1,10,29381743,108136945,3165330,2766312,110903257,101647216
29381743_2766323,CM021109.1,10,29381743,108136945,3165330,2766323,110903268,101647227
29381743_2766406,CM021109.1,10,29381743,108136945,3165330,2766406,110903351,101647310
29378985_2766349,CM021109.1,10,29378985,108137285,4316601,2766349,110903634,101647593
29378985_2766363,CM021109.1,10,29378985,108137285,4316601,2766363,110903648,101647607
29380870_2853487,CM021109.1,10,29380870,108136939,5812067,2853487,110990426,101734385
29380870_2872571,CM021109.1,10,29380870,108136939,5812067,2872571,111009510,101753469
29380870_2895555,CM021109.1,10,29380870,108136939,5812067,2895555,111032494,101776453
29380870_2895647,CM021109.1,10,29380870,108136939,5812067,2895647,111032586,101776545
29380870_2953191,CM021109.1,10,29380870,108136939,5812067,2953191,111090130,101834089
29380870_2953414,CM021109.1,10,29380870,108136939,5812067,2953414,111090353,101834312
29380870_2953469,CM021109.1,10,29380870,108136939,5812067,2953469,111090408,101834367
29380870_2953530,CM021109.1,10,29380870,108136939,5812067,2953530,111090469,101834428
29381743_2964069,CM021109.1,10,29381743,108136945,3165330,2964069,111101014,101844973
29381743_3121774,CM021109.1,10,29381743,108136945,3165330,3121774,111258719,102002678
29382418_3532914,CM021109.1,10,29382418,108136504,4967799,3532914,111669418,102413377
29382418_3668514,CM021109.1,10,29382418,108136504,4967799,3668514,111805018,102548977
29382418_3668544,CM021109.1,10,29382418,108136504,4967799,3668544,111805048,102549007
29382418_3701998,CM021109.1,10,29382418,108136504,4967799,3701998,111838502,102582461
29382418_3702006,CM021109.1,10,29382418,108136504,4967799,3702006,111838510,102582469
29382418_3702016,CM021109.1,10,29382418,108136504,4967799,3702016,111838520,102582479
29382418_3702027,CM021109.1,10,29382418,108136504,4967799,3702027,111838531,102582490
29382418_3702041,CM021109.1,10,29382418,108136504,4967799,3702041,111838545,102582504
29382418_3749650,CM021109.1,10,29382418,108136504,4967799,3749650,111886154,102630113
29382418_3749677,CM021109.1,10,29382418,108136504,4967799,3749677,111886181,102630140
29382418_3749694,CM021109.1,10,29382418,108136504,4967799,3749694,111886198,102630157
29382418_3749753,CM021109.1,10,29382418,108136504,4967799,3749753,111886257,102630216
29382418_3750401,CM021109.1,10,29382418,108136504,4967799,3750401,111886905,102630864
29382418_3750428,CM021109.1,10,29382418,108136504,4967799,3750428,111886932,102630891
29382418_3750443,CM021109.1,10,29382418,108136504,4967799,3750443,111886947,102630906
29382418_3844393,CM021109.1,10,29382418,108136504,4967799,3844393,111980897,102724856
29382418_3844420,CM021109.1,10,29382418,108136504,4967799,3844420,111980924,102724883
29378985_3941845,CM021109.1,10,29378985,108137285,4316601,3941845,112079130,102823089
29382418_4037352,CM021109.1,10,29382418,108136504,4967799,4037352,112173856,102917815
29382418_4037486,CM021109.1,10,29382418,108136504,4967799,4037486,112173990,102917949
29382418_4497441,CM021109.1,10,29382418,108136504,4967799,4497441,112633945,103377904
29382418_4497518,CM021109.1,10,29382418,108136504,4967799,4497518,112634022,103377981
29380870_5109113,CM021109.1,10,29380870,108136939,5812067,5109113,113246052,103990011
29380870_5806860,CM021109.1,10,29380870,108136939,5812067,5806860,113943799,104687758
29380870_5806941,CM021109.1,10,29380870,108136939,5812067,5806941,113943880,104687839
29380870_5811044,CM021109.1,10,29380870,108136939,5812067,5811044,113947983,104691942
29380870_5811052,CM021109.1,10,29380870,108136939,5812067,5811052,113947991,104691950
29380870_5811072,CM021109.1,10,29380870,108136939,5812067,5811072,113948011,104691970
29380870_5811074,CM021109.1,10,29380870,108136939,5812067,5811074,113948013,104691972
29380870_5811088,CM021109.1,10,29380870,108136939,5812067,5811088,113948027,104691986
29380796_31845,CM021109.1,10,29380796,132402292,38051,31845,132434137,123178096
29377478_170332,CM021109.1,10,29377478,132402286,2007660,170332,132572618,123316577
29377478_170424,CM021109.1,10,29377478,132402286,2007660,170424,132572710,123316669
29377906_213059,CM021109.1,10,29377906,132402295,1495513,213059,132615354,123359313
29377906_213062,CM021109.1,10,29377906,132402295,1495513,213062,132615357,123359316
29377156_258313,CM021109.1,10,29377156,132404827,1031126,258313,132663140,123407099
29377741_293478,CM021109.1,10,29377741,132402293,963771,293478,132695771,123439730
29377478_297948,CM021109.1,10,29377478,132402286,2007660,297948,132700234,123444193
29377741_318627,CM021109.1,10,29377741,132402293,963771,318627,132720920,123464879
29377741_318707,CM021109.1,10,29377741,132402293,963771,318707,132721000,123464959
29381176_385867,CM021109.1,10,29381176,132402291,1878957,385867,132788158,123532117
29381176_385889,CM021109.1,10,29381176,132402291,1878957,385889,132788180,123532139
29381176_408228,CM021109.1,10,29381176,132402291,1878957,408228,132810519,123554478
29381176_408252,CM021109.1,10,29381176,132402291,1878957,408252,132810543,123554502
29381176_433968,CM021109.1,10,29381176,132402291,1878957,433968,132836259,123580218
29377503_438574,CM021109.1,10,29377503,132403905,1367046,438574,132842479,123586438
29377503_438612,CM021109.1,10,29377503,132403905,1367046,438612,132842517,123586476
29377503_438628,CM021109.1,10,29377503,132403905,1367046,438628,132842533,123586492
29377478_449535,CM021109.1,10,29377478,132402286,2007660,449535,132851821,123595780
29377478_449611,CM021109.1,10,29377478,132402286,2007660,449611,132851897,123595856
29381176_455621,CM021109.1,10,29381176,132402291,1878957,455621,132857912,123601871
29381176_455645,CM021109.1,10,29381176,132402291,1878957,455645,132857936,123601895
29381176_455720,CM021109.1,10,29381176,132402291,1878957,455720,132858011,123601970
29381176_458737,CM021109.1,10,29381176,132402291,1878957,458737,132861028,123604987
29381176_460127,CM021109.1,10,29381176,132402291,1878957,460127,132862418,123606377
29381176_464348,CM021109.1,10,29381176,132402291,1878957,464348,132866639,123610598
29377478_487512,CM021109.1,10,29377478,132402286,2007660,487512,132889798,123633757
29377478_487581,CM021109.1,10,29377478,132402286,2007660,487581,132889867,123633826
29379191_536103,CM021109.1,10,29379191,132404342,2731935,536103,132940445,123684404
29379191_536201,CM021109.1,10,29379191,132404342,2731935,536201,132940543,123684502
29379896_569514,CM021109.1,10,29379896,132402285,5826892,569514,132971799,123715758
29379896_569531,CM021109.1,10,29379896,132402285,5826892,569531,132971816,123715775
29379896_569541,CM021109.1,10,29379896,132402285,5826892,569541,132971826,123715785
29379896_569549,CM021109.1,10,29379896,132402285,5826892,569549,132971834,123715793
29379896_569557,CM021109.1,10,29379896,132402285,5826892,569557,132971842,123715801
29381176_575964,CM021109.1,10,29381176,132402291,1878957,575964,132978255,123722214
29377741_618007,CM021109.1,10,29377741,132402293,963771,618007,133020300,123764259
29377741_618062,CM021109.1,10,29377741,132402293,963771,618062,133020355,123764314
29377741_618075,CM021109.1,10,29377741,132402293,963771,618075,133020368,123764327
29379160_623671,CM021109.1,10,29379160,132402293,5580296,623671,133025964,123769923
29377503_625938,CM021109.1,10,29377503,132403905,1367046,625938,133029843,123773802
29377906_633751,CM021109.1,10,29377906,132402295,1495513,633751,133036046,123780005
29377906_684142,CM021109.1,10,29377906,132402295,1495513,684142,133086437,123830396
29382252_712709,CM021109.1,10,29382252,132405063,729290,712709,133117772,123861731
29382252_712724,CM021109.1,10,29382252,132405063,729290,712724,133117787,123861746
29382252_712725,CM021109.1,10,29382252,132405063,729290,712725,133117788,123861747
29382252_712729,CM021109.1,10,29382252,132405063,729290,712729,133117792,123861751
29382252_712860,CM021109.1,10,29382252,132405063,729290,712860,133117923,123861882
29377478_880956,CM021109.1,10,29377478,132402286,2007660,880956,133283242,124027201
29377478_880987,CM021109.1,10,29377478,132402286,2007660,880987,133283273,124027232
29377478_881015,CM021109.1,10,29377478,132402286,2007660,881015,133283301,124027260
29377478_895232,CM021109.1,10,29377478,132402286,2007660,895232,133297518,124041477
29377478_895289,CM021109.1,10,29377478,132402286,2007660,895289,133297575,124041534
29377478_895331,CM021109.1,10,29377478,132402286,2007660,895331,133297617,124041576
29377478_895469,CM021109.1,10,29377478,132402286,2007660,895469,133297755,124041714
29377478_895800,CM021109.1,10,29377478,132402286,2007660,895800,133298086,124042045
29377478_895815,CM021109.1,10,29377478,132402286,2007660,895815,133298101,124042060
29377478_895840,CM021109.1,10,29377478,132402286,2007660,895840,133298126,124042085
29377300_916941,CM021109.1,10,29377300,132403284,1376268,916941,133320225,124064184
29377503_1006839,CM021109.1,10,29377503,132403905,1367046,1006839,133410744,124154703
29377300_1150518,CM021109.1,10,29377300,132403284,1376268,1150518,133553802,124297761
29377300_1150545,CM021109.1,10,29377300,132403284,1376268,1150545,133553829,124297788
29380563_1291025,CM021109.1,10,29380563,132402291,2945451,1291025,133693316,124437275
29377503_1289971,CM021109.1,10,29377503,132403905,1367046,1289971,133693876,124437835
29379896_1368684,CM021109.1,10,29379896,132402285,5826892,1368684,133770969,124514928
29379896_1369242,CM021109.1,10,29379896,132402285,5826892,1369242,133771527,124515486
29379896_1369245,CM021109.1,10,29379896,132402285,5826892,1369245,133771530,124515489
29379896_1473795,CM021109.1,10,29379896,132402285,5826892,1473795,133876080,124620039
29379896_1473815,CM021109.1,10,29379896,132402285,5826892,1473815,133876100,124620059
29381176_1594973,CM021109.1,10,29381176,132402291,1878957,1594973,133997264,124741223
29378743_1796103,CM021109.1,10,29378743,132402291,3108563,1796103,134198394,124942353
29381176_1818811,CM021109.1,10,29381176,132402291,1878957,1818811,134221102,124965061
29381176_1818845,CM021109.1,10,29381176,132402291,1878957,1818845,134221136,124965095
29379896_1861311,CM021109.1,10,29379896,132402285,5826892,1861311,134263596,125007555
29379896_1861328,CM021109.1,10,29379896,132402285,5826892,1861328,134263613,125007572
29379191_1959781,CM021109.1,10,29379191,132404342,2731935,1959781,134364123,125108082
29379191_1959862,CM021109.1,10,29379191,132404342,2731935,1959862,134364204,125108163
29377165_2014386,CM021109.1,10,29377165,132402293,5778011,2014386,134416679,125160638
29379896_2081671,CM021109.1,10,29379896,132402285,5826892,2081671,134483956,125227915
29379896_2081716,CM021109.1,10,29379896,132402285,5826892,2081716,134484001,125227960
29379896_2081744,CM021109.1,10,29379896,132402285,5826892,2081744,134484029,125227988
29379896_2099834,CM021109.1,10,29379896,132402285,5826892,2099834,134502119,125246078
29379896_2099845,CM021109.1,10,29379896,132402285,5826892,2099845,134502130,125246089
29379896_2102832,CM021109.1,10,29379896,132402285,5826892,2102832,134505117,125249076
29379896_2102838,CM021109.1,10,29379896,132402285,5826892,2102838,134505123,125249082
29379896_2102845,CM021109.1,10,29379896,132402285,5826892,2102845,134505130,125249089
29379896_2102852,CM021109.1,10,29379896,132402285,5826892,2102852,134505137,125249096
29379896_2102879,CM021109.1,10,29379896,132402285,5826892,2102879,134505164,125249123
29379896_2102881,CM021109.1,10,29379896,132402285,5826892,2102881,134505166,125249125
29379896_2102969,CM021109.1,10,29379896,132402285,5826892,2102969,134505254,125249213
29379191_2217528,CM021109.1,10,29379191,132404342,2731935,2217528,134621870,125365829
29379191_2217530,CM021109.1,10,29379191,132404342,2731935,2217530,134621872,125365831
29379191_2217684,CM021109.1,10,29379191,132404342,2731935,2217684,134622026,125365985
29379191_2217740,CM021109.1,10,29379191,132404342,2731935,2217740,134622082,125366041
29379191_2217742,CM021109.1,10,29379191,132404342,2731935,2217742,134622084,125366043
29379191_2217752,CM021109.1,10,29379191,132404342,2731935,2217752,134622094,125366053
29379191_2218270,CM021109.1,10,29379191,132404342,2731935,2218270,134622612,125366571
29379191_2218310,CM021109.1,10,29379191,132404342,2731935,2218310,134622652,125366611
29379191_2218334,CM021109.1,10,29379191,132404342,2731935,2218334,134622676,125366635
29379191_2218345,CM021109.1,10,29379191,132404342,2731935,2218345,134622687,125366646
29379191_2218828,CM021109.1,10,29379191,132404342,2731935,2218828,134623170,125367129
29379191_2218858,CM021109.1,10,29379191,132404342,2731935,2218858,134623200,125367159
29379191_2218860,CM021109.1,10,29379191,132404342,2731935,2218860,134623202,125367161
29379191_2218900,CM021109.1,10,29379191,132404342,2731935,2218900,134623242,125367201
29379191_2218927,CM021109.1,10,29379191,132404342,2731935,2218927,134623269,125367228
29379191_2218943,CM021109.1,10,29379191,132404342,2731935,2218943,134623285,125367244
29379191_2218947,CM021109.1,10,29379191,132404342,2731935,2218947,134623289,125367248
29379191_2218951,CM021109.1,10,29379191,132404342,2731935,2218951,134623293,125367252
29379191_2218961,CM021109.1,10,29379191,132404342,2731935,2218961,134623303,125367262
29379191_2218976,CM021109.1,10,29379191,132404342,2731935,2218976,134623318,125367277
29379191_2219058,CM021109.1,10,29379191,132404342,2731935,2219058,134623400,125367359
29379896_2453804,CM021109.1,10,29379896,132402285,5826892,2453804,134856089,125600048
29379896_2508175,CM021109.1,10,29379896,132402285,5826892,2508175,134910460,125654419
29379896_2545298,CM021109.1,10,29379896,132402285,5826892,2545298,134947583,125691542
29379896_2804631,CM021109.1,10,29379896,132402285,5826892,2804631,135206916,125950875
29379896_2804751,CM021109.1,10,29379896,132402285,5826892,2804751,135207036,125950995
29379160_2807047,CM021109.1,10,29379160,132402293,5580296,2807047,135209340,125953299
29379160_2928524,CM021109.1,10,29379160,132402293,5580296,2928524,135330817,126074776
29379160_2928544,CM021109.1,10,29379160,132402293,5580296,2928544,135330837,126074796
29379896_3049701,CM021109.1,10,29379896,132402285,5826892,3049701,135451986,126195945
29379896_3761897,CM021109.1,10,29379896,132402285,5826892,3761897,136164182,126908141
29379896_3761922,CM021109.1,10,29379896,132402285,5826892,3761922,136164207,126908166
29379896_3762006,CM021109.1,10,29379896,132402285,5826892,3762006,136164291,126908250
29379160_3936786,CM021109.1,10,29379160,132402293,5580296,3936786,136339079,127083038
29379160_3936825,CM021109.1,10,29379160,132402293,5580296,3936825,136339118,127083077
29379160_4233441,CM021109.1,10,29379160,132402293,5580296,4233441,136635734,127379693
29379160_4233469,CM021109.1,10,29379160,132402293,5580296,4233469,136635762,127379721
29379160_4233471,CM021109.1,10,29379160,132402293,5580296,4233471,136635764,127379723
29379160_4233497,CM021109.1,10,29379160,132402293,5580296,4233497,136635790,127379749
29379160_4233507,CM021109.1,10,29379160,132402293,5580296,4233507,136635800,127379759
29379160_4233531,CM021109.1,10,29379160,132402293,5580296,4233531,136635824,127379783
29379160_4233574,CM021109.1,10,29379160,132402293,5580296,4233574,136635867,127379826
29379160_4233608,CM021109.1,10,29379160,132402293,5580296,4233608,136635901,127379860
29379160_4233743,CM021109.1,10,29379160,132402293,5580296,4233743,136636036,127379995
29379160_4233758,CM021109.1,10,29379160,132402293,5580296,4233758,136636051,127380010
29379160_4233775,CM021109.1,10,29379160,132402293,5580296,4233775,136636068,127380027
29379160_4233816,CM021109.1,10,29379160,132402293,5580296,4233816,136636109,127380068
29379160_4233844,CM021109.1,10,29379160,132402293,5580296,4233844,136636137,127380096
29379896_4524690,CM021109.1,10,29379896,132402285,5826892,4524690,136926975,127670934
29379896_4524735,CM021109.1,10,29379896,132402285,5826892,4524735,136927020,127670979
29379160_4673250,CM021109.1,10,29379160,132402293,5580296,4673250,137075543,127819502
29379160_4673401,CM021109.1,10,29379160,132402293,5580296,4673401,137075694,127819653
29379160_4910159,CM021109.1,10,29379160,132402293,5580296,4910159,137312452,128056411
29379160_4910164,CM021109.1,10,29379160,132402293,5580296,4910164,137312457,128056416
29379160_5112799,CM021109.1,10,29379160,132402293,5580296,5112799,137515092,128259051
29379160_5112815,CM021109.1,10,29379160,132402293,5580296,5112815,137515108,128259067
29379160_5112842,CM021109.1,10,29379160,132402293,5580296,5112842,137515135,128259094
29379160_5112898,CM021109.1,10,29379160,132402293,5580296,5112898,137515191,128259150
29379160_5317641,CM021109.1,10,29379160,132402293,5580296,5317641,137719934,128463893
29379160_5317663,CM021109.1,10,29379160,132402293,5580296,5317663,137719956,128463915
29379160_5317666,CM021109.1,10,29379160,132402293,5580296,5317666,137719959,128463918
29379160_5317667,CM021109.1,10,29379160,132402293,5580296,5317667,137719960,128463919
29210653_866,CM021109.1,10,29210653,138928287,5154,866,138929153,129673112
29377205_30035,CM021109.1,10,29377205,153903462,735607,30035,153933497,144677456
29377205_30036,CM021109.1,10,29377205,153903462,735607,30036,153933498,144677457
29377205_30055,CM021109.1,10,29377205,153903462,735607,30055,153933517,144677476
29377205_30100,CM021109.1,10,29377205,153903462,735607,30100,153933562,144677521
29377205_30119,CM021109.1,10,29377205,153903462,735607,30119,153933581,144677540
29377205_30160,CM021109.1,10,29377205,153903462,735607,30160,153933622,144677581
29377205_30238,CM021109.1,10,29377205,153903462,735607,30238,153933700,144677659
29377205_30267,CM021109.1,10,29377205,153903462,735607,30267,153933729,144677688
29382193_37632,CM021109.1,10,29382193,153904328,3017257,37632,153941960,144685919
29382193_41909,CM021109.1,10,29382193,153904328,3017257,41909,153946237,144690196
29382193_42028,CM021109.1,10,29382193,153904328,3017257,42028,153946356,144690315
29379981_57727,CM021109.1,10,29379981,153903461,356231,57727,153961188,144705147
29379981_57731,CM021109.1,10,29379981,153903461,356231,57731,153961192,144705151
29379981_57747,CM021109.1,10,29379981,153903461,356231,57747,153961208,144705167
29379981_57771,CM021109.1,10,29379981,153903461,356231,57771,153961232,144705191
29379981_57779,CM021109.1,10,29379981,153903461,356231,57779,153961240,144705199
29379981_57796,CM021109.1,10,29379981,153903461,356231,57796,153961257,144705216
29379981_57802,CM021109.1,10,29379981,153903461,356231,57802,153961263,144705222
29379981_57827,CM021109.1,10,29379981,153903461,356231,57827,153961288,144705247
29379981_57848,CM021109.1,10,29379981,153903461,356231,57848,153961309,144705268
29379981_57861,CM021109.1,10,29379981,153903461,356231,57861,153961322,144705281
29379981_57888,CM021109.1,10,29379981,153903461,356231,57888,153961349,144705308
29379981_57936,CM021109.1,10,29379981,153903461,356231,57936,153961397,144705356
29379981_57956,CM021109.1,10,29379981,153903461,356231,57956,153961417,144705376
29379981_57978,CM021109.1,10,29379981,153903461,356231,57978,153961439,144705398
29377205_64775,CM021109.1,10,29377205,153903462,735607,64775,153968237,144712196
29377205_64836,CM021109.1,10,29377205,153903462,735607,64836,153968298,144712257
29377205_65077,CM021109.1,10,29377205,153903462,735607,65077,153968539,144712498
29377205_65092,CM021109.1,10,29377205,153903462,735607,65092,153968554,144712513
29377205_65093,CM021109.1,10,29377205,153903462,735607,65093,153968555,144712514
29377205_65142,CM021109.1,10,29377205,153903462,735607,65142,153968604,144712563
29377205_65144,CM021109.1,10,29377205,153903462,735607,65144,153968606,144712565
29378336_65220,CM021109.1,10,29378336,153904165,946576,65220,153969385,144713344
29382193_77935,CM021109.1,10,29382193,153904328,3017257,77935,153982263,144726222
29382193_78038,CM021109.1,10,29382193,153904328,3017257,78038,153982366,144726325
29380055_97702,CM021109.1,10,29380055,153904300,695221,97702,154002002,144745961
29377205_102611,CM021109.1,10,29377205,153903462,735607,102611,154006073,144750032
29377205_102674,CM021109.1,10,29377205,153903462,735607,102674,154006136,144750095
29380653_119644,CM021109.1,10,29380653,153903462,2008969,119644,154023106,144767065
29380653_119733,CM021109.1,10,29380653,153903462,2008969,119733,154023195,144767154
29380653_119741,CM021109.1,10,29380653,153903462,2008969,119741,154023203,144767162
29380653_119752,CM021109.1,10,29380653,153903462,2008969,119752,154023214,144767173
29377205_131375,CM021109.1,10,29377205,153903462,735607,131375,154034837,144778796
29377205_131464,CM021109.1,10,29377205,153903462,735607,131464,154034926,144778885
29377205_132070,CM021109.1,10,29377205,153903462,735607,132070,154035532,144779491
29377205_132093,CM021109.1,10,29377205,153903462,735607,132093,154035555,144779514
29377205_137499,CM021109.1,10,29377205,153903462,735607,137499,154040961,144784920
29377205_137506,CM021109.1,10,29377205,153903462,735607,137506,154040968,144784927
29377205_137706,CM021109.1,10,29377205,153903462,735607,137706,154041168,144785127
29377205_137714,CM021109.1,10,29377205,153903462,735607,137714,154041176,144785135
29377205_137725,CM021109.1,10,29377205,153903462,735607,137725,154041187,144785146
29378336_179070,CM021109.1,10,29378336,153904165,946576,179070,154083235,144827194
29378336_179708,CM021109.1,10,29378336,153904165,946576,179708,154083873,144827832
29382193_186286,CM021109.1,10,29382193,153904328,3017257,186286,154090614,144834573
29382193_186358,CM021109.1,10,29382193,153904328,3017257,186358,154090686,144834645
29378336_212307,CM021109.1,10,29378336,153904165,946576,212307,154116472,144860431
29377205_225272,CM021109.1,10,29377205,153903462,735607,225272,154128734,144872693
29379601_232798,CM021109.1,10,29379601,153903460,1092898,232798,154136258,144880217
29379601_232811,CM021109.1,10,29379601,153903460,1092898,232811,154136271,144880230
29379601_232813,CM021109.1,10,29379601,153903460,1092898,232813,154136273,144880232
29379601_232856,CM021109.1,10,29379601,153903460,1092898,232856,154136316,144880275
29379601_232880,CM021109.1,10,29379601,153903460,1092898,232880,154136340,144880299
29379601_232894,CM021109.1,10,29379601,153903460,1092898,232894,154136354,144880313
29379601_232902,CM021109.1,10,29379601,153903460,1092898,232902,154136362,144880321
29379601_232903,CM021109.1,10,29379601,153903460,1092898,232903,154136363,144880322
29381038_247183,CM021109.1,10,29381038,153903461,1517681,247183,154150644,144894603
29377205_252798,CM021109.1,10,29377205,153903462,735607,252798,154156260,144900219
29378336_263030,CM021109.1,10,29378336,153904165,946576,263030,154167195,144911154
29378336_263032,CM021109.1,10,29378336,153904165,946576,263032,154167197,144911156
29378336_263036,CM021109.1,10,29378336,153904165,946576,263036,154167201,144911160
29378336_263037,CM021109.1,10,29378336,153904165,946576,263037,154167202,144911161
29378336_263042,CM021109.1,10,29378336,153904165,946576,263042,154167207,144911166
29378336_263055,CM021109.1,10,29378336,153904165,946576,263055,154167220,144911179
29378336_263117,CM021109.1,10,29378336,153904165,946576,263117,154167282,144911241
29378336_263118,CM021109.1,10,29378336,153904165,946576,263118,154167283,144911242
29378336_263126,CM021109.1,10,29378336,153904165,946576,263126,154167291,144911250
29378336_263138,CM021109.1,10,29378336,153904165,946576,263138,154167303,144911262
29378336_263192,CM021109.1,10,29378336,153904165,946576,263192,154167357,144911316
29378336_263224,CM021109.1,10,29378336,153904165,946576,263224,154167389,144911348
29378336_263248,CM021109.1,10,29378336,153904165,946576,263248,154167413,144911372
29378336_263502,CM021109.1,10,29378336,153904165,946576,263502,154167667,144911626
29378305_292308,CM021109.1,10,29378305,153904040,1208485,292308,154196348,144940307
29378305_292402,CM021109.1,10,29378305,153904040,1208485,292402,154196442,144940401
29381038_298168,CM021109.1,10,29381038,153903461,1517681,298168,154201629,144945588
29378882_308915,CM021109.1,10,29378882,153904139,1234524,308915,154213054,144957013
29378882_308941,CM021109.1,10,29378882,153904139,1234524,308941,154213080,144957039
29378882_308962,CM021109.1,10,29378882,153904139,1234524,308962,154213101,144957060
29378882_309015,CM021109.1,10,29378882,153904139,1234524,309015,154213154,144957113
29381530_317671,CM021109.1,10,29381530,153903460,674361,317671,154221131,144965090
29378336_350025,CM021109.1,10,29378336,153904165,946576,350025,154254190,144998149
29378336_350027,CM021109.1,10,29378336,153904165,946576,350027,154254192,144998151
29378336_350036,CM021109.1,10,29378336,153904165,946576,350036,154254201,144998160
29381038_412888,CM021109.1,10,29381038,153903461,1517681,412888,154316349,145060308
29380055_415915,CM021109.1,10,29380055,153904300,695221,415915,154320215,145064174
29378336_478689,CM021109.1,10,29378336,153904165,946576,478689,154382854,145126813
29378336_478690,CM021109.1,10,29378336,153904165,946576,478690,154382855,145126814
29377205_488358,CM021109.1,10,29377205,153903462,735607,488358,154391820,145135779
29377205_488378,CM021109.1,10,29377205,153903462,735607,488378,154391840,145135799
29377205_488864,CM021109.1,10,29377205,153903462,735607,488864,154392326,145136285
29377205_557469,CM021109.1,10,29377205,153903462,735607,557469,154460931,145204890
29377205_557581,CM021109.1,10,29377205,153903462,735607,557581,154461043,145205002
29377205_578731,CM021109.1,10,29377205,153903462,735607,578731,154482193,145226152
29377205_580306,CM021109.1,10,29377205,153903462,735607,580306,154483768,145227727
29377205_580388,CM021109.1,10,29377205,153903462,735607,580388,154483850,145227809
29378063_588741,CM021109.1,10,29378063,153904068,766714,588741,154492809,145236768
29378063_588743,CM021109.1,10,29378063,153904068,766714,588743,154492811,145236770
29381530_601409,CM021109.1,10,29381530,153903460,674361,601409,154504869,145248828
29381530_601419,CM021109.1,10,29381530,153903460,674361,601419,154504879,145248838
29381530_601520,CM021109.1,10,29381530,153903460,674361,601520,154504980,145248939
29379601_619994,CM021109.1,10,29379601,153903460,1092898,619994,154523454,145267413
29379601_620007,CM021109.1,10,29379601,153903460,1092898,620007,154523467,145267426
29379601_620133,CM021109.1,10,29379601,153903460,1092898,620133,154523593,145267552
29381530_635951,CM021109.1,10,29381530,153903460,674361,635951,154539411,145283370
29381530_636023,CM021109.1,10,29381530,153903460,674361,636023,154539483,145283442
29381530_642816,CM021109.1,10,29381530,153903460,674361,642816,154546276,145290235
29381530_642869,CM021109.1,10,29381530,153903460,674361,642869,154546329,145290288
29381530_642888,CM021109.1,10,29381530,153903460,674361,642888,154546348,145290307
29378305_964817,CM021109.1,10,29378305,153904040,1208485,964817,154868857,145612816
29378305_1002059,CM021109.1,10,29378305,153904040,1208485,1002059,154906099,145650058
29379639_1127408,CM021109.1,10,29379639,153903462,1662107,1127408,155030870,145774829
29379639_1127623,CM021109.1,10,29379639,153903462,1662107,1127623,155031085,145775044
29379639_1130994,CM021109.1,10,29379639,153903462,1662107,1130994,155034456,145778415
29380653_1329882,CM021109.1,10,29380653,153903462,2008969,1329882,155233344,145977303
29380653_1329966,CM021109.1,10,29380653,153903462,2008969,1329966,155233428,145977387
29382193_1366404,CM021109.1,10,29382193,153904328,3017257,1366404,155270732,146014691
29380653_1507361,CM021109.1,10,29380653,153903462,2008969,1507361,155410823,146154782
29382193_1601322,CM021109.1,10,29382193,153904328,3017257,1601322,155505650,146249609
29382193_2057017,CM021109.1,10,29382193,153904328,3017257,2057017,155961345,146705304
29382193_2057140,CM021109.1,10,29382193,153904328,3017257,2057140,155961468,146705427
29382193_2057145,CM021109.1,10,29382193,153904328,3017257,2057145,155961473,146705432
29382193_2057156,CM021109.1,10,29382193,153904328,3017257,2057156,155961484,146705443
29382193_2057166,CM021109.1,10,29382193,153904328,3017257,2057166,155961494,146705453
29382193_2057192,CM021109.1,10,29382193,153904328,3017257,2057192,155961520,146705479
29382193_2057217,CM021109.1,10,29382193,153904328,3017257,2057217,155961545,146705504
29382193_2057223,CM021109.1,10,29382193,153904328,3017257,2057223,155961551,146705510
29382193_2057229,CM021109.1,10,29382193,153904328,3017257,2057229,155961557,146705516
29381940_14859,CM021109.1,10,29381940,183170075,3509478,14859,183184934,173928893
29381107_4783,CM021109.1,10,29381107,183200980,289498,4783,183205763,173949722
293717531_11839,CM021109.1,10,293717531,183200119,292038,11839,183211958,173955917
293717531_12214,CM021109.1,10,293717531,183200119,292038,12214,183212333,173956292
29380604_48141,CM021109.1,10,29380604,183200119,1351487,48141,183248260,173992219
29380604_50036,CM021109.1,10,29380604,183200119,1351487,50036,183250155,173994114
29380604_50105,CM021109.1,10,29380604,183200119,1351487,50105,183250224,173994183
29373068_88971,CM021109.1,10,29373068,183170076,144973,88971,183259047,174003006
29380012_73455,CM021109.1,10,29380012,183200119,1326742,73455,183273574,174017533
29380012_73462,CM021109.1,10,29380012,183200119,1326742,73462,183273581,174017540
29379110_77956,CM021109.1,10,29379110,183200531,662188,77956,183278487,174022446
29379110_77976,CM021109.1,10,29379110,183200531,662188,77976,183278507,174022466
29379110_77982,CM021109.1,10,29379110,183200531,662188,77982,183278513,174022472
29379110_77986,CM021109.1,10,29379110,183200531,662188,77986,183278517,174022476
29379110_80531,CM021109.1,10,29379110,183200531,662188,80531,183281062,174025021
29379110_81306,CM021109.1,10,29379110,183200531,662188,81306,183281837,174025796
29377761_86211,CM021109.1,10,29377761,183201124,561547,86211,183287335,174031294
29377761_86428,CM021109.1,10,29377761,183201124,561547,86428,183287552,174031511
29381940_127860,CM021109.1,10,29381940,183170075,3509478,127860,183297935,174041894
29381940_127946,CM021109.1,10,29381940,183170075,3509478,127946,183298021,174041980
29381940_127997,CM021109.1,10,29381940,183170075,3509478,127997,183298072,174042031
29381940_127998,CM021109.1,10,29381940,183170075,3509478,127998,183298073,174042032
293717531_108511,CM021109.1,10,293717531,183200119,292038,108511,183308630,174052589
29380058_166283,CM021109.1,10,29380058,183200119,2585943,166283,183366402,174110361
293717531_190469,CM021109.1,10,293717531,183200119,292038,190469,183390588,174134547
293717531_190514,CM021109.1,10,293717531,183200119,292038,190514,183390633,174134592
29379372_241964,CM021109.1,10,29379372,183170076,437937,241964,183412040,174155999
29379372_241985,CM021109.1,10,29379372,183170076,437937,241985,183412061,174156020
29379372_241991,CM021109.1,10,29379372,183170076,437937,241991,183412067,174156026
29379372_242055,CM021109.1,10,29379372,183170076,437937,242055,183412131,174156090
29379372_242056,CM021109.1,10,29379372,183170076,437937,242056,183412132,174156091
29381636_245729,CM021109.1,10,29381636,183170075,6607304,245729,183415804,174159763
29381636_245822,CM021109.1,10,29381636,183170075,6607304,245822,183415897,174159856
29381636_247975,CM021109.1,10,29381636,183170075,6607304,247975,183418050,174162009
29381636_248052,CM021109.1,10,29381636,183170075,6607304,248052,183418127,174162086
29379372_257587,CM021109.1,10,29379372,183170076,437937,257587,183427663,174171622
29379149_252104,CM021109.1,10,29379149,183182985,804171,252104,183435089,174179048
29379149_252170,CM021109.1,10,29379149,183182985,804171,252170,183435155,174179114
29379149_252190,CM021109.1,10,29379149,183182985,804171,252190,183435175,174179134
29379149_252205,CM021109.1,10,29379149,183182985,804171,252205,183435190,174179149
29379149_252235,CM021109.1,10,29379149,183182985,804171,252235,183435220,174179179
29381636_268260,CM021109.1,10,29381636,183170075,6607304,268260,183438335,174182294
29381636_268262,CM021109.1,10,29381636,183170075,6607304,268262,183438337,174182296
29381636_278311,CM021109.1,10,29381636,183170075,6607304,278311,183448386,174192345
29381636_283052,CM021109.1,10,29381636,183170075,6607304,283052,183453127,174197086
29381636_284943,CM021109.1,10,29381636,183170075,6607304,284943,183455018,174198977
29381636_284979,CM021109.1,10,29381636,183170075,6607304,284979,183455054,174199013
29381636_284995,CM021109.1,10,29381636,183170075,6607304,284995,183455070,174199029
29379372_311151,CM021109.1,10,29379372,183170076,437937,311151,183481227,174225186
29379372_311218,CM021109.1,10,29379372,183170076,437937,311218,183481294,174225253
29379372_312808,CM021109.1,10,29379372,183170076,437937,312808,183482884,174226843
29379372_313632,CM021109.1,10,29379372,183170076,437937,313632,183483708,174227667
29377728_301717,CM021109.1,10,29377728,183200419,804284,301717,183502136,174246095
29377728_301726,CM021109.1,10,29377728,183200419,804284,301726,183502145,174246104
29378376_351538,CM021109.1,10,29378376,183200119,1542113,351538,183551657,174295616
29378376_351560,CM021109.1,10,29378376,183200119,1542113,351560,183551679,174295638
29378376_351589,CM021109.1,10,29378376,183200119,1542113,351589,183551708,174295667
29378707_353736,CM021109.1,10,29378707,183201338,584126,353736,183555074,174299033
29378707_353814,CM021109.1,10,29378707,183201338,584126,353814,183555152,174299111
29378707_353873,CM021109.1,10,29378707,183201338,584126,353873,183555211,174299170
29378707_354133,CM021109.1,10,29378707,183201338,584126,354133,183555471,174299430
29381636_421439,CM021109.1,10,29381636,183170075,6607304,421439,183591514,174335473
29381636_421442,CM021109.1,10,29381636,183170075,6607304,421442,183591517,174335476
29381636_421464,CM021109.1,10,29381636,183170075,6607304,421464,183591539,174335498
29381636_421465,CM021109.1,10,29381636,183170075,6607304,421465,183591540,174335499
29381636_421492,CM021109.1,10,29381636,183170075,6607304,421492,183591567,174335526
29381636_421509,CM021109.1,10,29381636,183170075,6607304,421509,183591584,174335543
29381636_421562,CM021109.1,10,29381636,183170075,6607304,421562,183591637,174335596
29381636_421569,CM021109.1,10,29381636,183170075,6607304,421569,183591644,174335603
29380422_424956,CM021109.1,10,29380422,183180081,7677979,424956,183605037,174348996
29380422_425033,CM021109.1,10,29380422,183180081,7677979,425033,183605114,174349073
29380422_425099,CM021109.1,10,29380422,183180081,7677979,425099,183605180,174349139
29380422_425123,CM021109.1,10,29380422,183180081,7677979,425123,183605204,174349163
29380422_425246,CM021109.1,10,29380422,183180081,7677979,425246,183605327,174349286
29380422_425327,CM021109.1,10,29380422,183180081,7677979,425327,183605408,174349367
29338535_27545,CM021109.1,10,29338535,183601879,36563,27545,183629424,174373383
29380828_440945,CM021109.1,10,29380828,183200119,965426,440945,183641064,174385023
29355190_173809,CM021109.1,10,29355190,183601388,695418,173809,183775197,174519156
29380113_627141,CM021109.1,10,29380113,183200119,1471603,627141,183827260,174571219
29380113_627173,CM021109.1,10,29380113,183200119,1471603,627173,183827292,174571251
29380113_627192,CM021109.1,10,29380113,183200119,1471603,627192,183827311,174571270
29380113_627200,CM021109.1,10,29380113,183200119,1471603,627200,183827319,174571278
29380113_627252,CM021109.1,10,29380113,183200119,1471603,627252,183827371,174571330
29380113_680288,CM021109.1,10,29380113,183200119,1471603,680288,183880407,174624366
29380113_680289,CM021109.1,10,29380113,183200119,1471603,680289,183880408,174624367
29380113_680355,CM021109.1,10,29380113,183200119,1471603,680355,183880474,174624433
29380113_680437,CM021109.1,10,29380113,183200119,1471603,680437,183880556,174624515
29380976_771670,CM021109.1,10,29380976,183180611,887543,771670,183952281,174696240
29380976_771690,CM021109.1,10,29380976,183180611,887543,771690,183952301,174696260
29378683_758228,CM021109.1,10,29378683,183200648,878979,758228,183958876,174702835
29378683_758279,CM021109.1,10,29378683,183200648,878979,758279,183958927,174702886
29378683_758348,CM021109.1,10,29378683,183200648,878979,758348,183958996,174702955
29380828_768014,CM021109.1,10,29380828,183200119,965426,768014,183968133,174712092
29378683_767558,CM021109.1,10,29378683,183200648,878979,767558,183968206,174712165
29378683_767569,CM021109.1,10,29378683,183200648,878979,767569,183968217,174712176
29380828_768121,CM021109.1,10,29380828,183200119,965426,768121,183968240,174712199
29378683_769045,CM021109.1,10,29378683,183200648,878979,769045,183969693,174713652
29378683_771832,CM021109.1,10,29378683,183200648,878979,771832,183972480,174716439
29380828_778690,CM021109.1,10,29380828,183200119,965426,778690,183978809,174722768
29378417_795834,CM021109.1,10,29378417,183188255,2501734,795834,183984089,174728048
29380422_819738,CM021109.1,10,29380422,183180081,7677979,819738,183999819,174743778
29380422_819780,CM021109.1,10,29380422,183180081,7677979,819780,183999861,174743820
29380422_819791,CM021109.1,10,29380422,183180081,7677979,819791,183999872,174743831
29378376_891266,CM021109.1,10,29378376,183200119,1542113,891266,184091385,174835344
29380604_905659,CM021109.1,10,29380604,183200119,1351487,905659,184105778,174849737
29380604_909125,CM021109.1,10,29380604,183200119,1351487,909125,184109244,174853203
29378348_941406,CM021109.1,10,29378348,183200119,1189671,941406,184141525,174885484
29380438_581799,CM021109.1,10,29380438,183603138,1421828,581799,184184937,174928896
29380438_581877,CM021109.1,10,29380438,183603138,1421828,581877,184185015,174928974
29377159_623525,CM021109.1,10,29377159,183601391,1439375,623525,184224916,174968875
29377159_623685,CM021109.1,10,29377159,183601391,1439375,623685,184225076,174969035
29381636_1057928,CM021109.1,10,29381636,183170075,6607304,1057928,184228003,174971962
29381636_1057948,CM021109.1,10,29381636,183170075,6607304,1057948,184228023,174971982
29379477_1055947,CM021109.1,10,29379477,183200119,1087388,1055947,184256066,175000025
29380113_1061894,CM021109.1,10,29380113,183200119,1471603,1061894,184262013,175005972
29380113_1061926,CM021109.1,10,29380113,183200119,1471603,1061926,184262045,175006004
29380113_1061948,CM021109.1,10,29380113,183200119,1471603,1061948,184262067,175006026
29380113_1061956,CM021109.1,10,29380113,183200119,1471603,1061956,184262075,175006034
29380113_1061969,CM021109.1,10,29380113,183200119,1471603,1061969,184262088,175006047
29380113_1061979,CM021109.1,10,29380113,183200119,1471603,1061979,184262098,175006057
29380113_1061989,CM021109.1,10,29380113,183200119,1471603,1061989,184262108,175006067
29380113_1062028,CM021109.1,10,29380113,183200119,1471603,1062028,184262147,175006106
29380113_1062038,CM021109.1,10,29380113,183200119,1471603,1062038,184262157,175006116
29378417_1096282,CM021109.1,10,29378417,183188255,2501734,1096282,184284537,175028496
29381073_704710,CM021109.1,10,29381073,183601389,2435940,704710,184306099,175050058
29381940_1212305,CM021109.1,10,29381940,183170075,3509478,1212305,184382380,175126339
29382157_1327259,CM021109.1,10,29382157,183170073,4633030,1327259,184497332,175241291
29381073_966796,CM021109.1,10,29381073,183601389,2435940,966796,184568185,175312144
29381073_966865,CM021109.1,10,29381073,183601389,2435940,966865,184568254,175312213
29381073_966921,CM021109.1,10,29381073,183601389,2435940,966921,184568310,175312269
29381073_966931,CM021109.1,10,29381073,183601389,2435940,966931,184568320,175312279
29381073_966940,CM021109.1,10,29381073,183601389,2435940,966940,184568329,175312288
29381073_966951,CM021109.1,10,29381073,183601389,2435940,966951,184568340,175312299
29381073_966954,CM021109.1,10,29381073,183601389,2435940,966954,184568343,175312302
29381073_967045,CM021109.1,10,29381073,183601389,2435940,967045,184568434,175312393
29378417_1463835,CM021109.1,10,29378417,183188255,2501734,1463835,184652090,175396049
29382405_1476009,CM021109.1,10,29382405,183184868,2745055,1476009,184660877,175404836
29380113_1461273,CM021109.1,10,29380113,183200119,1471603,1461273,184661392,175405351
29380113_1461274,CM021109.1,10,29380113,183200119,1471603,1461274,184661393,175405352
29380113_1462093,CM021109.1,10,29380113,183200119,1471603,1462093,184662212,175406171
29380113_1462580,CM021109.1,10,29380113,183200119,1471603,1462580,184662699,175406658
29381636_1528692,CM021109.1,10,29381636,183170075,6607304,1528692,184698767,175442726
29381636_1528753,CM021109.1,10,29381636,183170075,6607304,1528753,184698828,175442787
29381073_1118025,CM021109.1,10,29381073,183601389,2435940,1118025,184719414,175463373
29381073_1118102,CM021109.1,10,29381073,183601389,2435940,1118102,184719491,175463450
29381073_1119878,CM021109.1,10,29381073,183601389,2435940,1119878,184721267,175465226
29381073_1119962,CM021109.1,10,29381073,183601389,2435940,1119962,184721351,175465310
29381073_1142753,CM021109.1,10,29381073,183601389,2435940,1142753,184744142,175488101
29381073_1143651,CM021109.1,10,29381073,183601389,2435940,1143651,184745040,175488999
29380438_1234141,CM021109.1,10,29380438,183603138,1421828,1234141,184837279,175581238
29380438_1234472,CM021109.1,10,29380438,183603138,1421828,1234472,184837610,175581569
29382405_1671794,CM021109.1,10,29382405,183184868,2745055,1671794,184856662,175600621
29382405_1671850,CM021109.1,10,29382405,183184868,2745055,1671850,184856718,175600677
29380438_1258968,CM021109.1,10,29380438,183603138,1421828,1258968,184862106,175606065
29381940_1721748,CM021109.1,10,29381940,183170075,3509478,1721748,184891823,175635782
29381940_1721786,CM021109.1,10,29381940,183170075,3509478,1721786,184891861,175635820
29381940_1722483,CM021109.1,10,29381940,183170075,3509478,1722483,184892558,175636517
29381940_1722519,CM021109.1,10,29381940,183170075,3509478,1722519,184892594,175636553
29381940_1723084,CM021109.1,10,29381940,183170075,3509478,1723084,184893159,175637118
29380422_1713773,CM021109.1,10,29380422,183180081,7677979,1713773,184893854,175637813
29381940_1740702,CM021109.1,10,29381940,183170075,3509478,1740702,184910777,175654736
29381940_1766752,CM021109.1,10,29381940,183170075,3509478,1766752,184936827,175680786
29381940_1766805,CM021109.1,10,29381940,183170075,3509478,1766805,184936880,175680839
29381940_1768540,CM021109.1,10,29381940,183170075,3509478,1768540,184938615,175682574
29380438_1375462,CM021109.1,10,29380438,183603138,1421828,1375462,184978600,175722559
29381940_2375712,CM021109.1,10,29381940,183170075,3509478,2375712,185545787,176289746
29381940_2380178,CM021109.1,10,29381940,183170075,3509478,2380178,185550253,176294212
29381940_2380361,CM021109.1,10,29381940,183170075,3509478,2380361,185550436,176294395
29381940_2380385,CM021109.1,10,29381940,183170075,3509478,2380385,185550460,176294419
29381940_2380487,CM021109.1,10,29381940,183170075,3509478,2380487,185550562,176294521
29381940_2380490,CM021109.1,10,29381940,183170075,3509478,2380490,185550565,176294524
29381940_2555777,CM021109.1,10,29381940,183170075,3509478,2555777,185725852,176469811
29381636_2587374,CM021109.1,10,29381636,183170075,6607304,2587374,185757449,176501408
29381636_2587552,CM021109.1,10,29381636,183170075,6607304,2587552,185757627,176501586
29382157_3237470,CM021109.1,10,29382157,183170073,4633030,3237470,186407543,177151502
29382157_3237522,CM021109.1,10,29382157,183170073,4633030,3237522,186407595,177151554
29382157_3237711,CM021109.1,10,29382157,183170073,4633030,3237711,186407784,177151743
29381188_2867847,CM021109.1,10,29381188,183601387,2961988,2867847,186469234,177213193
29381188_2867881,CM021109.1,10,29381188,183601387,2961988,2867881,186469268,177213227
29381188_2867923,CM021109.1,10,29381188,183601387,2961988,2867923,186469310,177213269
29381188_2867983,CM021109.1,10,29381188,183601387,2961988,2867983,186469370,177213329
29380422_3374730,CM021109.1,10,29380422,183180081,7677979,3374730,186554811,177298770
29380422_3374731,CM021109.1,10,29380422,183180081,7677979,3374731,186554812,177298771
29380422_3374784,CM021109.1,10,29380422,183180081,7677979,3374784,186554865,177298824
29382157_3384823,CM021109.1,10,29382157,183170073,4633030,3384823,186554896,177298855
29382157_3384880,CM021109.1,10,29382157,183170073,4633030,3384880,186554953,177298912
29380422_3374903,CM021109.1,10,29380422,183180081,7677979,3374903,186554984,177298943
29380422_3374908,CM021109.1,10,29380422,183180081,7677979,3374908,186554989,177298948
29382157_3384948,CM021109.1,10,29382157,183170073,4633030,3384948,186555021,177298980
29380422_3402403,CM021109.1,10,29380422,183180081,7677979,3402403,186582484,177326443
29380422_3444243,CM021109.1,10,29380422,183180081,7677979,3444243,186624324,177368283
29380422_3444274,CM021109.1,10,29380422,183180081,7677979,3444274,186624355,177368314
29382157_3603034,CM021109.1,10,29382157,183170073,4633030,3603034,186773107,177517066
29382157_3603049,CM021109.1,10,29382157,183170073,4633030,3603049,186773122,177517081
29382157_3603078,CM021109.1,10,29382157,183170073,4633030,3603078,186773151,177517110
29382157_3603140,CM021109.1,10,29382157,183170073,4633030,3603140,186773213,177517172
29379713_3442593,CM021109.1,10,29379713,183601387,3548589,3442593,187043980,177787939
29382157_4049133,CM021109.1,10,29382157,183170073,4633030,4049133,187219206,177963165
29382157_4049155,CM021109.1,10,29382157,183170073,4633030,4049155,187219228,177963187
29382157_4049263,CM021109.1,10,29382157,183170073,4633030,4049263,187219336,177963295
29382157_4049373,CM021109.1,10,29382157,183170073,4633030,4049373,187219446,177963405
29382157_4049411,CM021109.1,10,29382157,183170073,4633030,4049411,187219484,177963443
29382157_4049415,CM021109.1,10,29382157,183170073,4633030,4049415,187219488,177963447
29382157_4124873,CM021109.1,10,29382157,183170073,4633030,4124873,187294946,178038905
29380422_4161393,CM021109.1,10,29380422,183180081,7677979,4161393,187341474,178085433
29380422_4161396,CM021109.1,10,29380422,183180081,7677979,4161396,187341477,178085436
29380422_4161456,CM021109.1,10,29380422,183180081,7677979,4161456,187341537,178085496
29380422_4161539,CM021109.1,10,29380422,183180081,7677979,4161539,187341620,178085579
29380422_4161548,CM021109.1,10,29380422,183180081,7677979,4161548,187341629,178085588
29380422_4161558,CM021109.1,10,29380422,183180081,7677979,4161558,187341639,178085598
29380422_4161635,CM021109.1,10,29380422,183180081,7677979,4161635,187341716,178085675
29337786_490,CM021109.1,10,29337786,187472642,32481,490,187473132,178217091
29380422_5051239,CM021109.1,10,29380422,183180081,7677979,5051239,188231320,178975279
29380422_5051240,CM021109.1,10,29380422,183180081,7677979,5051240,188231321,178975280
29380422_5455774,CM021109.1,10,29380422,183180081,7677979,5455774,188635855,179379814
29380422_5455960,CM021109.1,10,29380422,183180081,7677979,5455960,188636041,179380000
29380422_5455969,CM021109.1,10,29380422,183180081,7677979,5455969,188636050,179380009
29380422_5455991,CM021109.1,10,29380422,183180081,7677979,5455991,188636072,179380031
29380422_5456096,CM021109.1,10,29380422,183180081,7677979,5456096,188636177,179380136
29380422_5456183,CM021109.1,10,29380422,183180081,7677979,5456183,188636264,179380223
29380422_5471333,CM021109.1,10,29380422,183180081,7677979,5471333,188651414,179395373
29380422_5471352,CM021109.1,10,29380422,183180081,7677979,5471352,188651433,179395392
29380422_5471364,CM021109.1,10,29380422,183180081,7677979,5471364,188651445,179395404
29380422_5471370,CM021109.1,10,29380422,183180081,7677979,5471370,188651451,179395410
29380422_5471375,CM021109.1,10,29380422,183180081,7677979,5471375,188651456,179395415
29380422_5471418,CM021109.1,10,29380422,183180081,7677979,5471418,188651499,179395458
29380422_5471465,CM021109.1,10,29380422,183180081,7677979,5471465,188651546,179395505
29380422_5618832,CM021109.1,10,29380422,183180081,7677979,5618832,188798913,179542872
29380422_5618865,CM021109.1,10,29380422,183180081,7677979,5618865,188798946,179542905
29380422_5618884,CM021109.1,10,29380422,183180081,7677979,5618884,188798965,179542924
29380422_5618925,CM021109.1,10,29380422,183180081,7677979,5618925,188799006,179542965
29380422_5618929,CM021109.1,10,29380422,183180081,7677979,5618929,188799010,179542969
29380422_5624271,CM021109.1,10,29380422,183180081,7677979,5624271,188804352,179548311
29380422_5624438,CM021109.1,10,29380422,183180081,7677979,5624438,188804519,179548478
29380422_5624489,CM021109.1,10,29380422,183180081,7677979,5624489,188804570,179548529
29380422_5630236,CM021109.1,10,29380422,183180081,7677979,5630236,188810317,179554276
29380422_5630289,CM021109.1,10,29380422,183180081,7677979,5630289,188810370,179554329
29380422_5630475,CM021109.1,10,29380422,183180081,7677979,5630475,188810556,179554515
29380422_5630588,CM021109.1,10,29380422,183180081,7677979,5630588,188810669,179554628
29381636_5781091,CM021109.1,10,29381636,183170075,6607304,5781091,188951166,179695125
29381636_5781098,CM021109.1,10,29381636,183170075,6607304,5781098,188951173,179695132
29380422_5828702,CM021109.1,10,29380422,183180081,7677979,5828702,189008783,179752742
29380422_5832543,CM021109.1,10,29380422,183180081,7677979,5832543,189012624,179756583
29380422_5832594,CM021109.1,10,29380422,183180081,7677979,5832594,189012675,179756634
29380422_6503451,CM021109.1,10,29380422,183180081,7677979,6503451,189683532,180427491
29380422_7132172,CM021109.1,10,29380422,183180081,7677979,7132172,190312253,181056212
29380422_7135118,CM021109.1,10,29380422,183180081,7677979,7135118,190315199,181059158
29380422_7137167,CM021109.1,10,29380422,183180081,7677979,7137167,190317248,181061207
29380422_7227316,CM021109.1,10,29380422,183180081,7677979,7227316,190407397,181151356
29380422_7227333,CM021109.1,10,29380422,183180081,7677979,7227333,190407414,181151373
29380422_7245853,CM021109.1,10,29380422,183180081,7677979,7245853,190425934,181169893
29380422_7246130,CM021109.1,10,29380422,183180081,7677979,7246130,190426211,181170170
29380422_7246163,CM021109.1,10,29380422,183180081,7677979,7246163,190426244,181170203
29341132_10214,CM021109.1,10,29341132,230311944,48830,10214,230322158,221066117
29341132_10215,CM021109.1,10,29341132,230311944,48830,10215,230322159,221066118
29341132_10216,CM021109.1,10,29341132,230311944,48830,10216,230322160,221066119
29341132_10217,CM021109.1,10,29341132,230311944,48830,10217,230322161,221066120
29341132_10223,CM021109.1,10,29341132,230311944,48830,10223,230322167,221066126
29341132_10291,CM021109.1,10,29341132,230311944,48830,10291,230322235,221066194
29341132_10335,CM021109.1,10,29341132,230311944,48830,10335,230322279,221066238
29341132_10359,CM021109.1,10,29341132,230311944,48830,10359,230322303,221066262
29339797_132269,CM021109.1,10,29339797,247291433,138086,132269,247423702,238167661
29347894_108331,CM021109.1,10,29347894,251666188,440574,108331,251774519,242518478
29347894_108400,CM021109.1,10,29347894,251666188,440574,108400,251774588,242518547
29377055_929483,CM021109.1,10,29377055,260329754,975560,929483,261259237,252003196
29377055_929506,CM021109.1,10,29377055,260329754,975560,929506,261259260,252003219
29381411_155628,CM021109.1,10,29381411,274359430,1896563,155628,274515058,265259017
29381411_155646,CM021109.1,10,29381411,274359430,1896563,155646,274515076,265259035
29381411_157326,CM021109.1,10,29381411,274359430,1896563,157326,274516756,265260715
29381411_157365,CM021109.1,10,29381411,274359430,1896563,157365,274516795,265260754
29381411_157393,CM021109.1,10,29381411,274359430,1896563,157393,274516823,265260782
29381411_158755,CM021109.1,10,29381411,274359430,1896563,158755,274518185,265262144
29382110_161694,CM021109.1,10,29382110,274360632,826167,161694,274522326,265266285
29382110_161842,CM021109.1,10,29382110,274360632,826167,161842,274522474,265266433
29382110_161849,CM021109.1,10,29382110,274360632,826167,161849,274522481,265266440
29381738_194930,CM021109.1,10,29381738,274358613,3234087,194930,274553543,265297502
29381738_196955,CM021109.1,10,29381738,274358613,3234087,196955,274555568,265299527
29381738_196963,CM021109.1,10,29381738,274358613,3234087,196963,274555576,265299535
29381738_196973,CM021109.1,10,29381738,274358613,3234087,196973,274555586,265299545
29382063_255196,CM021109.1,10,29382063,274360218,1460794,255196,274615414,265359373
29382063_255298,CM021109.1,10,29382063,274360218,1460794,255298,274615516,265359475
29381738_309664,CM021109.1,10,29381738,274358613,3234087,309664,274668277,265412236
29381738_312192,CM021109.1,10,29381738,274358613,3234087,312192,274670805,265414764
29382110_316769,CM021109.1,10,29382110,274360632,826167,316769,274677401,265421360
29381738_395614,CM021109.1,10,29381738,274358613,3234087,395614,274754227,265498186
29381738_401000,CM021109.1,10,29381738,274358613,3234087,401000,274759613,265503572
29377611_406036,CM021109.1,10,29377611,274361075,428125,406036,274767111,265511070
29377611_406079,CM021109.1,10,29377611,274361075,428125,406079,274767154,265511113
29381738_444680,CM021109.1,10,29381738,274358613,3234087,444680,274803293,265547252
29381738_444716,CM021109.1,10,29381738,274358613,3234087,444716,274803329,265547288
29382110_489003,CM021109.1,10,29382110,274360632,826167,489003,274849635,265593594
29382063_610673,CM021109.1,10,29382063,274360218,1460794,610673,274970891,265714850
29380075_622277,CM021109.1,10,29380075,274359703,1018537,622277,274981980,265725939
29380075_622281,CM021109.1,10,29380075,274359703,1018537,622281,274981984,265725943
29382110_631125,CM021109.1,10,29382110,274360632,826167,631125,274991757,265735716
29382110_631131,CM021109.1,10,29382110,274360632,826167,631131,274991763,265735722
29381411_639937,CM021109.1,10,29381411,274359430,1896563,639937,274999367,265743326
29381411_640023,CM021109.1,10,29381411,274359430,1896563,640023,274999453,265743412
29381411_640554,CM021109.1,10,29381411,274359430,1896563,640554,274999984,265743943
29381411_640625,CM021109.1,10,29381411,274359430,1896563,640625,275000055,265744014
29381411_640643,CM021109.1,10,29381411,274359430,1896563,640643,275000073,265744032
29380075_683793,CM021109.1,10,29380075,274359703,1018537,683793,275043496,265787455
29380075_712589,CM021109.1,10,29380075,274359703,1018537,712589,275072292,265816251
29382110_823878,CM021109.1,10,29382110,274360632,826167,823878,275184510,265928469
29382110_823892,CM021109.1,10,29382110,274360632,826167,823892,275184524,265928483
29380075_951877,CM021109.1,10,29380075,274359703,1018537,951877,275311580,266055539
29379658_954071,CM021109.1,10,29379658,274360933,1770956,954071,275315004,266058963
29379658_954142,CM021109.1,10,29379658,274360933,1770956,954142,275315075,266059034
29379658_954208,CM021109.1,10,29379658,274360933,1770956,954208,275315141,266059100
29381738_968975,CM021109.1,10,29381738,274358613,3234087,968975,275327588,266071547
29380075_999792,CM021109.1,10,29380075,274359703,1018537,999792,275359495,266103454
29380075_999933,CM021109.1,10,29380075,274359703,1018537,999933,275359636,266103595
29380075_999940,CM021109.1,10,29380075,274359703,1018537,999940,275359643,266103602
29380075_1000021,CM021109.1,10,29380075,274359703,1018537,1000021,275359724,266103683
29379658_1065838,CM021109.1,10,29379658,274360933,1770956,1065838,275426771,266170730
29379658_1065842,CM021109.1,10,29379658,274360933,1770956,1065842,275426775,266170734
29379658_1065947,CM021109.1,10,29379658,274360933,1770956,1065947,275426880,266170839
29379658_1474076,CM021109.1,10,29379658,274360933,1770956,1474076,275835009,266578968
29379658_1474089,CM021109.1,10,29379658,274360933,1770956,1474089,275835022,266578981
29379658_1474110,CM021109.1,10,29379658,274360933,1770956,1474110,275835043,266579002
29379658_1474112,CM021109.1,10,29379658,274360933,1770956,1474112,275835045,266579004
29381738_1623983,CM021109.1,10,29381738,274358613,3234087,1623983,275982596,266726555
29381738_1624002,CM021109.1,10,29381738,274358613,3234087,1624002,275982615,266726574
29381738_1624062,CM021109.1,10,29381738,274358613,3234087,1624062,275982675,266726634
29381738_1624193,CM021109.1,10,29381738,274358613,3234087,1624193,275982806,266726765
29381738_1624254,CM021109.1,10,29381738,274358613,3234087,1624254,275982867,266726826
29381738_1624255,CM021109.1,10,29381738,274358613,3234087,1624255,275982868,266726827
29381738_1624261,CM021109.1,10,29381738,274358613,3234087,1624261,275982874,266726833
29381738_1624309,CM021109.1,10,29381738,274358613,3234087,1624309,275982922,266726881
29381738_1624395,CM021109.1,10,29381738,274358613,3234087,1624395,275983008,266726967
29381411_1686575,CM021109.1,10,29381411,274359430,1896563,1686575,276046005,266789964
29381411_1694502,CM021109.1,10,29381411,274359430,1896563,1694502,276053932,266797891
29381411_1694551,CM021109.1,10,29381411,274359430,1896563,1694551,276053981,266797940
29381411_1694603,CM021109.1,10,29381411,274359430,1896563,1694603,276054033,266797992
29381738_1750708,CM021109.1,10,29381738,274358613,3234087,1750708,276109321,266853280
29381738_1750752,CM021109.1,10,29381738,274358613,3234087,1750752,276109365,266853324
29381738_1775988,CM021109.1,10,29381738,274358613,3234087,1775988,276134601,266878560
29381738_1876407,CM021109.1,10,29381738,274358613,3234087,1876407,276235020,266978979
29381738_1876469,CM021109.1,10,29381738,274358613,3234087,1876469,276235082,266979041
29381738_1924820,CM021109.1,10,29381738,274358613,3234087,1924820,276283433,267027392
29381738_1928971,CM021109.1,10,29381738,274358613,3234087,1928971,276287584,267031543
29381738_1938512,CM021109.1,10,29381738,274358613,3234087,1938512,276297125,267041084
29381738_1938513,CM021109.1,10,29381738,274358613,3234087,1938513,276297126,267041085
29381738_1938552,CM021109.1,10,29381738,274358613,3234087,1938552,276297165,267041124
29381738_1938557,CM021109.1,10,29381738,274358613,3234087,1938557,276297170,267041129
29381738_1938599,CM021109.1,10,29381738,274358613,3234087,1938599,276297212,267041171
29381738_1938829,CM021109.1,10,29381738,274358613,3234087,1938829,276297442,267041401
29381738_1952816,CM021109.1,10,29381738,274358613,3234087,1952816,276311429,267055388
29381738_1952958,CM021109.1,10,29381738,274358613,3234087,1952958,276311571,267055530
29381738_1952975,CM021109.1,10,29381738,274358613,3234087,1952975,276311588,267055547
29381738_1952985,CM021109.1,10,29381738,274358613,3234087,1952985,276311598,267055557
29381738_1952988,CM021109.1,10,29381738,274358613,3234087,1952988,276311601,267055560
29381738_1953048,CM021109.1,10,29381738,274358613,3234087,1953048,276311661,267055620
29381738_1953050,CM021109.1,10,29381738,274358613,3234087,1953050,276311663,267055622
29381738_2965783,CM021109.1,10,29381738,274358613,3234087,2965783,277324396,268068355
29381738_3162182,CM021109.1,10,29381738,274358613,3234087,3162182,277520795,268264754
29381738_3162196,CM021109.1,10,29381738,274358613,3234087,3162196,277520809,268264768
29381738_3162331,CM021109.1,10,29381738,274358613,3234087,3162331,277520944,268264903
29381738_3162355,CM021109.1,10,29381738,274358613,3234087,3162355,277520968,268264927
29380423_20396,CM021109.1,10,29380423,283340949,1037076,20396,283361345,274105304
29380423_67654,CM021109.1,10,29380423,283340949,1037076,67654,283408603,274152562
29380527_107393,CM021109.1,10,29380527,283339960,514934,107393,283447353,274191312
29380527_107497,CM021109.1,10,29380527,283339960,514934,107497,283447457,274191416
29380527_108352,CM021109.1,10,29380527,283339960,514934,108352,283448312,274192271
29379589_109368,CM021109.1,10,29379589,283339980,1011494,109368,283449348,274193307
29379589_109413,CM021109.1,10,29379589,283339980,1011494,109413,283449393,274193352
29380423_138010,CM021109.1,10,29380423,283340949,1037076,138010,283478959,274222918
29380423_138056,CM021109.1,10,29380423,283340949,1037076,138056,283479005,274222964
29380423_138098,CM021109.1,10,29380423,283340949,1037076,138098,283479047,274223006
29380423_138800,CM021109.1,10,29380423,283340949,1037076,138800,283479749,274223708
29336980_171541,CM021109.1,10,29336980,283339960,683775,171541,283511501,274255460
29336980_171548,CM021109.1,10,29336980,283339960,683775,171548,283511508,274255467
29336980_171563,CM021109.1,10,29336980,283339960,683775,171563,283511523,274255482
29336980_171571,CM021109.1,10,29336980,283339960,683775,171571,283511531,274255490
29336980_171852,CM021109.1,10,29336980,283339960,683775,171852,283511812,274255771
29336980_171856,CM021109.1,10,29336980,283339960,683775,171856,283511816,274255775
29336980_171862,CM021109.1,10,29336980,283339960,683775,171862,283511822,274255781
29336980_171872,CM021109.1,10,29336980,283339960,683775,171872,283511832,274255791
29336980_171880,CM021109.1,10,29336980,283339960,683775,171880,283511840,274255799
29336980_171889,CM021109.1,10,29336980,283339960,683775,171889,283511849,274255808
29336980_171932,CM021109.1,10,29336980,283339960,683775,171932,283511892,274255851
29380423_185240,CM021109.1,10,29380423,283340949,1037076,185240,283526189,274270148
29380423_185241,CM021109.1,10,29380423,283340949,1037076,185241,283526190,274270149
29380423_185285,CM021109.1,10,29380423,283340949,1037076,185285,283526234,274270193
29380343_190821,CM021109.1,10,29380343,283340359,321980,190821,283531180,274275139
29380343_190841,CM021109.1,10,29380343,283340359,321980,190841,283531200,274275159
29380343_190842,CM021109.1,10,29380343,283340359,321980,190842,283531201,274275160
29380343_190848,CM021109.1,10,29380343,283340359,321980,190848,283531207,274275166
29380343_190850,CM021109.1,10,29380343,283340359,321980,190850,283531209,274275168
29380343_190871,CM021109.1,10,29380343,283340359,321980,190871,283531230,274275189
29380343_190931,CM021109.1,10,29380343,283340359,321980,190931,283531290,274275249
29377371_409273,CM021109.1,10,29377371,283339960,4147755,409273,283749233,274493192
29380527_442951,CM021109.1,10,29380527,283339960,514934,442951,283782911,274526870
29380527_452455,CM021109.1,10,29380527,283339960,514934,452455,283792415,274536374
29380527_452491,CM021109.1,10,29380527,283339960,514934,452491,283792451,274536410
29380527_461746,CM021109.1,10,29380527,283339960,514934,461746,283801706,274545665
29380527_461808,CM021109.1,10,29380527,283339960,514934,461808,283801768,274545727
29382359_544401,CM021109.1,10,29382359,283341177,1158921,544401,283885578,274629537
29380423_566925,CM021109.1,10,29380423,283340949,1037076,566925,283907874,274651833
29380423_566987,CM021109.1,10,29380423,283340949,1037076,566987,283907936,274651895
29379919_703116,CM021109.1,10,29379919,283339957,2559188,703116,284043073,274787032
29379919_703223,CM021109.1,10,29379919,283339957,2559188,703223,284043180,274787139
29378713_770683,CM021109.1,10,29378713,283339959,2813979,770683,284110642,274854601
29378713_770753,CM021109.1,10,29378713,283339959,2813979,770753,284110712,274854671
29378713_770778,CM021109.1,10,29378713,283339959,2813979,770778,284110737,274854696
29382437_793811,CM021109.1,10,29382437,283339960,2861097,793811,284133771,274877730
29379919_845392,CM021109.1,10,29379919,283339957,2559188,845392,284185349,274929308
29382359_902174,CM021109.1,10,29382359,283341177,1158921,902174,284243351,274987310
29382359_902191,CM021109.1,10,29382359,283341177,1158921,902191,284243368,274987327
29382359_902219,CM021109.1,10,29382359,283341177,1158921,902219,284243396,274987355
29382359_902235,CM021109.1,10,29382359,283341177,1158921,902235,284243412,274987371
29382359_902279,CM021109.1,10,29382359,283341177,1158921,902279,284243456,274987415
29382359_902298,CM021109.1,10,29382359,283341177,1158921,902298,284243475,274987434
29379919_1014442,CM021109.1,10,29379919,283339957,2559188,1014442,284354399,275098358
29379919_1015143,CM021109.1,10,29379919,283339957,2559188,1015143,284355100,275099059
29382359_1030332,CM021109.1,10,29382359,283341177,1158921,1030332,284371509,275115468
29382359_1030333,CM021109.1,10,29382359,283341177,1158921,1030333,284371510,275115469
29382359_1030351,CM021109.1,10,29382359,283341177,1158921,1030351,284371528,275115487
29382359_1030370,CM021109.1,10,29382359,283341177,1158921,1030370,284371547,275115506
29382359_1030452,CM021109.1,10,29382359,283341177,1158921,1030452,284371629,275115588
29379919_1646369,CM021109.1,10,29379919,283339957,2559188,1646369,284986326,275730285
29378713_1653154,CM021109.1,10,29378713,283339959,2813979,1653154,284993113,275737072
29378713_1653179,CM021109.1,10,29378713,283339959,2813979,1653179,284993138,275737097
29379919_1718036,CM021109.1,10,29379919,283339957,2559188,1718036,285057993,275801952
29379919_1818100,CM021109.1,10,29379919,283339957,2559188,1818100,285158057,275902016
29378713_2026525,CM021109.1,10,29378713,283339959,2813979,2026525,285366484,276110443
29378713_2026563,CM021109.1,10,29378713,283339959,2813979,2026563,285366522,276110481
29378713_2026572,CM021109.1,10,29378713,283339959,2813979,2026572,285366531,276110490
29378713_2182969,CM021109.1,10,29378713,283339959,2813979,2182969,285522928,276266887
29379919_2310966,CM021109.1,10,29379919,283339957,2559188,2310966,285650923,276394882
29379919_2368729,CM021109.1,10,29379919,283339957,2559188,2368729,285708686,276452645
29379919_2382041,CM021109.1,10,29379919,283339957,2559188,2382041,285721998,276465957
29379919_2409173,CM021109.1,10,29379919,283339957,2559188,2409173,285749130,276493089
29382437_2814518,CM021109.1,10,29382437,283339960,2861097,2814518,286154478,276898437
29334734_119735,CM021109.1,10,29334734,297016021,366107,119735,297135756,287879715
29334734_119787,CM021109.1,10,29334734,297016021,366107,119787,297135808,287879767
29379868_570410,CM021109.1,10,29379868,297012674,3006952,570410,297583084,288327043
29379868_570529,CM021109.1,10,29379868,297012674,3006952,570529,297583203,288327162
29377015_57008,CM021109.1,10,29377015,298046083,178562,57008,298103091,288847050
29377015_57079,CM021109.1,10,29377015,298046083,178562,57079,298103162,288847121
29379868_2529885,CM021109.1,10,29379868,297012674,3006952,2529885,299542559,290286518
29379868_2530056,CM021109.1,10,29379868,297012674,3006952,2530056,299542730,290286689
29377794_11053,CM021109.1,10,29377794,317541070,1606911,11053,317552123,308296082
29377794_11082,CM021109.1,10,29377794,317541070,1606911,11082,317552152,308296111
29377794_12364,CM021109.1,10,29377794,317541070,1606911,12364,317553434,308297393
29377794_12394,CM021109.1,10,29377794,317541070,1606911,12394,317553464,308297423
29348817_13402,CM021109.1,10,29348817,317542465,1198499,13402,317555867,308299826
29348817_13426,CM021109.1,10,29348817,317542465,1198499,13426,317555891,308299850
29348817_13457,CM021109.1,10,29348817,317542465,1198499,13457,317555922,308299881
29348817_13503,CM021109.1,10,29348817,317542465,1198499,13503,317555968,308299927
29348817_89557,CM021109.1,10,29348817,317542465,1198499,89557,317632022,308375981
29379287_114856,CM021109.1,10,29379287,317543356,584502,114856,317658212,308402171
29379287_114870,CM021109.1,10,29379287,317543356,584502,114870,317658226,308402185
29377794_151086,CM021109.1,10,29377794,317541070,1606911,151086,317692156,308436115
29377794_151280,CM021109.1,10,29377794,317541070,1606911,151280,317692350,308436309
29377794_154052,CM021109.1,10,29377794,317541070,1606911,154052,317695122,308439081
29381062_199463,CM021109.1,10,29381062,317541073,2554502,199463,317740536,308484495
29334608_228057,CM021109.1,10,29334608,317548858,352808,228057,317776915,308520874
29334608_231632,CM021109.1,10,29334608,317548858,352808,231632,317780490,308524449
29334608_247168,CM021109.1,10,29334608,317548858,352808,247168,317796026,308539985
29379287_255069,CM021109.1,10,29379287,317543356,584502,255069,317798425,308542384
29379287_255315,CM021109.1,10,29379287,317543356,584502,255315,317798671,308542630
29379287_255386,CM021109.1,10,29379287,317543356,584502,255386,317798742,308542701
29379287_255419,CM021109.1,10,29379287,317543356,584502,255419,317798775,308542734
29376998_252926,CM021109.1,10,29376998,317548306,430039,252926,317801232,308545191
29376998_253025,CM021109.1,10,29376998,317548306,430039,253025,317801331,308545290
29334608_275951,CM021109.1,10,29334608,317548858,352808,275951,317824809,308568768
29334608_276102,CM021109.1,10,29334608,317548858,352808,276102,317824960,308568919
29334608_276433,CM021109.1,10,29334608,317548858,352808,276433,317825291,308569250
29334608_276540,CM021109.1,10,29334608,317548858,352808,276540,317825398,308569357
29334608_278115,CM021109.1,10,29334608,317548858,352808,278115,317826973,308570932
29334608_278138,CM021109.1,10,29334608,317548858,352808,278138,317826996,308570955
29348817_376581,CM021109.1,10,29348817,317542465,1198499,376581,317919046,308663005
29380970_501595,CM021109.1,10,29380970,317543007,3059408,501595,318044602,308788561
29380970_501610,CM021109.1,10,29380970,317543007,3059408,501610,318044617,308788576
29380970_501632,CM021109.1,10,29380970,317543007,3059408,501632,318044639,308788598
29380970_501642,CM021109.1,10,29380970,317543007,3059408,501642,318044649,308788608
29380970_501649,CM021109.1,10,29380970,317543007,3059408,501649,318044656,308788615
29380970_501655,CM021109.1,10,29380970,317543007,3059408,501655,318044662,308788621
29380970_501677,CM021109.1,10,29380970,317543007,3059408,501677,318044684,308788643
29380970_501679,CM021109.1,10,29380970,317543007,3059408,501679,318044686,308788645
29380970_501685,CM021109.1,10,29380970,317543007,3059408,501685,318044692,308788651
29380970_501687,CM021109.1,10,29380970,317543007,3059408,501687,318044694,308788653
29380970_501700,CM021109.1,10,29380970,317543007,3059408,501700,318044707,308788666
29380970_501717,CM021109.1,10,29380970,317543007,3059408,501717,318044724,308788683
29380970_501722,CM021109.1,10,29380970,317543007,3059408,501722,318044729,308788688
29380970_501731,CM021109.1,10,29380970,317543007,3059408,501731,318044738,308788697
29380970_501732,CM021109.1,10,29380970,317543007,3059408,501732,318044739,308788698
29380970_501739,CM021109.1,10,29380970,317543007,3059408,501739,318044746,308788705
29380970_501742,CM021109.1,10,29380970,317543007,3059408,501742,318044749,308788708
29380970_501761,CM021109.1,10,29380970,317543007,3059408,501761,318044768,308788727
29378928_518517,CM021109.1,10,29378928,317542612,5347781,518517,318061129,308805088
29378928_518595,CM021109.1,10,29378928,317542612,5347781,518595,318061207,308805166
29378928_590453,CM021109.1,10,29378928,317542612,5347781,590453,318133065,308877024
29348817_635338,CM021109.1,10,29348817,317542465,1198499,635338,318177803,308921762
29348817_635451,CM021109.1,10,29348817,317542465,1198499,635451,318177916,308921875
29348817_635550,CM021109.1,10,29348817,317542465,1198499,635550,318178015,308921974
29348817_635569,CM021109.1,10,29348817,317542465,1198499,635569,318178034,308921993
29379354_688138,CM021109.1,10,29379354,317543065,1040560,688138,318231203,308975162
29379354_688190,CM021109.1,10,29379354,317543065,1040560,688190,318231255,308975214
29377794_754985,CM021109.1,10,29377794,317541070,1606911,754985,318296055,309040014
29377794_756434,CM021109.1,10,29377794,317541070,1606911,756434,318297504,309041463
29381062_790661,CM021109.1,10,29381062,317541073,2554502,790661,318331734,309075693
29379354_813622,CM021109.1,10,29379354,317543065,1040560,813622,318356687,309100646
29379354_813640,CM021109.1,10,29379354,317543065,1040560,813640,318356705,309100664
29379354_813660,CM021109.1,10,29379354,317543065,1040560,813660,318356725,309100684
29379354_813695,CM021109.1,10,29379354,317543065,1040560,813695,318356760,309100719
29379354_813709,CM021109.1,10,29379354,317543065,1040560,813709,318356774,309100733
29380728_828403,CM021109.1,10,29380728,317541069,1675815,828403,318369472,309113431
29380728_828479,CM021109.1,10,29380728,317541069,1675815,828479,318369548,309113507
29380728_828495,CM021109.1,10,29380728,317541069,1675815,828495,318369564,309113523
29377658_836252,CM021109.1,10,29377658,317541070,3712592,836252,318377322,309121281
29377658_836286,CM021109.1,10,29377658,317541070,3712592,836286,318377356,309121315
29380970_835563,CM021109.1,10,29380970,317543007,3059408,835563,318378570,309122529
29380970_835626,CM021109.1,10,29380970,317543007,3059408,835626,318378633,309122592
29380970_835642,CM021109.1,10,29380970,317543007,3059408,835642,318378649,309122608
29380970_835643,CM021109.1,10,29380970,317543007,3059408,835643,318378650,309122609
29379479_849433,CM021109.1,10,29379479,317542922,1486779,849433,318392355,309136314
29379354_850659,CM021109.1,10,29379354,317543065,1040560,850659,318393724,309137683
29377794_858350,CM021109.1,10,29377794,317541070,1606911,858350,318399420,309143379
29381795_877146,CM021109.1,10,29381795,317541070,3587081,877146,318418216,309162175
29381795_877170,CM021109.1,10,29381795,317541070,3587081,877170,318418240,309162199
29381795_877218,CM021109.1,10,29381795,317541070,3587081,877218,318418288,309162247
29381795_877280,CM021109.1,10,29381795,317541070,3587081,877280,318418350,309162309
29381795_877505,CM021109.1,10,29381795,317541070,3587081,877505,318418575,309162534
29381795_877533,CM021109.1,10,29381795,317541070,3587081,877533,318418603,309162562
29381795_877582,CM021109.1,10,29381795,317541070,3587081,877582,318418652,309162611
29379354_986741,CM021109.1,10,29379354,317543065,1040560,986741,318529806,309273765
29379354_986789,CM021109.1,10,29379354,317543065,1040560,986789,318529854,309273813
29379479_1067685,CM021109.1,10,29379479,317542922,1486779,1067685,318610607,309354566
29379479_1067815,CM021109.1,10,29379479,317542922,1486779,1067815,318610737,309354696
29379479_1067842,CM021109.1,10,29379479,317542922,1486779,1067842,318610764,309354723
29379479_1068077,CM021109.1,10,29379479,317542922,1486779,1068077,318610999,309354958
29379479_1068081,CM021109.1,10,29379479,317542922,1486779,1068081,318611003,309354962
29379479_1068087,CM021109.1,10,29379479,317542922,1486779,1068087,318611009,309354968
29379479_1068124,CM021109.1,10,29379479,317542922,1486779,1068124,318611046,309355005
29379479_1068128,CM021109.1,10,29379479,317542922,1486779,1068128,318611050,309355009
29379479_1068146,CM021109.1,10,29379479,317542922,1486779,1068146,318611068,309355027
29379479_1068149,CM021109.1,10,29379479,317542922,1486779,1068149,318611071,309355030
29379479_1068358,CM021109.1,10,29379479,317542922,1486779,1068358,318611280,309355239
29379479_1068362,CM021109.1,10,29379479,317542922,1486779,1068362,318611284,309355243
29379479_1068368,CM021109.1,10,29379479,317542922,1486779,1068368,318611290,309355249
29379479_1068435,CM021109.1,10,29379479,317542922,1486779,1068435,318611357,309355316
29379479_1068445,CM021109.1,10,29379479,317542922,1486779,1068445,318611367,309355326
29379479_1068447,CM021109.1,10,29379479,317542922,1486779,1068447,318611369,309355328
29379479_1068538,CM021109.1,10,29379479,317542922,1486779,1068538,318611460,309355419
29379479_1068550,CM021109.1,10,29379479,317542922,1486779,1068550,318611472,309355431
29379479_1068562,CM021109.1,10,29379479,317542922,1486779,1068562,318611484,309355443
29377794_1109376,CM021109.1,10,29377794,317541070,1606911,1109376,318650446,309394405
29380728_1152426,CM021109.1,10,29380728,317541069,1675815,1152426,318693495,309437454
29377794_1176944,CM021109.1,10,29377794,317541070,1606911,1176944,318718014,309461973
29377794_1176975,CM021109.1,10,29377794,317541070,1606911,1176975,318718045,309462004
29377794_1178238,CM021109.1,10,29377794,317541070,1606911,1178238,318719308,309463267
29377794_1178307,CM021109.1,10,29377794,317541070,1606911,1178307,318719377,309463336
29377658_1217666,CM021109.1,10,29377658,317541070,3712592,1217666,318758736,309502695
29381795_1296873,CM021109.1,10,29381795,317541070,3587081,1296873,318837943,309581902
29381795_1296986,CM021109.1,10,29381795,317541070,3587081,1296986,318838056,309582015
29381795_1296987,CM021109.1,10,29381795,317541070,3587081,1296987,318838057,309582016
29381795_1297047,CM021109.1,10,29381795,317541070,3587081,1297047,318838117,309582076
29381795_1297066,CM021109.1,10,29381795,317541070,3587081,1297066,318838136,309582095
29381795_1297067,CM021109.1,10,29381795,317541070,3587081,1297067,318838137,309582096
29381795_1297098,CM021109.1,10,29381795,317541070,3587081,1297098,318838168,309582127
29381795_1414671,CM021109.1,10,29381795,317541070,3587081,1414671,318955741,309699700
29381795_1414857,CM021109.1,10,29381795,317541070,3587081,1414857,318955927,309699886
29381795_1414916,CM021109.1,10,29381795,317541070,3587081,1414916,318955986,309699945
29381795_1414934,CM021109.1,10,29381795,317541070,3587081,1414934,318956004,309699963
29381795_1415041,CM021109.1,10,29381795,317541070,3587081,1415041,318956111,309700070
29379479_1468139,CM021109.1,10,29379479,317542922,1486779,1468139,319011061,309755020
29379479_1469051,CM021109.1,10,29379479,317542922,1486779,1469051,319011973,309755932
29379479_1469054,CM021109.1,10,29379479,317542922,1486779,1469054,319011976,309755935
29379479_1469116,CM021109.1,10,29379479,317542922,1486779,1469116,319012038,309755997
29378928_1994413,CM021109.1,10,29378928,317542612,5347781,1994413,319537025,310280984
29381527_1997960,CM021109.1,10,29381527,317541070,2659934,1997960,319539030,310282989
29381527_2016946,CM021109.1,10,29381527,317541070,2659934,2016946,319558016,310301975
29381795_2180283,CM021109.1,10,29381795,317541070,3587081,2180283,319721353,310465312
29381795_2180334,CM021109.1,10,29381795,317541070,3587081,2180334,319721404,310465363
29380970_2290613,CM021109.1,10,29380970,317543007,3059408,2290613,319833620,310577579
29377658_2309043,CM021109.1,10,29377658,317541070,3712592,2309043,319850113,310594072
29377658_2309446,CM021109.1,10,29377658,317541070,3712592,2309446,319850516,310594475
29377658_2312352,CM021109.1,10,29377658,317541070,3712592,2312352,319853422,310597381
29380970_2424302,CM021109.1,10,29380970,317543007,3059408,2424302,319967309,310711268
29378928_2582249,CM021109.1,10,29378928,317542612,5347781,2582249,320124861,310868820
29377658_2659229,CM021109.1,10,29377658,317541070,3712592,2659229,320200299,310944258
29377658_2659267,CM021109.1,10,29377658,317541070,3712592,2659267,320200337,310944296
29381795_2731443,CM021109.1,10,29381795,317541070,3587081,2731443,320272513,311016472
29381795_2732362,CM021109.1,10,29381795,317541070,3587081,2732362,320273432,311017391
29365110_45589,CM021109.1,10,29365110,320320723,144403,45589,320366312,311110271
29365110_51428,CM021109.1,10,29365110,320320723,144403,51428,320372151,311116110
29365110_51512,CM021109.1,10,29365110,320320723,144403,51512,320372235,311116194
29365110_52073,CM021109.1,10,29365110,320320723,144403,52073,320372796,311116755
29365110_81765,CM021109.1,10,29365110,320320723,144403,81765,320402488,311146447
29365110_81868,CM021109.1,10,29365110,320320723,144403,81868,320402591,311146550
29365110_81907,CM021109.1,10,29365110,320320723,144403,81907,320402630,311146589
29365110_82426,CM021109.1,10,29365110,320320723,144403,82426,320403149,311147108
29378928_3079180,CM021109.1,10,29378928,317542612,5347781,3079180,320621792,311365751
29377265_3534022,CM021109.1,10,29377265,317541069,5372160,3534022,321075091,311819050
29378928_4180928,CM021109.1,10,29378928,317542612,5347781,4180928,321723540,312467499
29377265_4560517,CM021109.1,10,29377265,317541069,5372160,4560517,322101586,312845545
29377265_4587354,CM021109.1,10,29377265,317541069,5372160,4587354,322128423,312872382
28153863_4300,CM021109.1,10,28153863,334278473,5024,4300,334282773,325026732
29379232_45788,CM021109.1,10,29379232,353863024,1989917,45788,353908812,344652771
29379232_45794,CM021109.1,10,29379232,353863024,1989917,45794,353908818,344652777
29379232_45846,CM021109.1,10,29379232,353863024,1989917,45846,353908870,344652829
29379232_295983,CM021109.1,10,29379232,353863024,1989917,295983,354159007,344902966
29381408_447140,CM021109.1,10,29381408,353863200,842602,447140,354310340,345054299
29381408_447317,CM021109.1,10,29381408,353863200,842602,447317,354310517,345054476
29381408_447402,CM021109.1,10,29381408,353863200,842602,447402,354310602,345054561
29380748_943113,CM021109.1,10,29380748,353863024,971969,943113,354806137,345550096
29380748_943129,CM021109.1,10,29380748,353863024,971969,943129,354806153,345550112
29379232_1493478,CM021109.1,10,29379232,353863024,1989917,1493478,355356502,346100461
29379232_1493560,CM021109.1,10,29379232,353863024,1989917,1493560,355356584,346100543
29200622_2726,CM021109.1,10,29200622,365856403,3281,2726,365859129,356603088
29200622_2757,CM021109.1,10,29200622,365856403,3281,2757,365859160,356603119
29200622_2759,CM021109.1,10,29200622,365856403,3281,2759,365859162,356603121
29200622_2760,CM021109.1,10,29200622,365856403,3281,2760,365859163,356603122
29377887_2953,CM021109.1,10,29377887,377655371,271775,2953,377658324,368402283
29379302_30666,CM021109.1,10,29379302,377654626,579107,30666,377685292,368429251
29379302_45260,CM021109.1,10,29379302,377654626,579107,45260,377699886,368443845
29379302_45271,CM021109.1,10,29379302,377654626,579107,45271,377699897,368443856
29379302_45343,CM021109.1,10,29379302,377654626,579107,45343,377699969,368443928
29379302_45433,CM021109.1,10,29379302,377654626,579107,45433,377700059,368444018
29380174_119302,CM021109.1,10,29380174,377656083,1771771,119302,377775385,368519344
29346209_125823,CM021109.1,10,29346209,377654623,149759,125823,377780446,368524405
29346209_125901,CM021109.1,10,29346209,377654623,149759,125901,377780524,368524483
29346209_126116,CM021109.1,10,29346209,377654623,149759,126116,377780739,368524698
29346209_126139,CM021109.1,10,29346209,377654623,149759,126139,377780762,368524721
29379392_127922,CM021109.1,10,29379392,377655033,6551776,127922,377782955,368526914
29379392_127933,CM021109.1,10,29379392,377655033,6551776,127933,377782966,368526925
29381920_229206,CM021109.1,10,29381920,377654976,2029486,229206,377884182,368628141
29380379_269540,CM021109.1,10,29380379,377654996,826216,269540,377924536,368668495
29380379_269561,CM021109.1,10,29380379,377654996,826216,269561,377924557,368668516
29380174_323942,CM021109.1,10,29380174,377656083,1771771,323942,377980025,368723984
29380174_323943,CM021109.1,10,29380174,377656083,1771771,323943,377980026,368723985
29380174_323996,CM021109.1,10,29380174,377656083,1771771,323996,377980079,368724038
29380174_324027,CM021109.1,10,29380174,377656083,1771771,324027,377980110,368724069
29380174_324187,CM021109.1,10,29380174,377656083,1771771,324187,377980270,368724229
29380174_324293,CM021109.1,10,29380174,377656083,1771771,324293,377980376,368724335
29378210_370911,CM021109.1,10,29378210,377654626,1878922,370911,378025537,368769496
29380174_409367,CM021109.1,10,29380174,377656083,1771771,409367,378065450,368809409
29380174_425048,CM021109.1,10,29380174,377656083,1771771,425048,378081131,368825090
29380174_425072,CM021109.1,10,29380174,377656083,1771771,425072,378081155,368825114
29380174_425133,CM021109.1,10,29380174,377656083,1771771,425133,378081216,368825175
29380174_425135,CM021109.1,10,29380174,377656083,1771771,425135,378081218,368825177
29380174_425140,CM021109.1,10,29380174,377656083,1771771,425140,378081223,368825182
29380174_425141,CM021109.1,10,29380174,377656083,1771771,425141,378081224,368825183
29380174_425154,CM021109.1,10,29380174,377656083,1771771,425154,378081237,368825196
29380174_425155,CM021109.1,10,29380174,377656083,1771771,425155,378081238,368825197
29380174_425168,CM021109.1,10,29380174,377656083,1771771,425168,378081251,368825210
29380174_425198,CM021109.1,10,29380174,377656083,1771771,425198,378081281,368825240
29382166_429651,CM021109.1,10,29382166,377654623,1071069,429651,378084274,368828233
29382166_429665,CM021109.1,10,29382166,377654623,1071069,429665,378084288,368828247
29382166_429725,CM021109.1,10,29382166,377654623,1071069,429725,378084348,368828307
29379302_458415,CM021109.1,10,29379302,377654626,579107,458415,378113041,368857000
29379302_458416,CM021109.1,10,29379302,377654626,579107,458416,378113042,368857001
29381886_472719,CM021109.1,10,29381886,377655328,1608071,472719,378128047,368872006
29380622_497516,CM021109.1,10,29380622,377654835,2165815,497516,378152351,368896310
29380622_497526,CM021109.1,10,29380622,377654835,2165815,497526,378152361,368896320
29380622_497543,CM021109.1,10,29380622,377654835,2165815,497543,378152378,368896337
29380622_497544,CM021109.1,10,29380622,377654835,2165815,497544,378152379,368896338
29380622_497547,CM021109.1,10,29380622,377654835,2165815,497547,378152382,368896341
29380622_497556,CM021109.1,10,29380622,377654835,2165815,497556,378152391,368896350
29381708_498217,CM021109.1,10,29381708,377654626,619583,498217,378152843,368896802
29380622_501910,CM021109.1,10,29380622,377654835,2165815,501910,378156745,368900704
29381614_513671,CM021109.1,10,29381614,377656169,1144596,513671,378169840,368913799
29381614_513694,CM021109.1,10,29381614,377656169,1144596,513694,378169863,368913822
29380174_578336,CM021109.1,10,29380174,377656083,1771771,578336,378234419,368978378
29380174_578379,CM021109.1,10,29380174,377656083,1771771,578379,378234462,368978421
29380174_578381,CM021109.1,10,29380174,377656083,1771771,578381,378234464,368978423
29380174_578401,CM021109.1,10,29380174,377656083,1771771,578401,378234484,368978443
29380174_578410,CM021109.1,10,29380174,377656083,1771771,578410,378234493,368978452
29380174_578421,CM021109.1,10,29380174,377656083,1771771,578421,378234504,368978463
29380174_578456,CM021109.1,10,29380174,377656083,1771771,578456,378234539,368978498
29380174_580204,CM021109.1,10,29380174,377656083,1771771,580204,378236287,368980246
29380174_580217,CM021109.1,10,29380174,377656083,1771771,580217,378236300,368980259
29380174_580245,CM021109.1,10,29380174,377656083,1771771,580245,378236328,368980287
29380174_580253,CM021109.1,10,29380174,377656083,1771771,580253,378236336,368980295
29380174_580313,CM021109.1,10,29380174,377656083,1771771,580313,378236396,368980355
29380174_580314,CM021109.1,10,29380174,377656083,1771771,580314,378236397,368980356
29380174_634021,CM021109.1,10,29380174,377656083,1771771,634021,378290104,369034063
29380174_634055,CM021109.1,10,29380174,377656083,1771771,634055,378290138,369034097
29380174_634104,CM021109.1,10,29380174,377656083,1771771,634104,378290187,369034146
29380174_634141,CM021109.1,10,29380174,377656083,1771771,634141,378290224,369034183
29380174_634157,CM021109.1,10,29380174,377656083,1771771,634157,378290240,369034199
29380174_634172,CM021109.1,10,29380174,377656083,1771771,634172,378290255,369034214
29380174_634181,CM021109.1,10,29380174,377656083,1771771,634181,378290264,369034223
29380174_634226,CM021109.1,10,29380174,377656083,1771771,634226,378290309,369034268
29380174_634254,CM021109.1,10,29380174,377656083,1771771,634254,378290337,369034296
29380174_634334,CM021109.1,10,29380174,377656083,1771771,634334,378290417,369034376
29380174_635456,CM021109.1,10,29380174,377656083,1771771,635456,378291539,369035498
29380174_636020,CM021109.1,10,29380174,377656083,1771771,636020,378292103,369036062
29379404_674962,CM021109.1,10,29379404,377654622,2290949,674962,378329584,369073543
29379404_674973,CM021109.1,10,29379404,377654622,2290949,674973,378329595,369073554
29379404_675050,CM021109.1,10,29379404,377654622,2290949,675050,378329672,369073631
29379404_675773,CM021109.1,10,29379404,377654622,2290949,675773,378330395,369074354
29379404_675844,CM021109.1,10,29379404,377654622,2290949,675844,378330466,369074425
29379404_726677,CM021109.1,10,29379404,377654622,2290949,726677,378381299,369125258
29379404_726682,CM021109.1,10,29379404,377654622,2290949,726682,378381304,369125263
29379404_726684,CM021109.1,10,29379404,377654622,2290949,726684,378381306,369125265
29379404_726688,CM021109.1,10,29379404,377654622,2290949,726688,378381310,369125269
29379404_726690,CM021109.1,10,29379404,377654622,2290949,726690,378381312,369125271
29378921_765230,CM021109.1,10,29378921,377654623,1631958,765230,378419853,369163812
29378921_765333,CM021109.1,10,29378921,377654623,1631958,765333,378419956,369163915
29380174_768528,CM021109.1,10,29380174,377656083,1771771,768528,378424611,369168570
29380174_768549,CM021109.1,10,29380174,377656083,1771771,768549,378424632,369168591
29380174_768580,CM021109.1,10,29380174,377656083,1771771,768580,378424663,369168622
29380174_768643,CM021109.1,10,29380174,377656083,1771771,768643,378424726,369168685
29380174_814645,CM021109.1,10,29380174,377656083,1771771,814645,378470728,369214687
29380174_814662,CM021109.1,10,29380174,377656083,1771771,814662,378470745,369214704
29380174_814863,CM021109.1,10,29380174,377656083,1771771,814863,378470946,369214905
29380174_871172,CM021109.1,10,29380174,377656083,1771771,871172,378527255,369271214
29380174_872645,CM021109.1,10,29380174,377656083,1771771,872645,378528728,369272687
29380174_872718,CM021109.1,10,29380174,377656083,1771771,872718,378528801,369272760
29380174_872741,CM021109.1,10,29380174,377656083,1771771,872741,378528824,369272783
29380174_872764,CM021109.1,10,29380174,377656083,1771771,872764,378528847,369272806
29380174_872856,CM021109.1,10,29380174,377656083,1771771,872856,378528939,369272898
29381614_894348,CM021109.1,10,29381614,377656169,1144596,894348,378550517,369294476
29381614_894423,CM021109.1,10,29381614,377656169,1144596,894423,378550592,369294551
29380174_900842,CM021109.1,10,29380174,377656083,1771771,900842,378556925,369300884
29380174_900908,CM021109.1,10,29380174,377656083,1771771,900908,378556991,369300950
29380174_900923,CM021109.1,10,29380174,377656083,1771771,900923,378557006,369300965
29380174_901008,CM021109.1,10,29380174,377656083,1771771,901008,378557091,369301050
29379404_980057,CM021109.1,10,29379404,377654622,2290949,980057,378634679,369378638
29379404_980092,CM021109.1,10,29379404,377654622,2290949,980092,378634714,369378673
29379404_980097,CM021109.1,10,29379404,377654622,2290949,980097,378634719,369378678
29379404_980451,CM021109.1,10,29379404,377654622,2290949,980451,378635073,369379032
29379404_980454,CM021109.1,10,29379404,377654622,2290949,980454,378635076,369379035
29379404_980486,CM021109.1,10,29379404,377654622,2290949,980486,378635108,369379067
29379392_998803,CM021109.1,10,29379392,377655033,6551776,998803,378653836,369397795
29379392_998834,CM021109.1,10,29379392,377655033,6551776,998834,378653867,369397826
29379392_998874,CM021109.1,10,29379392,377655033,6551776,998874,378653907,369397866
29379392_1002299,CM021109.1,10,29379392,377655033,6551776,1002299,378657332,369401291
29379392_1002307,CM021109.1,10,29379392,377655033,6551776,1002307,378657340,369401299
29379392_1002313,CM021109.1,10,29379392,377655033,6551776,1002313,378657346,369401305
29378921_1058987,CM021109.1,10,29378921,377654623,1631958,1058987,378713610,369457569
29380174_1172820,CM021109.1,10,29380174,377656083,1771771,1172820,378828903,369572862
29380174_1172829,CM021109.1,10,29380174,377656083,1771771,1172829,378828912,369572871
29380174_1172907,CM021109.1,10,29380174,377656083,1771771,1172907,378828990,369572949
29380174_1172927,CM021109.1,10,29380174,377656083,1771771,1172927,378829010,369572969
29380174_1172948,CM021109.1,10,29380174,377656083,1771771,1172948,378829031,369572990
29380174_1173017,CM021109.1,10,29380174,377656083,1771771,1173017,378829100,369573059
29378889_1179584,CM021109.1,10,29378889,377654626,1350992,1179584,378834210,369578169
29378889_1179585,CM021109.1,10,29378889,377654626,1350992,1179585,378834211,369578170
29378889_1179605,CM021109.1,10,29378889,377654626,1350992,1179605,378834231,369578190
29378889_1179653,CM021109.1,10,29378889,377654626,1350992,1179653,378834279,369578238
29380622_1271475,CM021109.1,10,29380622,377654835,2165815,1271475,378926310,369670269
29380622_1271519,CM021109.1,10,29380622,377654835,2165815,1271519,378926354,369670313
29379404_1348984,CM021109.1,10,29379404,377654622,2290949,1348984,379003606,369747565
29379404_1349006,CM021109.1,10,29379404,377654622,2290949,1349006,379003628,369747587
29379404_1357672,CM021109.1,10,29379404,377654622,2290949,1357672,379012294,369756253
29379404_1375325,CM021109.1,10,29379404,377654622,2290949,1375325,379029947,369773906
29379404_1375336,CM021109.1,10,29379404,377654622,2290949,1375336,379029958,369773917
29379404_1376677,CM021109.1,10,29379404,377654622,2290949,1376677,379031299,369775258
29379404_1376835,CM021109.1,10,29379404,377654622,2290949,1376835,379031457,369775416
29379404_1376890,CM021109.1,10,29379404,377654622,2290949,1376890,379031512,369775471
29379392_1413340,CM021109.1,10,29379392,377655033,6551776,1413340,379068373,369812332
29379392_1413426,CM021109.1,10,29379392,377655033,6551776,1413426,379068459,369812418
29382085_1414022,CM021109.1,10,29382085,377654950,4407338,1414022,379068972,369812931
29378210_1451363,CM021109.1,10,29378210,377654626,1878922,1451363,379105989,369849948
29381886_1459669,CM021109.1,10,29381886,377655328,1608071,1459669,379114997,369858956
29379392_1596670,CM021109.1,10,29379392,377655033,6551776,1596670,379251703,369995662
29379392_1614483,CM021109.1,10,29379392,377655033,6551776,1614483,379269516,370013475
29379392_1724717,CM021109.1,10,29379392,377655033,6551776,1724717,379379750,370123709
29379392_1724726,CM021109.1,10,29379392,377655033,6551776,1724726,379379759,370123718
29379392_1724765,CM021109.1,10,29379392,377655033,6551776,1724765,379379798,370123757
29379392_1840850,CM021109.1,10,29379392,377655033,6551776,1840850,379495883,370239842
29379392_1840859,CM021109.1,10,29379392,377655033,6551776,1840859,379495892,370239851
29379392_1840908,CM021109.1,10,29379392,377655033,6551776,1840908,379495941,370239900
29378210_1842340,CM021109.1,10,29378210,377654626,1878922,1842340,379496966,370240925
29378210_1842345,CM021109.1,10,29378210,377654626,1878922,1842345,379496971,370240930
29378210_1842445,CM021109.1,10,29378210,377654626,1878922,1842445,379497071,370241030
29378210_1842570,CM021109.1,10,29378210,377654626,1878922,1842570,379497196,370241155
29379392_1998843,CM021109.1,10,29379392,377655033,6551776,1998843,379653876,370397835
29379392_2564144,CM021109.1,10,29379392,377655033,6551776,2564144,380219177,370963136
29379392_2564148,CM021109.1,10,29379392,377655033,6551776,2564148,380219181,370963140
29382085_2784798,CM021109.1,10,29382085,377654950,4407338,2784798,380439748,371183707
29382085_4114679,CM021109.1,10,29382085,377654950,4407338,4114679,381769629,372513588
29382085_4114757,CM021109.1,10,29382085,377654950,4407338,4114757,381769707,372513666
29382085_4114770,CM021109.1,10,29382085,377654950,4407338,4114770,381769720,372513679
29382085_4114861,CM021109.1,10,29382085,377654950,4407338,4114861,381769811,372513770
29382085_4114890,CM021109.1,10,29382085,377654950,4407338,4114890,381769840,372513799
29382085_4114932,CM021109.1,10,29382085,377654950,4407338,4114932,381769882,372513841
29382085_4115053,CM021109.1,10,29382085,377654950,4407338,4115053,381770003,372513962
29382085_4196354,CM021109.1,10,29382085,377654950,4407338,4196354,381851304,372595263
29382085_4225843,CM021109.1,10,29382085,377654950,4407338,4225843,381880793,372624752
29382085_4225888,CM021109.1,10,29382085,377654950,4407338,4225888,381880838,372624797
29382085_4225942,CM021109.1,10,29382085,377654950,4407338,4225942,381880892,372624851
29382085_4225948,CM021109.1,10,29382085,377654950,4407338,4225948,381880898,372624857
29381433_185207,CM021109.1,10,29381433,381871757,1039225,185207,382056964,372800923
29381433_185242,CM021109.1,10,29381433,381871757,1039225,185242,382056999,372800958
29381433_185264,CM021109.1,10,29381433,381871757,1039225,185264,382057021,372800980
29381433_185598,CM021109.1,10,29381433,381871757,1039225,185598,382057355,372801314
29381433_185705,CM021109.1,10,29381433,381871757,1039225,185705,382057462,372801421
29381433_699309,CM021109.1,10,29381433,381871757,1039225,699309,382571066,373315025
29381433_699508,CM021109.1,10,29381433,381871757,1039225,699508,382571265,373315224
29381433_699524,CM021109.1,10,29381433,381871757,1039225,699524,382571281,373315240
29381433_699546,CM021109.1,10,29381433,381871757,1039225,699546,382571303,373315262
29379392_4958517,CM021109.1,10,29379392,377655033,6551776,4958517,382613550,373357509
29378606_211819,CM021109.1,10,29378606,420054379,329708,211819,420266198,411010157
29378606_211825,CM021109.1,10,29378606,420054379,329708,211825,420266204,411010163
29378481_66000,CM021109.1,10,29378481,439677882,2149292,66000,439743882,430487841
29379938_102373,CM021109.1,10,29379938,439663372,1178093,102373,439765745,430509704
29378562_124596,CM021109.1,10,29378562,439678414,479334,124596,439803010,430546969
29378562_124752,CM021109.1,10,29378562,439678414,479334,124752,439803166,430547125
29378562_124808,CM021109.1,10,29378562,439678414,479334,124808,439803222,430547181
29378562_124815,CM021109.1,10,29378562,439678414,479334,124815,439803229,430547188
29378562_124818,CM021109.1,10,29378562,439678414,479334,124818,439803232,430547191
29378562_124865,CM021109.1,10,29378562,439678414,479334,124865,439803279,430547238
29378562_173176,CM021109.1,10,29378562,439678414,479334,173176,439851590,430595549
29378562_173231,CM021109.1,10,29378562,439678414,479334,173231,439851645,430595604
29380791_275335,CM021109.1,10,29380791,439674641,708320,275335,439949976,430693935
29380791_275410,CM021109.1,10,29380791,439674641,708320,275410,439950051,430694010
29378676_297551,CM021109.1,10,29378676,439663383,1050755,297551,439960934,430704893
29377261_337102,CM021109.1,10,29377261,439663375,366808,337102,440000477,430744436
29377261_337157,CM021109.1,10,29377261,439663375,366808,337157,440000532,430744491
29377261_337170,CM021109.1,10,29377261,439663375,366808,337170,440000545,430744504
29379938_396981,CM021109.1,10,29379938,439663372,1178093,396981,440060353,430804312
29380685_415600,CM021109.1,10,29380685,439663383,2468719,415600,440078983,430822942
29380685_415611,CM021109.1,10,29380685,439663383,2468719,415611,440078994,430822953
29380685_415673,CM021109.1,10,29380685,439663383,2468719,415673,440079056,430823015
29380685_415690,CM021109.1,10,29380685,439663383,2468719,415690,440079073,430823032
29380685_415709,CM021109.1,10,29380685,439663383,2468719,415709,440079092,430823051
29380685_415729,CM021109.1,10,29380685,439663383,2468719,415729,440079112,430823071
29380685_415750,CM021109.1,10,29380685,439663383,2468719,415750,440079133,430823092
29380685_415752,CM021109.1,10,29380685,439663383,2468719,415752,440079135,430823094
29380685_415764,CM021109.1,10,29380685,439663383,2468719,415764,440079147,430823106
29380685_415768,CM021109.1,10,29380685,439663383,2468719,415768,440079151,430823110
29380685_415786,CM021109.1,10,29380685,439663383,2468719,415786,440079169,430823128
29380685_456141,CM021109.1,10,29380685,439663383,2468719,456141,440119524,430863483
29380685_456155,CM021109.1,10,29380685,439663383,2468719,456155,440119538,430863497
29380685_456197,CM021109.1,10,29380685,439663383,2468719,456197,440119580,430863539
29380685_456212,CM021109.1,10,29380685,439663383,2468719,456212,440119595,430863554
29380685_456267,CM021109.1,10,29380685,439663383,2468719,456267,440119650,430863609
29380791_501044,CM021109.1,10,29380791,439674641,708320,501044,440175685,430919644
29380791_501109,CM021109.1,10,29380791,439674641,708320,501109,440175750,430919709
29380685_543868,CM021109.1,10,29380685,439663383,2468719,543868,440207251,430951210
29380685_543885,CM021109.1,10,29380685,439663383,2468719,543885,440207268,430951227
29379938_547768,CM021109.1,10,29379938,439663372,1178093,547768,440211140,430955099
29378926_652296,CM021109.1,10,29378926,439678632,662943,652296,440330928,431074887
29378926_652302,CM021109.1,10,29378926,439678632,662943,652302,440330934,431074893
29378926_652305,CM021109.1,10,29378926,439678632,662943,652305,440330937,431074896
29378926_652310,CM021109.1,10,29378926,439678632,662943,652310,440330942,431074901
29378926_652331,CM021109.1,10,29378926,439678632,662943,652331,440330963,431074922
29378926_652343,CM021109.1,10,29378926,439678632,662943,652343,440330975,431074934
29378926_652423,CM021109.1,10,29378926,439678632,662943,652423,440331055,431075014
29380061_811372,CM021109.1,10,29380061,439663378,1294168,811372,440474750,431218709
29378481_808423,CM021109.1,10,29378481,439677882,2149292,808423,440486305,431230264
29380685_1000978,CM021109.1,10,29380685,439663383,2468719,1000978,440664361,431408320
29380685_1011868,CM021109.1,10,29380685,439663383,2468719,1011868,440675251,431419210
29378885_1059074,CM021109.1,10,29378885,439663383,1385087,1059074,440722457,431466416
29382283_1099018,CM021109.1,10,29382283,439663382,3558488,1099018,440762400,431506359
29379938_1129135,CM021109.1,10,29379938,439663372,1178093,1129135,440792507,431536466
29379938_1129138,CM021109.1,10,29379938,439663372,1178093,1129138,440792510,431536469
29380685_1146028,CM021109.1,10,29380685,439663383,2468719,1146028,440809411,431553370
29380685_1148508,CM021109.1,10,29380685,439663383,2468719,1148508,440811891,431555850
29380685_1148786,CM021109.1,10,29380685,439663383,2468719,1148786,440812169,431556128
29378885_1204617,CM021109.1,10,29378885,439663383,1385087,1204617,440868000,431611959
29378885_1204619,CM021109.1,10,29378885,439663383,1385087,1204619,440868002,431611961
29378885_1204626,CM021109.1,10,29378885,439663383,1385087,1204626,440868009,431611968
29378885_1204629,CM021109.1,10,29378885,439663383,1385087,1204629,440868012,431611971
29378885_1204662,CM021109.1,10,29378885,439663383,1385087,1204662,440868045,431612004
29378885_1226406,CM021109.1,10,29378885,439663383,1385087,1226406,440889789,431633748
29378481_1326026,CM021109.1,10,29378481,439677882,2149292,1326026,441003908,431747867
29378481_1447850,CM021109.1,10,29378481,439677882,2149292,1447850,441125732,431869691
29380685_1645286,CM021109.1,10,29380685,439663383,2468719,1645286,441308669,432052628
29380685_1645359,CM021109.1,10,29380685,439663383,2468719,1645359,441308742,432052701
29380685_1789981,CM021109.1,10,29380685,439663383,2468719,1789981,441453364,432197323
29380685_1790011,CM021109.1,10,29380685,439663383,2468719,1790011,441453394,432197353
29380685_1790596,CM021109.1,10,29380685,439663383,2468719,1790596,441453979,432197938
29380685_1794517,CM021109.1,10,29380685,439663383,2468719,1794517,441457900,432201859
29380685_1794549,CM021109.1,10,29380685,439663383,2468719,1794549,441457932,432201891
29380685_1859179,CM021109.1,10,29380685,439663383,2468719,1859179,441522562,432266521
29380685_1859205,CM021109.1,10,29380685,439663383,2468719,1859205,441522588,432266547
29380685_1885044,CM021109.1,10,29380685,439663383,2468719,1885044,441548427,432292386
29380685_2277954,CM021109.1,10,29380685,439663383,2468719,2277954,441941337,432685296
29380685_2277979,CM021109.1,10,29380685,439663383,2468719,2277979,441941362,432685321
29382283_2410617,CM021109.1,10,29382283,439663382,3558488,2410617,442073999,432817958
29382283_3477794,CM021109.1,10,29382283,439663382,3558488,3477794,443141176,433885135
29381665_138429,CM021109.1,10,29381665,463420430,4568095,138429,463558859,454302818
29381665_138469,CM021109.1,10,29381665,463420430,4568095,138469,463558899,454302858
29379719_267616,CM021109.1,10,29379719,463423886,411711,267616,463691502,454435461
29378958_286259,CM021109.1,10,29378958,463420428,1309037,286259,463706687,454450646
29378501_369218,CM021109.1,10,29378501,463421176,1027916,369218,463790394,454534353
29378501_370682,CM021109.1,10,29378501,463421176,1027916,370682,463791858,454535817
29378501_370808,CM021109.1,10,29378501,463421176,1027916,370808,463791984,454535943
29381665_897621,CM021109.1,10,29381665,463420430,4568095,897621,464318051,455062010
29378501_913068,CM021109.1,10,29378501,463421176,1027916,913068,464334244,455078203
29378958_1016612,CM021109.1,10,29378958,463420428,1309037,1016612,464437040,455180999
29381665_2976416,CM021109.1,10,29381665,463420430,4568095,2976416,466396846,457140805
29381665_3496950,CM021109.1,10,29381665,463420430,4568095,3496950,466917380,457661339
29381665_3496998,CM021109.1,10,29381665,463420430,4568095,3496998,466917428,457661387
29381665_3664553,CM021109.1,10,29381665,463420430,4568095,3664553,467084983,457828942
29381665_3664614,CM021109.1,10,29381665,463420430,4568095,3664614,467085044,457829003
29381665_3669948,CM021109.1,10,29381665,463420430,4568095,3669948,467090378,457834337
29381665_3669964,CM021109.1,10,29381665,463420430,4568095,3669964,467090394,457834353
29381665_3669973,CM021109.1,10,29381665,463420430,4568095,3669973,467090403,457834362
29381665_3669982,CM021109.1,10,29381665,463420430,4568095,3669982,467090412,457834371
29381665_3669983,CM021109.1,10,29381665,463420430,4568095,3669983,467090413,457834372
29381665_3669991,CM021109.1,10,29381665,463420430,4568095,3669991,467090421,457834380
29381665_3670007,CM021109.1,10,29381665,463420430,4568095,3670007,467090437,457834396
29381665_3670010,CM021109.1,10,29381665,463420430,4568095,3670010,467090440,457834399
29381665_3670075,CM021109.1,10,29381665,463420430,4568095,3670075,467090505,457834464
29381665_3670119,CM021109.1,10,29381665,463420430,4568095,3670119,467090549,457834508
29381665_3670125,CM021109.1,10,29381665,463420430,4568095,3670125,467090555,457834514
29381665_3670157,CM021109.1,10,29381665,463420430,4568095,3670157,467090587,457834546
29381665_3670219,CM021109.1,10,29381665,463420430,4568095,3670219,467090649,457834608
29381665_3670239,CM021109.1,10,29381665,463420430,4568095,3670239,467090669,457834628
29381665_3670330,CM021109.1,10,29381665,463420430,4568095,3670330,467090760,457834719
29381665_3670408,CM021109.1,10,29381665,463420430,4568095,3670408,467090838,457834797
29381665_3670414,CM021109.1,10,29381665,463420430,4568095,3670414,467090844,457834803
29381665_3670415,CM021109.1,10,29381665,463420430,4568095,3670415,467090845,457834804
29381665_3670535,CM021109.1,10,29381665,463420430,4568095,3670535,467090965,457834924
29381665_3901170,CM021109.1,10,29381665,463420430,4568095,3901170,467321600,458065559
29381665_3901212,CM021109.1,10,29381665,463420430,4568095,3901212,467321642,458065601
29381665_3901220,CM021109.1,10,29381665,463420430,4568095,3901220,467321650,458065609
29381665_3901231,CM021109.1,10,29381665,463420430,4568095,3901231,467321661,458065620
29381665_3901246,CM021109.1,10,29381665,463420430,4568095,3901246,467321676,458065635
29381665_3901265,CM021109.1,10,29381665,463420430,4568095,3901265,467321695,458065654
29381665_3901290,CM021109.1,10,29381665,463420430,4568095,3901290,467321720,458065679
29380153_1299,CM021109.1,10,29380153,473791436,1584177,1299,473792735,464536694
29378124_52542,CM021109.1,10,29378124,473791433,175238,52542,473843975,464587934
29380153_265899,CM021109.1,10,29380153,473791436,1584177,265899,474057335,464801294
29380153_265907,CM021109.1,10,29380153,473791436,1584177,265907,474057343,464801302
29380153_266045,CM021109.1,10,29380153,473791436,1584177,266045,474057481,464801440
29380153_266160,CM021109.1,10,29380153,473791436,1584177,266160,474057596,464801555
29380153_300743,CM021109.1,10,29380153,473791436,1584177,300743,474092179,464836138
29380153_300778,CM021109.1,10,29380153,473791436,1584177,300778,474092214,464836173
29380153_300806,CM021109.1,10,29380153,473791436,1584177,300806,474092242,464836201
29380153_300845,CM021109.1,10,29380153,473791436,1584177,300845,474092281,464836240
29380153_300903,CM021109.1,10,29380153,473791436,1584177,300903,474092339,464836298
29380153_300935,CM021109.1,10,29380153,473791436,1584177,300935,474092371,464836330
29380153_300984,CM021109.1,10,29380153,473791436,1584177,300984,474092420,464836379
29380153_301041,CM021109.1,10,29380153,473791436,1584177,301041,474092477,464836436
29380153_310687,CM021109.1,10,29380153,473791436,1584177,310687,474102123,464846082
29380153_310748,CM021109.1,10,29380153,473791436,1584177,310748,474102184,464846143
29380153_310763,CM021109.1,10,29380153,473791436,1584177,310763,474102199,464846158
29380153_310771,CM021109.1,10,29380153,473791436,1584177,310771,474102207,464846166
29380153_310949,CM021109.1,10,29380153,473791436,1584177,310949,474102385,464846344
29380153_311051,CM021109.1,10,29380153,473791436,1584177,311051,474102487,464846446
29380153_389220,CM021109.1,10,29380153,473791436,1584177,389220,474180656,464924615
29380153_1092853,CM021109.1,10,29380153,473791436,1584177,1092853,474884289,465628248
29380153_1565025,CM021109.1,10,29380153,473791436,1584177,1565025,475356461,466100420
29380153_1567019,CM021109.1,10,29380153,473791436,1584177,1567019,475358455,466102414
29380153_1567116,CM021109.1,10,29380153,473791436,1584177,1567116,475358552,466102511
29376428_507705,CM021109.1,10,29376428,496712083,575284,507705,497219788,487963747
29382461_3992,CM021109.1,10,29382461,498941168,64635,3992,498945160,489689119
29382461_4022,CM021109.1,10,29382461,498941168,64635,4022,498945190,489689149
29382297_565614,CM021109.1,10,29382297,506466349,2761436,565614,507031963,497775922
29382297_565649,CM021109.1,10,29382297,506466349,2761436,565649,507031998,497775957
29381232_630689,CM021109.1,10,29381232,506466348,1177670,630689,507097037,497840996
29381630_1071573,CM021109.1,10,29381630,506466339,5203112,1071573,507537912,498281871
29381630_1113771,CM021109.1,10,29381630,506466339,5203112,1113771,507580110,498324069
29346344_9812,CM021109.1,10,29346344,511340846,15942,9812,511350658,502094617
29346344_9856,CM021109.1,10,29346344,511340846,15942,9856,511350702,502094661
29346344_9895,CM021109.1,10,29346344,511340846,15942,9895,511350741,502094700
29378182_184386,CM021109.1,10,29378182,545047116,1547853,184386,545231502,535975461
29378182_184628,CM021109.1,10,29378182,545047116,1547853,184628,545231744,535975703
29378182_200641,CM021109.1,10,29378182,545047116,1547853,200641,545247757,535991716
29378182_229275,CM021109.1,10,29378182,545047116,1547853,229275,545276391,536020350
28477215_4960,CM021109.1,10,28477215,558293018,8456,4960,558297978,549041937
28477215_5030,CM021109.1,10,28477215,558293018,8456,5030,558298048,549042007
29346187_9115,CM021109.1,10,29346187,574787064,58691,9115,574796179,565540138
29377932_6405,CM021109.1,10,29377932,582149482,1540900,6405,582155887,572899846
29377787_117193,CM021109.1,10,29377787,582147786,323353,117193,582264979,573008938
29377787_150594,CM021109.1,10,29377787,582147786,323353,150594,582298380,573042339
29377787_150702,CM021109.1,10,29377787,582147786,323353,150702,582298488,573042447
29377787_150823,CM021109.1,10,29377787,582147786,323353,150823,582298609,573042568
29377787_150827,CM021109.1,10,29377787,582147786,323353,150827,582298613,573042572
29377787_277096,CM021109.1,10,29377787,582147786,323353,277096,582424882,573168841
29377787_277186,CM021109.1,10,29377787,582147786,323353,277186,582424972,573168931
29377932_678787,CM021109.1,10,29377932,582149482,1540900,678787,582828269,573572228
29377932_678802,CM021109.1,10,29377932,582149482,1540900,678802,582828284,573572243
29377932_815603,CM021109.1,10,29377932,582149482,1540900,815603,582965085,573709044
29377932_815631,CM021109.1,10,29377932,582149482,1540900,815631,582965113,573709072
29377932_815871,CM021109.1,10,29377932,582149482,1540900,815871,582965353,573709312
29371059_24333,CM021109.1,10,29371059,588354323,234188,24333,588378656,579122615
29380683_96824,CM021109.1,10,29380683,588349904,233739,96824,588446728,579190687
29380683_96825,CM021109.1,10,29380683,588349904,233739,96825,588446729,579190688
29380683_96831,CM021109.1,10,29380683,588349904,233739,96831,588446735,579190694
29380683_96858,CM021109.1,10,29380683,588349904,233739,96858,588446762,579190721
29380683_96874,CM021109.1,10,29380683,588349904,233739,96874,588446778,579190737
29380683_96891,CM021109.1,10,29380683,588349904,233739,96891,588446795,579190754
29380683_96905,CM021109.1,10,29380683,588349904,233739,96905,588446809,579190768
29380683_96923,CM021109.1,10,29380683,588349904,233739,96923,588446827,579190786
29380683_96940,CM021109.1,10,29380683,588349904,233739,96940,588446844,579190803
29380683_96948,CM021109.1,10,29380683,588349904,233739,96948,588446852,579190811
29380683_96961,CM021109.1,10,29380683,588349904,233739,96961,588446865,579190824
29377634_176310,CM021109.1,10,29377634,588353918,607210,176310,588530228,579274187
29377634_176320,CM021109.1,10,29377634,588353918,607210,176320,588530238,579274197
29379018_431593,CM021109.1,10,29379018,588349908,1174311,431593,588781501,579525460
29379018_454964,CM021109.1,10,29379018,588349908,1174311,454964,588804872,579548831
29379018_454965,CM021109.1,10,29379018,588349908,1174311,454965,588804873,579548832
29379018_458434,CM021109.1,10,29379018,588349908,1174311,458434,588808342,579552301
29379018_458450,CM021109.1,10,29379018,588349908,1174311,458450,588808358,579552317
29379018_826436,CM021109.1,10,29379018,588349908,1174311,826436,589176344,579920303
29379018_826554,CM021109.1,10,29379018,588349908,1174311,826554,589176462,579920421
29379018_831051,CM021109.1,10,29379018,588349908,1174311,831051,589180959,579924918
29379018_831057,CM021109.1,10,29379018,588349908,1174311,831057,589180965,579924924
29379018_831163,CM021109.1,10,29379018,588349908,1174311,831163,589181071,579925030
29379018_995190,CM021109.1,10,29379018,588349908,1174311,995190,589345098,580089057
29379018_1029946,CM021109.1,10,29379018,588349908,1174311,1029946,589379854,580123813
29377139_2138918,CM021109.1,10,29377139,588349903,3226085,2138918,590488821,581232780
29377139_3096236,CM021109.1,10,29377139,588349903,3226085,3096236,591446139,582190098
29350611_90591,CM021109.1,10,29350611,624997812,140111,90591,625088403,615832362
29345129_342802,CM021109.1,10,29345129,624995258,444149,342802,625338060,616082019
29345129_342816,CM021109.1,10,29345129,624995258,444149,342816,625338074,616082033
29345129_348622,CM021109.1,10,29345129,624995258,444149,348622,625343880,616087839
29345129_439445,CM021109.1,10,29345129,624995258,444149,439445,625434703,616178662
29345129_441186,CM021109.1,10,29345129,624995258,444149,441186,625436444,616180403
29375398_5094,CM021109.1,10,29375398,628165028,214059,5094,628170122,618914081
29378820_127175,CM021109.1,10,29378820,628162575,3949796,127175,628289750,619033709
29378409_161760,CM021109.1,10,29378409,628162559,395309,161760,628324319,619068278
29378409_161865,CM021109.1,10,29378409,628162559,395309,161865,628324424,619068383
29378409_168728,CM021109.1,10,29378409,628162559,395309,168728,628331287,619075246
29378409_168752,CM021109.1,10,29378409,628162559,395309,168752,628331311,619075270
29378409_168957,CM021109.1,10,29378409,628162559,395309,168957,628331516,619075475
29378820_214232,CM021109.1,10,29378820,628162575,3949796,214232,628376807,619120766
29378007_273156,CM021109.1,10,29378007,628162559,330259,273156,628435715,619179674
29378007_273186,CM021109.1,10,29378007,628162559,330259,273186,628435745,619179704
29378007_273217,CM021109.1,10,29378007,628162559,330259,273217,628435776,619179735
29378007_273375,CM021109.1,10,29378007,628162559,330259,273375,628435934,619179893
29378007_273376,CM021109.1,10,29378007,628162559,330259,273376,628435935,619179894
29378007_273407,CM021109.1,10,29378007,628162559,330259,273407,628435966,619179925
29381401_275023,CM021109.1,10,29381401,628162559,698552,275023,628437582,619181541
29380868_288534,CM021109.1,10,29380868,628162559,1415054,288534,628451093,619195052
29380372_321766,CM021109.1,10,29380372,628163013,519832,321766,628484779,619228738
29380868_845095,CM021109.1,10,29380868,628162559,1415054,845095,629007654,619751613
29378820_1414388,CM021109.1,10,29378820,628162575,3949796,1414388,629576963,620320922
29378820_1414429,CM021109.1,10,29378820,628162575,3949796,1414429,629577004,620320963
29378820_1414430,CM021109.1,10,29378820,628162575,3949796,1414430,629577005,620320964
29378820_1915376,CM021109.1,10,29378820,628162575,3949796,1915376,630077951,620821910
29378820_1949879,CM021109.1,10,29378820,628162575,3949796,1949879,630112454,620856413
29378820_1951285,CM021109.1,10,29378820,628162575,3949796,1951285,630113860,620857819
29378820_1951440,CM021109.1,10,29378820,628162575,3949796,1951440,630114015,620857974
29378820_2393929,CM021109.1,10,29378820,628162575,3949796,2393929,630556504,621300463
29378820_2394005,CM021109.1,10,29378820,628162575,3949796,2394005,630556580,621300539
29378820_3576891,CM021109.1,10,29378820,628162575,3949796,3576891,631739466,622483425
29378820_3576916,CM021109.1,10,29378820,628162575,3949796,3576916,631739491,622483450
29378820_3576931,CM021109.1,10,29378820,628162575,3949796,3576931,631739506,622483465
29378820_3625740,CM021109.1,10,29378820,628162575,3949796,3625740,631788315,622532274
29378820_3626240,CM021109.1,10,29378820,628162575,3949796,3626240,631788815,622532774
29378820_3647112,CM021109.1,10,29378820,628162575,3949796,3647112,631809687,622553646
29378820_3679021,CM021109.1,10,29378820,628162575,3949796,3679021,631841596,622585555
29191022_1523,CM021110.1,11,29191022,10115535,3785,1523,10117058,1523
28154626_133,CM021110.1,11,28154626,10468957,4608,133,10469090,353555
28154626_326,CM021110.1,11,28154626,10468957,4608,326,10469283,353748
28154626_3513,CM021110.1,11,28154626,10468957,4608,3513,10472470,356935
29381415_26923,CM021110.1,11,29381415,18393162,391818,26923,18420085,8304550
29381415_26931,CM021110.1,11,29381415,18393162,391818,26931,18420093,8304558
29381415_26937,CM021110.1,11,29381415,18393162,391818,26937,18420099,8304564
29381415_27051,CM021110.1,11,29381415,18393162,391818,27051,18420213,8304678
29381415_28391,CM021110.1,11,29381415,18393162,391818,28391,18421553,8306018
29381415_96137,CM021110.1,11,29381415,18393162,391818,96137,18489299,8373764
29381415_125916,CM021110.1,11,29381415,18393162,391818,125916,18519078,8403543
29381415_131587,CM021110.1,11,29381415,18393162,391818,131587,18524749,8409214
29381415_131655,CM021110.1,11,29381415,18393162,391818,131655,18524817,8409282
29381415_131700,CM021110.1,11,29381415,18393162,391818,131700,18524862,8409327
29381415_131754,CM021110.1,11,29381415,18393162,391818,131754,18524916,8409381
29381415_131771,CM021110.1,11,29381415,18393162,391818,131771,18524933,8409398
29381415_131830,CM021110.1,11,29381415,18393162,391818,131830,18524992,8409457
29379186_401212,CM021110.1,11,29379186,18393162,732392,401212,18794374,8678839
29379186_572690,CM021110.1,11,29379186,18393162,732392,572690,18965852,8850317
29379186_572791,CM021110.1,11,29379186,18393162,732392,572791,18965953,8850418
29379186_673575,CM021110.1,11,29379186,18393162,732392,673575,19066737,8951202
29379186_673595,CM021110.1,11,29379186,18393162,732392,673595,19066757,8951222
29379200_90893,CM021110.1,11,29379200,40672091,321658,90893,40762984,30647449
29377588_220772,CM021110.1,11,29377588,69031092,2343286,220772,69251864,59136329
29377840_284647,CM021110.1,11,29377840,69031091,1279907,284647,69315738,59200203
29377588_365211,CM021110.1,11,29377588,69031092,2343286,365211,69396303,59280768
29382144_401575,CM021110.1,11,29382144,69031095,918720,401575,69432670,59317135
29377840_475595,CM021110.1,11,29377840,69031091,1279907,475595,69506686,59391151
29382144_538961,CM021110.1,11,29382144,69031095,918720,538961,69570056,59454521
29377840_562264,CM021110.1,11,29377840,69031091,1279907,562264,69593355,59477820
29377840_562340,CM021110.1,11,29377840,69031091,1279907,562340,69593431,59477896
29377840_578439,CM021110.1,11,29377840,69031091,1279907,578439,69609530,59493995
29377588_678114,CM021110.1,11,29377588,69031092,2343286,678114,69709206,59593671
29377840_692556,CM021110.1,11,29377840,69031091,1279907,692556,69723647,59608112
29377840_692593,CM021110.1,11,29377840,69031091,1279907,692593,69723684,59608149
29377840_692626,CM021110.1,11,29377840,69031091,1279907,692626,69723717,59608182
29377840_692918,CM021110.1,11,29377840,69031091,1279907,692918,69724009,59608474
29377840_718780,CM021110.1,11,29377840,69031091,1279907,718780,69749871,59634336
29377840_753763,CM021110.1,11,29377840,69031091,1279907,753763,69784854,59669319
29377840_753783,CM021110.1,11,29377840,69031091,1279907,753783,69784874,59669339
29377840_753826,CM021110.1,11,29377840,69031091,1279907,753826,69784917,59669382
29377840_753838,CM021110.1,11,29377840,69031091,1279907,753838,69784929,59669394
29377840_753953,CM021110.1,11,29377840,69031091,1279907,753953,69785044,59669509
29377840_753962,CM021110.1,11,29377840,69031091,1279907,753962,69785053,59669518
29377840_753982,CM021110.1,11,29377840,69031091,1279907,753982,69785073,59669538
29377840_753986,CM021110.1,11,29377840,69031091,1279907,753986,69785077,59669542
29377840_754013,CM021110.1,11,29377840,69031091,1279907,754013,69785104,59669569
29377840_754049,CM021110.1,11,29377840,69031091,1279907,754049,69785140,59669605
29377840_754055,CM021110.1,11,29377840,69031091,1279907,754055,69785146,59669611
29377588_883143,CM021110.1,11,29377588,69031092,2343286,883143,69914235,59798700
29377840_913579,CM021110.1,11,29377840,69031091,1279907,913579,69944670,59829135
29377840_913829,CM021110.1,11,29377840,69031091,1279907,913829,69944920,59829385
29377840_913880,CM021110.1,11,29377840,69031091,1279907,913880,69944971,59829436
29377840_914027,CM021110.1,11,29377840,69031091,1279907,914027,69945118,59829583
29377840_914041,CM021110.1,11,29377840,69031091,1279907,914041,69945132,59829597
29377840_914126,CM021110.1,11,29377840,69031091,1279907,914126,69945217,59829682
29377588_958314,CM021110.1,11,29377588,69031092,2343286,958314,69989406,59873871
29377588_958509,CM021110.1,11,29377588,69031092,2343286,958509,69989601,59874066
29377840_1000691,CM021110.1,11,29377840,69031091,1279907,1000691,70031782,59916247
29380756_24877,CM021110.1,11,29380756,84404700,468733,24877,84429577,74314042
29380756_175050,CM021110.1,11,29380756,84404700,468733,175050,84579750,74464215
29380756_249677,CM021110.1,11,29380756,84404700,468733,249677,84654377,74538842
29377426_316271,CM021110.1,11,29377426,84404700,597056,316271,84720971,74605436
29377426_539783,CM021110.1,11,29377426,84404700,597056,539783,84944483,74828948
29381006_10729,CM021110.1,11,29381006,99662044,1631516,10729,99672773,89557238
29381777_14736,CM021110.1,11,29381777,99664301,1200007,14736,99679037,89563502
29381777_14831,CM021110.1,11,29381777,99664301,1200007,14831,99679132,89563597
29381313_38872,CM021110.1,11,29381313,99662980,671879,38872,99701852,89586317
29381313_38896,CM021110.1,11,29381313,99662980,671879,38896,99701876,89586341
29381313_39495,CM021110.1,11,29381313,99662980,671879,39495,99702475,89586940
29381313_39535,CM021110.1,11,29381313,99662980,671879,39535,99702515,89586980
29381313_39548,CM021110.1,11,29381313,99662980,671879,39548,99702528,89586993
29381313_39582,CM021110.1,11,29381313,99662980,671879,39582,99702562,89587027
29381006_46250,CM021110.1,11,29381006,99662044,1631516,46250,99708294,89592759
29381313_61741,CM021110.1,11,29381313,99662980,671879,61741,99724721,89609186
29381313_69729,CM021110.1,11,29381313,99662980,671879,69729,99732709,89617174
29377460_135013,CM021110.1,11,29377460,99662043,468703,135013,99797056,89681521
29377460_135023,CM021110.1,11,29377460,99662043,468703,135023,99797066,89681531
29377460_135082,CM021110.1,11,29377460,99662043,468703,135082,99797125,89681590
29377460_135109,CM021110.1,11,29377460,99662043,468703,135109,99797152,89681617
29377460_135154,CM021110.1,11,29377460,99662043,468703,135154,99797197,89681662
29377460_135193,CM021110.1,11,29377460,99662043,468703,135193,99797236,89681701
29381006_143962,CM021110.1,11,29381006,99662044,1631516,143962,99806006,89690471
29381006_149192,CM021110.1,11,29381006,99662044,1631516,149192,99811236,89695701
29381006_149205,CM021110.1,11,29381006,99662044,1631516,149205,99811249,89695714
29377460_166171,CM021110.1,11,29377460,99662043,468703,166171,99828214,89712679
29377460_166235,CM021110.1,11,29377460,99662043,468703,166235,99828278,89712743
29377460_166288,CM021110.1,11,29377460,99662043,468703,166288,99828331,89712796
29377460_166324,CM021110.1,11,29377460,99662043,468703,166324,99828367,89712832
29377460_166328,CM021110.1,11,29377460,99662043,468703,166328,99828371,89712836
29377460_166331,CM021110.1,11,29377460,99662043,468703,166331,99828374,89712839
29380986_176355,CM021110.1,11,29380986,99662041,575538,176355,99838396,89722861
29380986_176391,CM021110.1,11,29380986,99662041,575538,176391,99838432,89722897
29380986_176531,CM021110.1,11,29380986,99662041,575538,176531,99838572,89723037
29380986_176579,CM021110.1,11,29380986,99662041,575538,176579,99838620,89723085
29381006_228450,CM021110.1,11,29381006,99662044,1631516,228450,99890494,89774959
29381006_228513,CM021110.1,11,29381006,99662044,1631516,228513,99890557,89775022
29381006_228536,CM021110.1,11,29381006,99662044,1631516,228536,99890580,89775045
29380152_238974,CM021110.1,11,29380152,99664902,1013785,238974,99903876,89788341
29378960_251098,CM021110.1,11,29378960,99662038,933223,251098,99913136,89797601
29378960_255484,CM021110.1,11,29378960,99662038,933223,255484,99917522,89801987
29380781_259081,CM021110.1,11,29380781,99662043,1244480,259081,99921124,89805589
29378100_284992,CM021110.1,11,29378100,99662371,1121895,284992,99947363,89831828
29378100_284997,CM021110.1,11,29378100,99662371,1121895,284997,99947368,89831833
29378100_285029,CM021110.1,11,29378100,99662371,1121895,285029,99947400,89831865
29378100_285045,CM021110.1,11,29378100,99662371,1121895,285045,99947416,89831881
29378100_285085,CM021110.1,11,29378100,99662371,1121895,285085,99947456,89831921
29378100_285091,CM021110.1,11,29378100,99662371,1121895,285091,99947462,89831927
29378100_285093,CM021110.1,11,29378100,99662371,1121895,285093,99947464,89831929
29378100_285098,CM021110.1,11,29378100,99662371,1121895,285098,99947469,89831934
29379871_295253,CM021110.1,11,29379871,99662044,4360676,295253,99957297,89841762
29380152_298366,CM021110.1,11,29380152,99664902,1013785,298366,99963268,89847733
29380781_324123,CM021110.1,11,29380781,99662043,1244480,324123,99986166,89870631
29377755_342206,CM021110.1,11,29377755,99662044,534102,342206,100004250,89888715
29381449_348093,CM021110.1,11,29381449,99662043,1284370,348093,100010136,89894601
29381449_348102,CM021110.1,11,29381449,99662043,1284370,348102,100010145,89894610
29381449_348150,CM021110.1,11,29381449,99662043,1284370,348150,100010193,89894658
29381449_348156,CM021110.1,11,29381449,99662043,1284370,348156,100010199,89894664
29381313_352888,CM021110.1,11,29381313,99662980,671879,352888,100015868,89900333
29381313_352968,CM021110.1,11,29381313,99662980,671879,352968,100015948,89900413
29381313_356180,CM021110.1,11,29381313,99662980,671879,356180,100019160,89903625
29381349_363011,CM021110.1,11,29381349,99662039,2122704,363011,100025050,89909515
29381349_363078,CM021110.1,11,29381349,99662039,2122704,363078,100025117,89909582
29381313_366214,CM021110.1,11,29381313,99662980,671879,366214,100029194,89913659
29381313_377367,CM021110.1,11,29381313,99662980,671879,377367,100040347,89924812
29381313_377451,CM021110.1,11,29381313,99662980,671879,377451,100040431,89924896
29380152_440875,CM021110.1,11,29380152,99664902,1013785,440875,100105777,89990242
29380152_441283,CM021110.1,11,29380152,99664902,1013785,441283,100106185,89990650
29380152_528990,CM021110.1,11,29380152,99664902,1013785,528990,100193892,90078357
29378100_601744,CM021110.1,11,29378100,99662371,1121895,601744,100264115,90148580
29378100_601749,CM021110.1,11,29378100,99662371,1121895,601749,100264120,90148585
29378100_601883,CM021110.1,11,29378100,99662371,1121895,601883,100264254,90148719
29378100_602605,CM021110.1,11,29378100,99662371,1121895,602605,100264976,90149441
29380152_606050,CM021110.1,11,29380152,99664902,1013785,606050,100270952,90155417
29380152_659766,CM021110.1,11,29380152,99664902,1013785,659766,100324668,90209133
29378960_734582,CM021110.1,11,29378960,99662038,933223,734582,100396620,90281085
29378960_762121,CM021110.1,11,29378960,99662038,933223,762121,100424159,90308624
29378960_821223,CM021110.1,11,29378960,99662038,933223,821223,100483261,90367726
29377844_896448,CM021110.1,11,29377844,99662039,2057237,896448,100558487,90442952
29380152_914546,CM021110.1,11,29380152,99664902,1013785,914546,100579448,90463913
29380152_914749,CM021110.1,11,29380152,99664902,1013785,914749,100579651,90464116
29380152_915264,CM021110.1,11,29380152,99664902,1013785,915264,100580166,90464631
29380152_915327,CM021110.1,11,29380152,99664902,1013785,915327,100580229,90464694
29380152_915372,CM021110.1,11,29380152,99664902,1013785,915372,100580274,90464739
29380152_916372,CM021110.1,11,29380152,99664902,1013785,916372,100581274,90465739
29380152_916379,CM021110.1,11,29380152,99664902,1013785,916379,100581281,90465746
29380152_916638,CM021110.1,11,29380152,99664902,1013785,916638,100581540,90466005
29380152_916647,CM021110.1,11,29380152,99664902,1013785,916647,100581549,90466014
29379871_1053920,CM021110.1,11,29379871,99662044,4360676,1053920,100715964,90600429
29379871_1054034,CM021110.1,11,29379871,99662044,4360676,1054034,100716078,90600543
29379871_1089075,CM021110.1,11,29379871,99662044,4360676,1089075,100751119,90635584
29378100_1119313,CM021110.1,11,29378100,99662371,1121895,1119313,100781684,90666149
29378100_1119314,CM021110.1,11,29378100,99662371,1121895,1119314,100781685,90666150
29381006_1165375,CM021110.1,11,29381006,99662044,1631516,1165375,100827419,90711884
29379871_1234682,CM021110.1,11,29379871,99662044,4360676,1234682,100896726,90781191
29381006_1249301,CM021110.1,11,29381006,99662044,1631516,1249301,100911345,90795810
29381006_1249371,CM021110.1,11,29381006,99662044,1631516,1249371,100911415,90795880
29379288_1255152,CM021110.1,11,29379288,99662044,2431035,1255152,100917196,90801661
29379288_1259100,CM021110.1,11,29379288,99662044,2431035,1259100,100921144,90805609
29379871_1271788,CM021110.1,11,29379871,99662044,4360676,1271788,100933832,90818297
29379871_1274497,CM021110.1,11,29379871,99662044,4360676,1274497,100936541,90821006
29379871_1293488,CM021110.1,11,29379871,99662044,4360676,1293488,100955532,90839997
29379288_1689715,CM021110.1,11,29379288,99662044,2431035,1689715,101351759,91236224
29379288_1710909,CM021110.1,11,29379288,99662044,2431035,1710909,101372953,91257418
29379288_1710991,CM021110.1,11,29379288,99662044,2431035,1710991,101373035,91257500
29379288_1710998,CM021110.1,11,29379288,99662044,2431035,1710998,101373042,91257507
29379871_1730408,CM021110.1,11,29379871,99662044,4360676,1730408,101392452,91276917
29379288_1765129,CM021110.1,11,29379288,99662044,2431035,1765129,101427173,91311638
29381349_2013861,CM021110.1,11,29381349,99662039,2122704,2013861,101675900,91560365
29381349_2013904,CM021110.1,11,29381349,99662039,2122704,2013904,101675943,91560408
29378459_2111529,CM021110.1,11,29378459,99662045,3573255,2111529,101773574,91658039
29378459_2111537,CM021110.1,11,29378459,99662045,3573255,2111537,101773582,91658047
29378459_2111574,CM021110.1,11,29378459,99662045,3573255,2111574,101773619,91658084
29378459_2113440,CM021110.1,11,29378459,99662045,3573255,2113440,101775485,91659950
29378459_2118272,CM021110.1,11,29378459,99662045,3573255,2118272,101780317,91664782
29378459_2120765,CM021110.1,11,29378459,99662045,3573255,2120765,101782810,91667275
29378459_2120781,CM021110.1,11,29378459,99662045,3573255,2120781,101782826,91667291
29381724_2129854,CM021110.1,11,29381724,99662044,2603317,2129854,101791898,91676363
29381724_2129986,CM021110.1,11,29381724,99662044,2603317,2129986,101792030,91676495
29381724_2129987,CM021110.1,11,29381724,99662044,2603317,2129987,101792031,91676496
29381724_2129989,CM021110.1,11,29381724,99662044,2603317,2129989,101792033,91676498
29381724_2130140,CM021110.1,11,29381724,99662044,2603317,2130140,101792184,91676649
29381724_2130446,CM021110.1,11,29381724,99662044,2603317,2130446,101792490,91676955
29378459_2139605,CM021110.1,11,29378459,99662045,3573255,2139605,101801650,91686115
29379288_2159925,CM021110.1,11,29379288,99662044,2431035,2159925,101821969,91706434
29379871_2185590,CM021110.1,11,29379871,99662044,4360676,2185590,101847634,91732099
29378459_2401396,CM021110.1,11,29378459,99662045,3573255,2401396,102063441,91947906
29378459_2401443,CM021110.1,11,29378459,99662045,3573255,2401443,102063488,91947953
29379871_2563306,CM021110.1,11,29379871,99662044,4360676,2563306,102225350,92109815
29379871_2609232,CM021110.1,11,29379871,99662044,4360676,2609232,102271276,92155741
29379871_2609286,CM021110.1,11,29379871,99662044,4360676,2609286,102271330,92155795
29379871_2609312,CM021110.1,11,29379871,99662044,4360676,2609312,102271356,92155821
29379871_2609333,CM021110.1,11,29379871,99662044,4360676,2609333,102271377,92155842
29379871_2612529,CM021110.1,11,29379871,99662044,4360676,2612529,102274573,92159038
29379871_2624356,CM021110.1,11,29379871,99662044,4360676,2624356,102286400,92170865
29379871_2624371,CM021110.1,11,29379871,99662044,4360676,2624371,102286415,92170880
29379871_2626343,CM021110.1,11,29379871,99662044,4360676,2626343,102288387,92172852
29379871_2626356,CM021110.1,11,29379871,99662044,4360676,2626356,102288400,92172865
29379871_2626368,CM021110.1,11,29379871,99662044,4360676,2626368,102288412,92172877
29379871_2626914,CM021110.1,11,29379871,99662044,4360676,2626914,102288958,92173423
29379871_2626948,CM021110.1,11,29379871,99662044,4360676,2626948,102288992,92173457
29379871_2626949,CM021110.1,11,29379871,99662044,4360676,2626949,102288993,92173458
29379871_2743768,CM021110.1,11,29379871,99662044,4360676,2743768,102405812,92290277
29378459_2982812,CM021110.1,11,29378459,99662045,3573255,2982812,102644857,92529322
29378459_3173021,CM021110.1,11,29378459,99662045,3573255,3173021,102835066,92719531
29378459_3173050,CM021110.1,11,29378459,99662045,3573255,3173050,102835095,92719560
29379871_3796682,CM021110.1,11,29379871,99662044,4360676,3796682,103458726,93343191
29379871_3920596,CM021110.1,11,29379871,99662044,4360676,3920596,103582640,93467105
29379871_4217509,CM021110.1,11,29379871,99662044,4360676,4217509,103879553,93764018
29379871_4312688,CM021110.1,11,29379871,99662044,4360676,4312688,103974732,93859197
29376288_19964,CM021110.1,11,29376288,122820497,179962,19964,122840461,112724926
29381001_18809,CM021110.1,11,29381001,146487177,121748,18809,146505986,136390451
29350469_6928,CM021110.1,11,29350469,152368535,17637,6928,152375463,142259928
29381865_35689,CM021110.1,11,29381865,160197064,727802,35689,160232753,150117218
29381865_60646,CM021110.1,11,29381865,160197064,727802,60646,160257710,150142175
29381348_162477,CM021110.1,11,29381348,160197066,2293629,162477,160359543,150244008
29381348_162509,CM021110.1,11,29381348,160197066,2293629,162509,160359575,150244040
29381348_162553,CM021110.1,11,29381348,160197066,2293629,162553,160359619,150244084
29381348_162574,CM021110.1,11,29381348,160197066,2293629,162574,160359640,150244105
29381348_162897,CM021110.1,11,29381348,160197066,2293629,162897,160359963,150244428
29381348_162973,CM021110.1,11,29381348,160197066,2293629,162973,160360039,150244504
29381348_253832,CM021110.1,11,29381348,160197066,2293629,253832,160450898,150335363
29381348_253891,CM021110.1,11,29381348,160197066,2293629,253891,160450957,150335422
29381348_253895,CM021110.1,11,29381348,160197066,2293629,253895,160450961,150335426
29381865_421444,CM021110.1,11,29381865,160197064,727802,421444,160618508,150502973
29379865_466569,CM021110.1,11,29379865,160197066,780686,466569,160663635,150548100
29381865_493207,CM021110.1,11,29381865,160197064,727802,493207,160690271,150574736
29381865_493229,CM021110.1,11,29381865,160197064,727802,493229,160690293,150574758
29379865_611808,CM021110.1,11,29379865,160197066,780686,611808,160808874,150693339
29379865_623190,CM021110.1,11,29379865,160197066,780686,623190,160820256,150704721
29379865_623251,CM021110.1,11,29379865,160197066,780686,623251,160820317,150704782
29381348_697585,CM021110.1,11,29381348,160197066,2293629,697585,160894651,150779116
29380570_954873,CM021110.1,11,29380570,160198573,984901,954873,161153446,151037911
29380570_954875,CM021110.1,11,29380570,160198573,984901,954875,161153448,151037913
29379154_11711,CM021110.1,11,29379154,163773064,376224,11711,163784775,153669240
29379154_11750,CM021110.1,11,29379154,163773064,376224,11750,163784814,153669279
29379154_11790,CM021110.1,11,29379154,163773064,376224,11790,163784854,153669319
29379154_11803,CM021110.1,11,29379154,163773064,376224,11803,163784867,153669332
29379154_11826,CM021110.1,11,29379154,163773064,376224,11826,163784890,153669355
29379154_11836,CM021110.1,11,29379154,163773064,376224,11836,163784900,153669365
29379154_11866,CM021110.1,11,29379154,163773064,376224,11866,163784930,153669395
29378559_21485,CM021110.1,11,29378559,163774960,183895,21485,163796445,153680910
29378559_21784,CM021110.1,11,29378559,163774960,183895,21784,163796744,153681209
29378559_105359,CM021110.1,11,29378559,163774960,183895,105359,163880319,153764784
29378456_126402,CM021110.1,11,29378456,163775984,2167643,126402,163902386,153786851
29378456_126480,CM021110.1,11,29378456,163775984,2167643,126480,163902464,153786929
29378456_126492,CM021110.1,11,29378456,163775984,2167643,126492,163902476,153786941
29378456_126493,CM021110.1,11,29378456,163775984,2167643,126493,163902477,153786942
29377384_176988,CM021110.1,11,29377384,163776636,1665171,176988,163953624,153838089
29377870_192946,CM021110.1,11,29377870,163775224,1387080,192946,163968170,153852635
29377870_193005,CM021110.1,11,29377870,163775224,1387080,193005,163968229,153852694
29377870_193095,CM021110.1,11,29377870,163775224,1387080,193095,163968319,153852784
29377870_204102,CM021110.1,11,29377870,163775224,1387080,204102,163979326,153863791
29377870_204262,CM021110.1,11,29377870,163775224,1387080,204262,163979486,153863951
29377870_204348,CM021110.1,11,29377870,163775224,1387080,204348,163979572,153864037
29377384_227658,CM021110.1,11,29377384,163776636,1665171,227658,164004294,153888759
29377870_400660,CM021110.1,11,29377870,163775224,1387080,400660,164175884,154060349
29377870_400684,CM021110.1,11,29377870,163775224,1387080,400684,164175908,154060373
29377870_400703,CM021110.1,11,29377870,163775224,1387080,400703,164175927,154060392
29377870_400706,CM021110.1,11,29377870,163775224,1387080,400706,164175930,154060395
29377870_400750,CM021110.1,11,29377870,163775224,1387080,400750,164175974,154060439
29378751_538295,CM021110.1,11,29378751,163779760,1087759,538295,164318055,154202520
29378751_538366,CM021110.1,11,29378751,163779760,1087759,538366,164318126,154202591
29380021_749957,CM021110.1,11,29380021,163773061,1796303,749957,164523018,154407483
29377384_806678,CM021110.1,11,29377384,163776636,1665171,806678,164583314,154467779
29377384_806781,CM021110.1,11,29377384,163776636,1665171,806781,164583417,154467882
29377384_806800,CM021110.1,11,29377384,163776636,1665171,806800,164583436,154467901
29377384_806811,CM021110.1,11,29377384,163776636,1665171,806811,164583447,154467912
29380021_972611,CM021110.1,11,29380021,163773061,1796303,972611,164745672,154630137
29359020_499,CM021110.1,11,29359020,164758640,32755,499,164759139,154643604
29359020_516,CM021110.1,11,29359020,164758640,32755,516,164759156,154643621
29359020_517,CM021110.1,11,29359020,164758640,32755,517,164759157,154643622
29359020_557,CM021110.1,11,29359020,164758640,32755,557,164759197,154643662
29378163_479,CM021110.1,11,29378163,164758974,347561,479,164759453,154643918
29378163_517,CM021110.1,11,29378163,164758974,347561,517,164759491,154643956
29378163_520,CM021110.1,11,29378163,164758974,347561,520,164759494,154643959
29378163_527,CM021110.1,11,29378163,164758974,347561,527,164759501,154643966
29378163_565,CM021110.1,11,29378163,164758974,347561,565,164759539,154644004
29378163_570,CM021110.1,11,29378163,164758974,347561,570,164759544,154644009
29378163_571,CM021110.1,11,29378163,164758974,347561,571,164759545,154644010
29378163_627,CM021110.1,11,29378163,164758974,347561,627,164759601,154644066
29381320_1040184,CM021110.1,11,29381320,163776013,2439371,1040184,164816197,154700662
29381320_1040264,CM021110.1,11,29381320,163776013,2439371,1040264,164816277,154700742
29381320_1080349,CM021110.1,11,29381320,163776013,2439371,1080349,164856362,154740827
29380913_1400465,CM021110.1,11,29380913,163776708,2480657,1400465,165177173,155061638
29380913_1400496,CM021110.1,11,29380913,163776708,2480657,1400496,165177204,155061669
29380913_1401502,CM021110.1,11,29380913,163776708,2480657,1401502,165178210,155062675
29380913_1401536,CM021110.1,11,29380913,163776708,2480657,1401536,165178244,155062709
29381320_1430923,CM021110.1,11,29381320,163776013,2439371,1430923,165206936,155091401
29381320_1430926,CM021110.1,11,29381320,163776013,2439371,1430926,165206939,155091404
29381320_1431024,CM021110.1,11,29381320,163776013,2439371,1431024,165207037,155091502
29381320_1431071,CM021110.1,11,29381320,163776013,2439371,1431071,165207084,155091549
29380021_1436997,CM021110.1,11,29380021,163773061,1796303,1436997,165210058,155094523
29380021_1439298,CM021110.1,11,29380021,163773061,1796303,1439298,165212359,155096824
29380021_1439406,CM021110.1,11,29380021,163773061,1796303,1439406,165212467,155096932
29380021_1439749,CM021110.1,11,29380021,163773061,1796303,1439749,165212810,155097275
29378456_1483938,CM021110.1,11,29378456,163775984,2167643,1483938,165259922,155144387
29378456_1483949,CM021110.1,11,29378456,163775984,2167643,1483949,165259933,155144398
29378456_1483991,CM021110.1,11,29378456,163775984,2167643,1483991,165259975,155144440
29378456_1484019,CM021110.1,11,29378456,163775984,2167643,1484019,165260003,155144468
29378456_1506651,CM021110.1,11,29378456,163775984,2167643,1506651,165282635,155167100
29378456_1544764,CM021110.1,11,29378456,163775984,2167643,1544764,165320748,155205213
29378456_1545063,CM021110.1,11,29378456,163775984,2167643,1545063,165321047,155205512
29378456_1545078,CM021110.1,11,29378456,163775984,2167643,1545078,165321062,155205527
29378456_1545090,CM021110.1,11,29378456,163775984,2167643,1545090,165321074,155205539
29381284_1558767,CM021110.1,11,29381284,163777375,2074928,1558767,165336142,155220607
29381284_1558912,CM021110.1,11,29381284,163777375,2074928,1558912,165336287,155220752
29381284_1558927,CM021110.1,11,29381284,163777375,2074928,1558927,165336302,155220767
29381284_1558950,CM021110.1,11,29381284,163777375,2074928,1558950,165336325,155220790
29381320_1569298,CM021110.1,11,29381320,163776013,2439371,1569298,165345311,155229776
29378456_1571107,CM021110.1,11,29378456,163775984,2167643,1571107,165347091,155231556
29378456_1571176,CM021110.1,11,29378456,163775984,2167643,1571176,165347160,155231625
29378456_1963337,CM021110.1,11,29378456,163775984,2167643,1963337,165739321,155623786
29378456_2082348,CM021110.1,11,29378456,163775984,2167643,2082348,165858332,155742797
29378456_2087668,CM021110.1,11,29378456,163775984,2167643,2087668,165863652,155748117
29380913_2229224,CM021110.1,11,29380913,163776708,2480657,2229224,166005932,155890397
29380913_2229483,CM021110.1,11,29380913,163776708,2480657,2229483,166006191,155890656
29379326_78036,CM021110.1,11,29379326,174295051,222855,78036,174373087,164257552
29379326_78094,CM021110.1,11,29379326,174295051,222855,78094,174373145,164257610
29379326_78420,CM021110.1,11,29379326,174295051,222855,78420,174373471,164257936
29379326_78422,CM021110.1,11,29379326,174295051,222855,78422,174373473,164257938
29382408_12113,CM021110.1,11,29382408,190752682,100921,12113,190764795,180649260
29378511_20103,CM021110.1,11,29378511,190755079,2434841,20103,190775182,180659647
29339864_15959,CM021110.1,11,29339864,190759805,38203,15959,190775764,180660229
29381030_57106,CM021110.1,11,29381030,190753463,1362606,57106,190810569,180695034
29381030_57131,CM021110.1,11,29381030,190753463,1362606,57131,190810594,180695059
29381030_57138,CM021110.1,11,29381030,190753463,1362606,57138,190810601,180695066
29381030_57169,CM021110.1,11,29381030,190753463,1362606,57169,190810632,180695097
29381030_57208,CM021110.1,11,29381030,190753463,1362606,57208,190810671,180695136
29381030_57596,CM021110.1,11,29381030,190753463,1362606,57596,190811059,180695524
29381066_77277,CM021110.1,11,29381066,190757321,2049854,77277,190834598,180719063
29380040_83669,CM021110.1,11,29380040,190752678,300429,83669,190836347,180720812
29380590_82510,CM021110.1,11,29380590,190760953,442533,82510,190843463,180727928
29379092_117658,CM021110.1,11,29379092,190754016,543873,117658,190871674,180756139
29379092_117710,CM021110.1,11,29379092,190754016,543873,117710,190871726,180756191
29381330_129244,CM021110.1,11,29381330,190758312,618613,129244,190887556,180772021
29382280_133281,CM021110.1,11,29382280,190757846,1438739,133281,190891127,180775592
29382280_133369,CM021110.1,11,29382280,190757846,1438739,133369,190891215,180775680
29382280_134918,CM021110.1,11,29382280,190757846,1438739,134918,190892764,180777229
29381030_141365,CM021110.1,11,29381030,190753463,1362606,141365,190894828,180779293
29381030_141437,CM021110.1,11,29381030,190753463,1362606,141437,190894900,180779365
29381030_141504,CM021110.1,11,29381030,190753463,1362606,141504,190894967,180779432
29381030_142023,CM021110.1,11,29381030,190753463,1362606,142023,190895486,180779951
29381030_143222,CM021110.1,11,29381030,190753463,1362606,143222,190896685,180781150
29381330_148056,CM021110.1,11,29381330,190758312,618613,148056,190906368,180790833
29382280_153120,CM021110.1,11,29382280,190757846,1438739,153120,190910966,180795431
29379242_153269,CM021110.1,11,29379242,190758330,1060087,153269,190911599,180796064
29382280_162789,CM021110.1,11,29382280,190757846,1438739,162789,190920635,180805100
29381030_170194,CM021110.1,11,29381030,190753463,1362606,170194,190923657,180808122
29381030_170235,CM021110.1,11,29381030,190753463,1362606,170235,190923698,180808163
29382280_179767,CM021110.1,11,29382280,190757846,1438739,179767,190937613,180822078
29378511_183076,CM021110.1,11,29378511,190755079,2434841,183076,190938155,180822620
29378511_183109,CM021110.1,11,29378511,190755079,2434841,183109,190938188,180822653
29378511_183118,CM021110.1,11,29378511,190755079,2434841,183118,190938197,180822662
29378511_183162,CM021110.1,11,29378511,190755079,2434841,183162,190938241,180822706
29380590_191234,CM021110.1,11,29380590,190760953,442533,191234,190952187,180836652
29382280_201108,CM021110.1,11,29382280,190757846,1438739,201108,190958954,180843419
29382280_201295,CM021110.1,11,29382280,190757846,1438739,201295,190959141,180843606
29378511_217566,CM021110.1,11,29378511,190755079,2434841,217566,190972645,180857110
29378511_217601,CM021110.1,11,29378511,190755079,2434841,217601,190972680,180857145
29378511_217647,CM021110.1,11,29378511,190755079,2434841,217647,190972726,180857191
29378511_217649,CM021110.1,11,29378511,190755079,2434841,217649,190972728,180857193
29378511_217674,CM021110.1,11,29378511,190755079,2434841,217674,190972753,180857218
29378511_217675,CM021110.1,11,29378511,190755079,2434841,217675,190972754,180857219
29381330_216501,CM021110.1,11,29381330,190758312,618613,216501,190974813,180859278
29381330_217562,CM021110.1,11,29381330,190758312,618613,217562,190975874,180860339
29377945_249972,CM021110.1,11,29377945,190757906,1625936,249972,191007878,180892343
29377945_250031,CM021110.1,11,29377945,190757906,1625936,250031,191007937,180892402
29377945_250065,CM021110.1,11,29377945,190757906,1625936,250065,191007971,180892436
29377945_251187,CM021110.1,11,29377945,190757906,1625936,251187,191009093,180893558
29377945_251207,CM021110.1,11,29377945,190757906,1625936,251207,191009113,180893578
29377945_253628,CM021110.1,11,29377945,190757906,1625936,253628,191011534,180895999
29382280_373247,CM021110.1,11,29382280,190757846,1438739,373247,191131093,181015558
29378511_401986,CM021110.1,11,29378511,190755079,2434841,401986,191157065,181041530
29378511_402000,CM021110.1,11,29378511,190755079,2434841,402000,191157079,181041544
29378511_402018,CM021110.1,11,29378511,190755079,2434841,402018,191157097,181041562
29382280_400950,CM021110.1,11,29382280,190757846,1438739,400950,191158796,181043261
29377945_402419,CM021110.1,11,29377945,190757906,1625936,402419,191160325,181044790
29377945_402446,CM021110.1,11,29377945,190757906,1625936,402446,191160352,181044817
29378093_439451,CM021110.1,11,29378093,190752682,1302889,439451,191192133,181076598
29377945_434792,CM021110.1,11,29377945,190757906,1625936,434792,191192698,181077163
29377945_434874,CM021110.1,11,29377945,190757906,1625936,434874,191192780,181077245
29378093_440102,CM021110.1,11,29378093,190752682,1302889,440102,191192784,181077249
29378093_440135,CM021110.1,11,29378093,190752682,1302889,440135,191192817,181077282
29378093_440248,CM021110.1,11,29378093,190752682,1302889,440248,191192930,181077395
29378705_437513,CM021110.1,11,29378705,190758764,493194,437513,191196277,181080742
29378093_444779,CM021110.1,11,29378093,190752682,1302889,444779,191197461,181081926
29379242_440907,CM021110.1,11,29379242,190758330,1060087,440907,191199237,181083702
29379242_440947,CM021110.1,11,29379242,190758330,1060087,440947,191199277,181083742
29378093_452965,CM021110.1,11,29378093,190752682,1302889,452965,191205647,181090112
29378093_453285,CM021110.1,11,29378093,190752682,1302889,453285,191205967,181090432
29379242_459396,CM021110.1,11,29379242,190758330,1060087,459396,191217726,181102191
29379242_459693,CM021110.1,11,29379242,190758330,1060087,459693,191218023,181102488
29379242_459770,CM021110.1,11,29379242,190758330,1060087,459770,191218100,181102565
29377945_461498,CM021110.1,11,29377945,190757906,1625936,461498,191219404,181103869
29378705_469456,CM021110.1,11,29378705,190758764,493194,469456,191228220,181112685
29377192_472138,CM021110.1,11,29377192,190757257,2934256,472138,191229395,181113860
29377192_472141,CM021110.1,11,29377192,190757257,2934256,472141,191229398,181113863
29378093_490728,CM021110.1,11,29378093,190752682,1302889,490728,191243410,181127875
29381066_490680,CM021110.1,11,29381066,190757321,2049854,490680,191248001,181132466
29381066_490959,CM021110.1,11,29381066,190757321,2049854,490959,191248280,181132745
29381066_490974,CM021110.1,11,29381066,190757321,2049854,490974,191248295,181132760
29381066_492427,CM021110.1,11,29381066,190757321,2049854,492427,191249748,181134213
29381066_494480,CM021110.1,11,29381066,190757321,2049854,494480,191251801,181136266
29381066_494514,CM021110.1,11,29381066,190757321,2049854,494514,191251835,181136300
29381066_494534,CM021110.1,11,29381066,190757321,2049854,494534,191251855,181136320
29382280_549414,CM021110.1,11,29382280,190757846,1438739,549414,191307260,181191725
29382280_568582,CM021110.1,11,29382280,190757846,1438739,568582,191326428,181210893
29382280_568607,CM021110.1,11,29382280,190757846,1438739,568607,191326453,181210918
29382280_568615,CM021110.1,11,29382280,190757846,1438739,568615,191326461,181210926
29382280_568628,CM021110.1,11,29382280,190757846,1438739,568628,191326474,181210939
29382280_568665,CM021110.1,11,29382280,190757846,1438739,568665,191326511,181210976
29382280_568683,CM021110.1,11,29382280,190757846,1438739,568683,191326529,181210994
29381066_579371,CM021110.1,11,29381066,190757321,2049854,579371,191336692,181221157
29378511_609516,CM021110.1,11,29378511,190755079,2434841,609516,191364595,181249060
29377945_662241,CM021110.1,11,29377945,190757906,1625936,662241,191420147,181304612
29382280_684035,CM021110.1,11,29382280,190757846,1438739,684035,191441881,181326346
29382280_684078,CM021110.1,11,29382280,190757846,1438739,684078,191441924,181326389
29382280_684090,CM021110.1,11,29382280,190757846,1438739,684090,191441936,181326401
29382280_684100,CM021110.1,11,29382280,190757846,1438739,684100,191441946,181326411
29382280_686153,CM021110.1,11,29382280,190757846,1438739,686153,191443999,181328464
29381030_693651,CM021110.1,11,29381030,190753463,1362606,693651,191447114,181331579
29381030_693927,CM021110.1,11,29381030,190753463,1362606,693927,191447390,181331855
29381030_695593,CM021110.1,11,29381030,190753463,1362606,695593,191449056,181333521
29381030_696549,CM021110.1,11,29381030,190753463,1362606,696549,191450012,181334477
29381030_696842,CM021110.1,11,29381030,190753463,1362606,696842,191450305,181334770
29381030_696873,CM021110.1,11,29381030,190753463,1362606,696873,191450336,181334801
29382280_745078,CM021110.1,11,29382280,190757846,1438739,745078,191502924,181387389
29382280_746369,CM021110.1,11,29382280,190757846,1438739,746369,191504215,181388680
29382280_746370,CM021110.1,11,29382280,190757846,1438739,746370,191504216,181388681
29378511_752799,CM021110.1,11,29378511,190755079,2434841,752799,191507878,181392343
29378511_752906,CM021110.1,11,29378511,190755079,2434841,752906,191507985,181392450
29378511_752918,CM021110.1,11,29378511,190755079,2434841,752918,191507997,181392462
29378511_759609,CM021110.1,11,29378511,190755079,2434841,759609,191514688,181399153
29378511_759648,CM021110.1,11,29378511,190755079,2434841,759648,191514727,181399192
29378511_759664,CM021110.1,11,29378511,190755079,2434841,759664,191514743,181399208
29378511_759675,CM021110.1,11,29378511,190755079,2434841,759675,191514754,181399219
29378511_759737,CM021110.1,11,29378511,190755079,2434841,759737,191514816,181399281
29379630_767086,CM021110.1,11,29379630,190757417,8470972,767086,191524503,181408968
29379630_767095,CM021110.1,11,29379630,190757417,8470972,767095,191524512,181408977
29379242_770010,CM021110.1,11,29379242,190758330,1060087,770010,191528340,181412805
29382280_781425,CM021110.1,11,29382280,190757846,1438739,781425,191539271,181423736
29377680_795365,CM021110.1,11,29377680,190752681,3434283,795365,191548046,181432511
29382280_792515,CM021110.1,11,29382280,190757846,1438739,792515,191550361,181434826
29382280_792516,CM021110.1,11,29382280,190757846,1438739,792516,191550362,181434827
29382280_792518,CM021110.1,11,29382280,190757846,1438739,792518,191550364,181434829
29382280_792525,CM021110.1,11,29382280,190757846,1438739,792525,191550371,181434836
29382280_792533,CM021110.1,11,29382280,190757846,1438739,792533,191550379,181434844
29382280_880885,CM021110.1,11,29382280,190757846,1438739,880885,191638731,181523196
29382280_880894,CM021110.1,11,29382280,190757846,1438739,880894,191638740,181523205
29382280_880895,CM021110.1,11,29382280,190757846,1438739,880895,191638741,181523206
29382280_880981,CM021110.1,11,29382280,190757846,1438739,880981,191638827,181523292
29382280_881925,CM021110.1,11,29382280,190757846,1438739,881925,191639771,181524236
29377192_893920,CM021110.1,11,29377192,190757257,2934256,893920,191651177,181535642
29377192_893985,CM021110.1,11,29377192,190757257,2934256,893985,191651242,181535707
29377192_893987,CM021110.1,11,29377192,190757257,2934256,893987,191651244,181535709
29381066_934381,CM021110.1,11,29381066,190757321,2049854,934381,191691702,181576167
29381066_934405,CM021110.1,11,29381066,190757321,2049854,934405,191691726,181576191
29377192_940526,CM021110.1,11,29377192,190757257,2934256,940526,191697783,181582248
29378511_945403,CM021110.1,11,29378511,190755079,2434841,945403,191700482,181584947
29378511_945416,CM021110.1,11,29378511,190755079,2434841,945416,191700495,181584960
29379079_957436,CM021110.1,11,29379079,190756953,7369967,957436,191714389,181598854
29379079_986989,CM021110.1,11,29379079,190756953,7369967,986989,191743942,181628407
29379079_997609,CM021110.1,11,29379079,190756953,7369967,997609,191754562,181639027
29379079_999306,CM021110.1,11,29379079,190756953,7369967,999306,191756259,181640724
29379079_999318,CM021110.1,11,29379079,190756953,7369967,999318,191756271,181640736
29379079_999437,CM021110.1,11,29379079,190756953,7369967,999437,191756390,181640855
29379079_1019219,CM021110.1,11,29379079,190756953,7369967,1019219,191776172,181660637
29379079_1020013,CM021110.1,11,29379079,190756953,7369967,1020013,191776966,181661431
29381066_1030180,CM021110.1,11,29381066,190757321,2049854,1030180,191787501,181671966
29381030_1166471,CM021110.1,11,29381030,190753463,1362606,1166471,191919934,181804399
29377414_1181190,CM021110.1,11,29377414,190760021,2279096,1181190,191941211,181825676
29377414_1181193,CM021110.1,11,29377414,190760021,2279096,1181193,191941214,181825679
29377414_1181194,CM021110.1,11,29377414,190760021,2279096,1181194,191941215,181825680
29377414_1181214,CM021110.1,11,29377414,190760021,2279096,1181214,191941235,181825700
29377414_1181299,CM021110.1,11,29377414,190760021,2279096,1181299,191941320,181825785
29377414_1181677,CM021110.1,11,29377414,190760021,2279096,1181677,191941698,181826163
29382280_1201265,CM021110.1,11,29382280,190757846,1438739,1201265,191959111,181843576
29378377_1243195,CM021110.1,11,29378377,190752682,5332615,1243195,191995877,181880342
29381030_1273616,CM021110.1,11,29381030,190753463,1362606,1273616,192027079,181911544
29377945_1483124,CM021110.1,11,29377945,190757906,1625936,1483124,192241030,182125495
29381066_1621812,CM021110.1,11,29381066,190757321,2049854,1621812,192379133,182263598
29381066_1621987,CM021110.1,11,29381066,190757321,2049854,1621987,192379308,182263773
29381066_1622023,CM021110.1,11,29381066,190757321,2049854,1622023,192379344,182263809
29377680_1628100,CM021110.1,11,29377680,190752681,3434283,1628100,192380781,182265246
29377680_1628132,CM021110.1,11,29377680,190752681,3434283,1628132,192380813,182265278
29377680_1628160,CM021110.1,11,29377680,190752681,3434283,1628160,192380841,182265306
29377680_1628163,CM021110.1,11,29377680,190752681,3434283,1628163,192380844,182265309
29377680_1628174,CM021110.1,11,29377680,190752681,3434283,1628174,192380855,182265320
29377680_1628213,CM021110.1,11,29377680,190752681,3434283,1628213,192380894,182265359
29377680_1628214,CM021110.1,11,29377680,190752681,3434283,1628214,192380895,182265360
29377680_1628284,CM021110.1,11,29377680,190752681,3434283,1628284,192380965,182265430
29377680_1628301,CM021110.1,11,29377680,190752681,3434283,1628301,192380982,182265447
29378511_1683940,CM021110.1,11,29378511,190755079,2434841,1683940,192439019,182323484
29378511_1686023,CM021110.1,11,29378511,190755079,2434841,1686023,192441102,182325567
29378511_1686032,CM021110.1,11,29378511,190755079,2434841,1686032,192441111,182325576
29381066_1706641,CM021110.1,11,29381066,190757321,2049854,1706641,192463962,182348427
29381066_1707430,CM021110.1,11,29381066,190757321,2049854,1707430,192464751,182349216
29378511_1734642,CM021110.1,11,29378511,190755079,2434841,1734642,192489721,182374186
29378511_1734652,CM021110.1,11,29378511,190755079,2434841,1734652,192489731,182374196
29378511_1734665,CM021110.1,11,29378511,190755079,2434841,1734665,192489744,182374209
29378511_1734755,CM021110.1,11,29378511,190755079,2434841,1734755,192489834,182374299
29378511_1734908,CM021110.1,11,29378511,190755079,2434841,1734908,192489987,182374452
29378511_1735050,CM021110.1,11,29378511,190755079,2434841,1735050,192490129,182374594
29378511_1735093,CM021110.1,11,29378511,190755079,2434841,1735093,192490172,182374637
29378511_1782707,CM021110.1,11,29378511,190755079,2434841,1782707,192537786,182422251
29378511_1793164,CM021110.1,11,29378511,190755079,2434841,1793164,192548243,182432708
29378511_1793282,CM021110.1,11,29378511,190755079,2434841,1793282,192548361,182432826
29378511_1793666,CM021110.1,11,29378511,190755079,2434841,1793666,192548745,182433210
29378511_1793742,CM021110.1,11,29378511,190755079,2434841,1793742,192548821,182433286
29381066_2000827,CM021110.1,11,29381066,190757321,2049854,2000827,192758148,182642613
29381066_2000890,CM021110.1,11,29381066,190757321,2049854,2000890,192758211,182642676
29381066_2000965,CM021110.1,11,29381066,190757321,2049854,2000965,192758286,182642751
29382243_2002869,CM021110.1,11,29382243,190757004,4667954,2002869,192759873,182644338
29382243_2002925,CM021110.1,11,29382243,190757004,4667954,2002925,192759929,182644394
29378377_2010886,CM021110.1,11,29378377,190752682,5332615,2010886,192763568,182648033
29378377_2011192,CM021110.1,11,29378377,190752682,5332615,2011192,192763874,182648339
29378511_2016869,CM021110.1,11,29378511,190755079,2434841,2016869,192771948,182656413
29381066_2033949,CM021110.1,11,29381066,190757321,2049854,2033949,192791270,182675735
29378377_2086978,CM021110.1,11,29378377,190752682,5332615,2086978,192839660,182724125
29378377_2087082,CM021110.1,11,29378377,190752682,5332615,2087082,192839764,182724229
29378377_2087174,CM021110.1,11,29378377,190752682,5332615,2087174,192839856,182724321
29377192_2254378,CM021110.1,11,29377192,190757257,2934256,2254378,193011635,182896100
29377192_2255743,CM021110.1,11,29377192,190757257,2934256,2255743,193013000,182897465
29379079_2285963,CM021110.1,11,29379079,190756953,7369967,2285963,193042916,182927381
29379079_2287092,CM021110.1,11,29379079,190756953,7369967,2287092,193044045,182928510
29379079_2354123,CM021110.1,11,29379079,190756953,7369967,2354123,193111076,182995541
29379079_2387299,CM021110.1,11,29379079,190756953,7369967,2387299,193144252,183028717
29379079_2387329,CM021110.1,11,29379079,190756953,7369967,2387329,193144282,183028747
29379630_2717353,CM021110.1,11,29379630,190757417,8470972,2717353,193474770,183359235
29379630_2717593,CM021110.1,11,29379630,190757417,8470972,2717593,193475010,183359475
29378377_3058215,CM021110.1,11,29378377,190752682,5332615,3058215,193810897,183695362
29378377_3058241,CM021110.1,11,29378377,190752682,5332615,3058241,193810923,183695388
29377680_3265588,CM021110.1,11,29377680,190752681,3434283,3265588,194018269,183902734
29378377_3531719,CM021110.1,11,29378377,190752682,5332615,3531719,194284401,184168866
29378377_3531734,CM021110.1,11,29378377,190752682,5332615,3531734,194284416,184168881
29378377_3531759,CM021110.1,11,29378377,190752682,5332615,3531759,194284441,184168906
29379630_3668085,CM021110.1,11,29379630,190757417,8470972,3668085,194425502,184309967
29378377_3753524,CM021110.1,11,29378377,190752682,5332615,3753524,194506206,184390671
29378377_3753591,CM021110.1,11,29378377,190752682,5332615,3753591,194506273,184390738
29378377_3753619,CM021110.1,11,29378377,190752682,5332615,3753619,194506301,184390766
29379630_3818039,CM021110.1,11,29379630,190757417,8470972,3818039,194575456,184459921
29379630_3818059,CM021110.1,11,29379630,190757417,8470972,3818059,194575476,184459941
29379630_3818088,CM021110.1,11,29379630,190757417,8470972,3818088,194575505,184459970
29379630_3818131,CM021110.1,11,29379630,190757417,8470972,3818131,194575548,184460013
29379630_3818145,CM021110.1,11,29379630,190757417,8470972,3818145,194575562,184460027
29379630_3818170,CM021110.1,11,29379630,190757417,8470972,3818170,194575587,184460052
29379630_3818195,CM021110.1,11,29379630,190757417,8470972,3818195,194575612,184460077
29379630_3818197,CM021110.1,11,29379630,190757417,8470972,3818197,194575614,184460079
29379630_3818208,CM021110.1,11,29379630,190757417,8470972,3818208,194575625,184460090
29379630_3818232,CM021110.1,11,29379630,190757417,8470972,3818232,194575649,184460114
29378377_4102853,CM021110.1,11,29378377,190752682,5332615,4102853,194855535,184740000
29378377_4102869,CM021110.1,11,29378377,190752682,5332615,4102869,194855551,184740016
29378377_4102986,CM021110.1,11,29378377,190752682,5332615,4102986,194855668,184740133
29378377_4103010,CM021110.1,11,29378377,190752682,5332615,4103010,194855692,184740157
29379630_4152685,CM021110.1,11,29379630,190757417,8470972,4152685,194910102,184794567
29379630_4152723,CM021110.1,11,29379630,190757417,8470972,4152723,194910140,184794605
29379630_4152754,CM021110.1,11,29379630,190757417,8470972,4152754,194910171,184794636
29379630_4155614,CM021110.1,11,29379630,190757417,8470972,4155614,194913031,184797496
29379630_4230440,CM021110.1,11,29379630,190757417,8470972,4230440,194987857,184872322
29378377_4494068,CM021110.1,11,29378377,190752682,5332615,4494068,195246750,185131215
29378377_4494072,CM021110.1,11,29378377,190752682,5332615,4494072,195246754,185131219
29378377_4494093,CM021110.1,11,29378377,190752682,5332615,4494093,195246775,185131240
29378377_4494180,CM021110.1,11,29378377,190752682,5332615,4494180,195246862,185131327
29378377_4494221,CM021110.1,11,29378377,190752682,5332615,4494221,195246903,185131368
29379630_4499851,CM021110.1,11,29379630,190757417,8470972,4499851,195257268,185141733
29379630_4500007,CM021110.1,11,29379630,190757417,8470972,4500007,195257424,185141889
29379630_4500070,CM021110.1,11,29379630,190757417,8470972,4500070,195257487,185141952
29382243_4552466,CM021110.1,11,29382243,190757004,4667954,4552466,195309470,185193935
29378377_4682271,CM021110.1,11,29378377,190752682,5332615,4682271,195434953,185319418
29378377_4717796,CM021110.1,11,29378377,190752682,5332615,4717796,195470478,185354943
29378377_4768745,CM021110.1,11,29378377,190752682,5332615,4768745,195521427,185405892
29378377_4768813,CM021110.1,11,29378377,190752682,5332615,4768813,195521495,185405960
29378377_4768820,CM021110.1,11,29378377,190752682,5332615,4768820,195521502,185405967
29378377_4786453,CM021110.1,11,29378377,190752682,5332615,4786453,195539135,185423600
29378377_4827116,CM021110.1,11,29378377,190752682,5332615,4827116,195579798,185464263
29378377_4827180,CM021110.1,11,29378377,190752682,5332615,4827180,195579862,185464327
29378377_4827194,CM021110.1,11,29378377,190752682,5332615,4827194,195579876,185464341
29378377_4827473,CM021110.1,11,29378377,190752682,5332615,4827473,195580155,185464620
29378377_4827522,CM021110.1,11,29378377,190752682,5332615,4827522,195580204,185464669
29378377_4852044,CM021110.1,11,29378377,190752682,5332615,4852044,195604726,185489191
29378377_4852692,CM021110.1,11,29378377,190752682,5332615,4852692,195605374,185489839
29378377_4852695,CM021110.1,11,29378377,190752682,5332615,4852695,195605377,185489842
29379630_4863497,CM021110.1,11,29379630,190757417,8470972,4863497,195620914,185505379
29379630_4863859,CM021110.1,11,29379630,190757417,8470972,4863859,195621276,185505741
29379630_4863968,CM021110.1,11,29379630,190757417,8470972,4863968,195621385,185505850
29378377_4889363,CM021110.1,11,29378377,190752682,5332615,4889363,195642045,185526510
29378377_4889396,CM021110.1,11,29378377,190752682,5332615,4889396,195642078,185526543
29379079_5036016,CM021110.1,11,29379079,190756953,7369967,5036016,195792969,185677434
29379079_5211983,CM021110.1,11,29379079,190756953,7369967,5211983,195968936,185853401
29379630_5774187,CM021110.1,11,29379630,190757417,8470972,5774187,196531604,186416069
29379079_6100585,CM021110.1,11,29379079,190756953,7369967,6100585,196857538,186742003
29379079_6100720,CM021110.1,11,29379079,190756953,7369967,6100720,196857673,186742138
29379079_6115625,CM021110.1,11,29379079,190756953,7369967,6115625,196872578,186757043
29379079_6122964,CM021110.1,11,29379079,190756953,7369967,6122964,196879917,186764382
29379079_6122995,CM021110.1,11,29379079,190756953,7369967,6122995,196879948,186764413
29377567_86091,CM021110.1,11,29377567,197114703,1507383,86091,197200794,187085259
29378403_120353,CM021110.1,11,29378403,197115531,1433068,120353,197235884,187120349
29378403_120387,CM021110.1,11,29378403,197115531,1433068,120387,197235918,187120383
29345502_124460,CM021110.1,11,29345502,197114215,149543,124460,197238675,187123140
29381593_146552,CM021110.1,11,29381593,197115130,838903,146552,197261682,187146147
29381593_146627,CM021110.1,11,29381593,197115130,838903,146627,197261757,187146222
29377567_164087,CM021110.1,11,29377567,197114703,1507383,164087,197278790,187163255
29377544_260882,CM021110.1,11,29377544,197116406,1421248,260882,197377288,187261753
29377544_260900,CM021110.1,11,29377544,197116406,1421248,260900,197377306,187261771
29377544_260925,CM021110.1,11,29377544,197116406,1421248,260925,197377331,187261796
29377544_268955,CM021110.1,11,29377544,197116406,1421248,268955,197385361,187269826
29377567_279229,CM021110.1,11,29377567,197114703,1507383,279229,197393932,187278397
29377567_279341,CM021110.1,11,29377567,197114703,1507383,279341,197394044,187278509
29377567_279342,CM021110.1,11,29377567,197114703,1507383,279342,197394045,187278510
29377567_279343,CM021110.1,11,29377567,197114703,1507383,279343,197394046,187278511
29377567_279388,CM021110.1,11,29377567,197114703,1507383,279388,197394091,187278556
29381434_294150,CM021110.1,11,29381434,197116626,1753587,294150,197410776,187295241
29378403_336439,CM021110.1,11,29378403,197115531,1433068,336439,197451970,187336435
29377544_350332,CM021110.1,11,29377544,197116406,1421248,350332,197466738,187351203
29377544_354601,CM021110.1,11,29377544,197116406,1421248,354601,197471007,187355472
29378403_387169,CM021110.1,11,29378403,197115531,1433068,387169,197502700,187387165
29377544_424449,CM021110.1,11,29377544,197116406,1421248,424449,197540855,187425320
29377544_424483,CM021110.1,11,29377544,197116406,1421248,424483,197540889,187425354
29377544_457842,CM021110.1,11,29377544,197116406,1421248,457842,197574248,187458713
29377567_575483,CM021110.1,11,29377567,197114703,1507383,575483,197690186,187574651
29377567_575549,CM021110.1,11,29377567,197114703,1507383,575549,197690252,187574717
29377567_588203,CM021110.1,11,29377567,197114703,1507383,588203,197702906,187587371
29377567_621560,CM021110.1,11,29377567,197114703,1507383,621560,197736263,187620728
29377567_621572,CM021110.1,11,29377567,197114703,1507383,621572,197736275,187620740
29377567_621612,CM021110.1,11,29377567,197114703,1507383,621612,197736315,187620780
29377567_621657,CM021110.1,11,29377567,197114703,1507383,621657,197736360,187620825
29379630_7066491,CM021110.1,11,29379630,190757417,8470972,7066491,197823908,187708373
29379630_7066509,CM021110.1,11,29379630,190757417,8470972,7066509,197823926,187708391
29377567_725876,CM021110.1,11,29377567,197114703,1507383,725876,197840579,187725044
29377567_726105,CM021110.1,11,29377567,197114703,1507383,726105,197840808,187725273
29377567_736462,CM021110.1,11,29377567,197114703,1507383,736462,197851165,187735630
29377567_736514,CM021110.1,11,29377567,197114703,1507383,736514,197851217,187735682
29377567_736536,CM021110.1,11,29377567,197114703,1507383,736536,197851239,187735704
29377567_736561,CM021110.1,11,29377567,197114703,1507383,736561,197851264,187735729
29377567_736580,CM021110.1,11,29377567,197114703,1507383,736580,197851283,187735748
29377567_736645,CM021110.1,11,29377567,197114703,1507383,736645,197851348,187735813
29377567_736657,CM021110.1,11,29377567,197114703,1507383,736657,197851360,187735825
29377567_736667,CM021110.1,11,29377567,197114703,1507383,736667,197851370,187735835
29377567_736670,CM021110.1,11,29377567,197114703,1507383,736670,197851373,187735838
29377567_736674,CM021110.1,11,29377567,197114703,1507383,736674,197851377,187735842
29381434_744111,CM021110.1,11,29381434,197116626,1753587,744111,197860737,187745202
29381434_744247,CM021110.1,11,29381434,197116626,1753587,744247,197860873,187745338
29381986_752116,CM021110.1,11,29381986,197115425,2234612,752116,197867541,187752006
29381986_752133,CM021110.1,11,29381986,197115425,2234612,752133,197867558,187752023
29381986_752193,CM021110.1,11,29381986,197115425,2234612,752193,197867618,187752083
29381986_752254,CM021110.1,11,29381986,197115425,2234612,752254,197867679,187752144
29377580_808249,CM021110.1,11,29377580,197114914,3009996,808249,197923163,187807628
29381434_832079,CM021110.1,11,29381434,197116626,1753587,832079,197948705,187833170
29378490_171721,CM021110.1,11,29378490,197785318,3622472,171721,197957039,187841504
29378490_171751,CM021110.1,11,29378490,197785318,3622472,171751,197957069,187841534
29377567_854327,CM021110.1,11,29377567,197114703,1507383,854327,197969030,187853495
29381004_857159,CM021110.1,11,29381004,197114214,991115,857159,197971373,187855838
29377567_868613,CM021110.1,11,29377567,197114703,1507383,868613,197983316,187867781
29377567_868614,CM021110.1,11,29377567,197114703,1507383,868614,197983317,187867782
29377567_875753,CM021110.1,11,29377567,197114703,1507383,875753,197990456,187874921
29377567_875864,CM021110.1,11,29377567,197114703,1507383,875864,197990567,187875032
29377216_894423,CM021110.1,11,29377216,197114215,1614687,894423,198008638,187893103
29377216_894473,CM021110.1,11,29377216,197114215,1614687,894473,198008688,187893153
29377544_939079,CM021110.1,11,29377544,197116406,1421248,939079,198055485,187939950
29377544_939081,CM021110.1,11,29377544,197116406,1421248,939081,198055487,187939952
29377544_939115,CM021110.1,11,29377544,197116406,1421248,939115,198055521,187939986
29377544_939202,CM021110.1,11,29377544,197116406,1421248,939202,198055608,187940073
29377544_939226,CM021110.1,11,29377544,197116406,1421248,939226,198055632,187940097
29377544_939266,CM021110.1,11,29377544,197116406,1421248,939266,198055672,187940137
29377216_955597,CM021110.1,11,29377216,197114215,1614687,955597,198069812,187954277
29377216_955664,CM021110.1,11,29377216,197114215,1614687,955664,198069879,187954344
29379630_7312900,CM021110.1,11,29379630,190757417,8470972,7312900,198070317,187954782
29379630_7312967,CM021110.1,11,29379630,190757417,8470972,7312967,198070384,187954849
29379630_7313016,CM021110.1,11,29379630,190757417,8470972,7313016,198070433,187954898
29380200_286538,CM021110.1,11,29380200,197785090,5247048,286538,198071628,187956093
29377580_989574,CM021110.1,11,29377580,197114914,3009996,989574,198104488,187988953
29377580_989575,CM021110.1,11,29377580,197114914,3009996,989575,198104489,187988954
29377580_989603,CM021110.1,11,29377580,197114914,3009996,989603,198104517,187988982
29377567_1020829,CM021110.1,11,29377567,197114703,1507383,1020829,198135532,188019997
29377950_1027584,CM021110.1,11,29377950,197114208,2238735,1027584,198141792,188026257
29377950_1027659,CM021110.1,11,29377950,197114208,2238735,1027659,198141867,188026332
29377950_1027681,CM021110.1,11,29377950,197114208,2238735,1027681,198141889,188026354
29377544_1055505,CM021110.1,11,29377544,197116406,1421248,1055505,198171911,188056376
29377544_1055547,CM021110.1,11,29377544,197116406,1421248,1055547,198171953,188056418
29377544_1056436,CM021110.1,11,29377544,197116406,1421248,1056436,198172842,188057307
29377544_1056453,CM021110.1,11,29377544,197116406,1421248,1056453,198172859,188057324
29377544_1056463,CM021110.1,11,29377544,197116406,1421248,1056463,198172869,188057334
29377544_1056482,CM021110.1,11,29377544,197116406,1421248,1056482,198172888,188057353
29377544_1056525,CM021110.1,11,29377544,197116406,1421248,1056525,198172931,188057396
29377544_1056535,CM021110.1,11,29377544,197116406,1421248,1056535,198172941,188057406
29377544_1056547,CM021110.1,11,29377544,197116406,1421248,1056547,198172953,188057418
29377544_1056561,CM021110.1,11,29377544,197116406,1421248,1056561,198172967,188057432
29377544_1056588,CM021110.1,11,29377544,197116406,1421248,1056588,198172994,188057459
29377544_1056624,CM021110.1,11,29377544,197116406,1421248,1056624,198173030,188057495
29377580_1061615,CM021110.1,11,29377580,197114914,3009996,1061615,198176529,188060994
29377216_1067901,CM021110.1,11,29377216,197114215,1614687,1067901,198182116,188066581
29377216_1067935,CM021110.1,11,29377216,197114215,1614687,1067935,198182150,188066615
29381986_1099789,CM021110.1,11,29381986,197115425,2234612,1099789,198215214,188099679
29380808_1188338,CM021110.1,11,29380808,197116810,1285506,1188338,198305148,188189613
29380808_1188361,CM021110.1,11,29380808,197116810,1285506,1188361,198305171,188189636
29380808_1189228,CM021110.1,11,29380808,197116810,1285506,1189228,198306038,188190503
29380808_1189263,CM021110.1,11,29380808,197116810,1285506,1189263,198306073,188190538
29380808_1189364,CM021110.1,11,29380808,197116810,1285506,1189364,198306174,188190639
29381434_1191149,CM021110.1,11,29381434,197116626,1753587,1191149,198307775,188192240
29381434_1191202,CM021110.1,11,29381434,197116626,1753587,1191202,198307828,188192293
29381434_1191244,CM021110.1,11,29381434,197116626,1753587,1191244,198307870,188192335
29379630_7561297,CM021110.1,11,29379630,190757417,8470972,7561297,198318714,188203179
29379630_7561309,CM021110.1,11,29379630,190757417,8470972,7561309,198318726,188203191
29379630_7561325,CM021110.1,11,29379630,190757417,8470972,7561325,198318742,188203207
29379630_7561338,CM021110.1,11,29379630,190757417,8470972,7561338,198318755,188203220
29379630_7561363,CM021110.1,11,29379630,190757417,8470972,7561363,198318780,188203245
29379630_7561388,CM021110.1,11,29379630,190757417,8470972,7561388,198318805,188203270
29379630_7561441,CM021110.1,11,29379630,190757417,8470972,7561441,198318858,188203323
29379630_7561466,CM021110.1,11,29379630,190757417,8470972,7561466,198318883,188203348
29380109_1331582,CM021110.1,11,29380109,197116106,1622188,1331582,198447688,188332153
29377216_1340340,CM021110.1,11,29377216,197114215,1614687,1340340,198454555,188339020
29381986_1358679,CM021110.1,11,29381986,197115425,2234612,1358679,198474104,188358569
29381986_1359436,CM021110.1,11,29381986,197115425,2234612,1359436,198474861,188359326
29381986_1359469,CM021110.1,11,29381986,197115425,2234612,1359469,198474894,188359359
29381986_1359470,CM021110.1,11,29381986,197115425,2234612,1359470,198474895,188359360
29381986_1359503,CM021110.1,11,29381986,197115425,2234612,1359503,198474928,188359393
29380200_843445,CM021110.1,11,29380200,197785090,5247048,843445,198628535,188513000
29380109_1544310,CM021110.1,11,29380109,197116106,1622188,1544310,198660416,188544881
29380109_1548861,CM021110.1,11,29380109,197116106,1622188,1548861,198664967,188549432
29380109_1548868,CM021110.1,11,29380109,197116106,1622188,1548868,198664974,188549439
29380109_1548885,CM021110.1,11,29380109,197116106,1622188,1548885,198664991,188549456
29377580_1574327,CM021110.1,11,29377580,197114914,3009996,1574327,198689241,188573706
29377580_1574358,CM021110.1,11,29377580,197114914,3009996,1574358,198689272,188573737
29377580_1574370,CM021110.1,11,29377580,197114914,3009996,1574370,198689284,188573749
29377580_1574372,CM021110.1,11,29377580,197114914,3009996,1574372,198689286,188573751
29378490_1130693,CM021110.1,11,29378490,197785318,3622472,1130693,198916011,188800476
29381986_1949058,CM021110.1,11,29381986,197115425,2234612,1949058,199064483,188948948
29381986_1949104,CM021110.1,11,29381986,197115425,2234612,1949104,199064529,188948994
29381986_1949148,CM021110.1,11,29381986,197115425,2234612,1949148,199064573,188949038
29381986_1949166,CM021110.1,11,29381986,197115425,2234612,1949166,199064591,188949056
29381986_1949311,CM021110.1,11,29381986,197115425,2234612,1949311,199064736,188949201
29380200_1520351,CM021110.1,11,29380200,197785090,5247048,1520351,199305441,189189906
29378490_1923376,CM021110.1,11,29378490,197785318,3622472,1923376,199708694,189593159
29378490_2129836,CM021110.1,11,29378490,197785318,3622472,2129836,199915154,189799619
29378490_2129859,CM021110.1,11,29378490,197785318,3622472,2129859,199915177,189799642
29378490_2129860,CM021110.1,11,29378490,197785318,3622472,2129860,199915178,189799643
29378490_2129870,CM021110.1,11,29378490,197785318,3622472,2129870,199915188,189799653
29378490_2129886,CM021110.1,11,29378490,197785318,3622472,2129886,199915204,189799669
29378490_2129924,CM021110.1,11,29378490,197785318,3622472,2129924,199915242,189799707
29379959_2287006,CM021110.1,11,29379959,197785089,4289256,2287006,200072095,189956560
29379959_2287009,CM021110.1,11,29379959,197785089,4289256,2287009,200072098,189956563
29379959_2287014,CM021110.1,11,29379959,197785089,4289256,2287014,200072103,189956568
29379959_2316320,CM021110.1,11,29379959,197785089,4289256,2316320,200101409,189985874
29378490_2389657,CM021110.1,11,29378490,197785318,3622472,2389657,200174975,190059440
29378490_2629051,CM021110.1,11,29378490,197785318,3622472,2629051,200414369,190298834
29378490_2629090,CM021110.1,11,29378490,197785318,3622472,2629090,200414408,190298873
29378490_2629113,CM021110.1,11,29378490,197785318,3622472,2629113,200414431,190298896
29378490_2629162,CM021110.1,11,29378490,197785318,3622472,2629162,200414480,190298945
29378490_2629164,CM021110.1,11,29378490,197785318,3622472,2629164,200414482,190298947
29378490_2629203,CM021110.1,11,29378490,197785318,3622472,2629203,200414521,190298986
29378490_2629229,CM021110.1,11,29378490,197785318,3622472,2629229,200414547,190299012
29379959_2755213,CM021110.1,11,29379959,197785089,4289256,2755213,200540302,190424767
29379959_2755438,CM021110.1,11,29379959,197785089,4289256,2755438,200540527,190424992
29379959_2760465,CM021110.1,11,29379959,197785089,4289256,2760465,200545554,190430019
29379959_2760513,CM021110.1,11,29379959,197785089,4289256,2760513,200545602,190430067
29379959_2788021,CM021110.1,11,29379959,197785089,4289256,2788021,200573110,190457575
29378490_2802965,CM021110.1,11,29378490,197785318,3622472,2802965,200588283,190472748
29378490_2803024,CM021110.1,11,29378490,197785318,3622472,2803024,200588342,190472807
29378490_2803065,CM021110.1,11,29378490,197785318,3622472,2803065,200588383,190472848
29378490_3518111,CM021110.1,11,29378490,197785318,3622472,3518111,201303429,191187894
29378490_3519592,CM021110.1,11,29378490,197785318,3622472,3519592,201304910,191189375
29378490_3519594,CM021110.1,11,29378490,197785318,3622472,3519594,201304912,191189377
29378490_3519678,CM021110.1,11,29378490,197785318,3622472,3519678,201304996,191189461
29379959_3576905,CM021110.1,11,29379959,197785089,4289256,3576905,201361994,191246459
29379959_3577834,CM021110.1,11,29379959,197785089,4289256,3577834,201362923,191247388
29379959_3707479,CM021110.1,11,29379959,197785089,4289256,3707479,201492568,191377033
29379959_3729132,CM021110.1,11,29379959,197785089,4289256,3729132,201514221,191398686
29379959_3787846,CM021110.1,11,29379959,197785089,4289256,3787846,201572935,191457400
29379959_3788577,CM021110.1,11,29379959,197785089,4289256,3788577,201573666,191458131
29379959_3788594,CM021110.1,11,29379959,197785089,4289256,3788594,201573683,191458148
29379959_3788596,CM021110.1,11,29379959,197785089,4289256,3788596,201573685,191458150
29379959_3788657,CM021110.1,11,29379959,197785089,4289256,3788657,201573746,191458211
29379959_3788665,CM021110.1,11,29379959,197785089,4289256,3788665,201573754,191458219
29379959_3907922,CM021110.1,11,29379959,197785089,4289256,3907922,201693011,191577476
29366883_20196,CM021110.1,11,29366883,205465506,21014,20196,205485702,195370167
29381388_234104,CM021110.1,11,29381388,205465815,1884921,234104,205699919,195584384
29381388_234168,CM021110.1,11,29381388,205465815,1884921,234168,205699983,195584448
29381388_239558,CM021110.1,11,29381388,205465815,1884921,239558,205705373,195589838
29381388_239566,CM021110.1,11,29381388,205465815,1884921,239566,205705381,195589846
29381388_239568,CM021110.1,11,29381388,205465815,1884921,239568,205705383,195589848
29381388_239576,CM021110.1,11,29381388,205465815,1884921,239576,205705391,195589856
29381388_239579,CM021110.1,11,29381388,205465815,1884921,239579,205705394,195589859
29381388_239640,CM021110.1,11,29381388,205465815,1884921,239640,205705455,195589920
29381388_239657,CM021110.1,11,29381388,205465815,1884921,239657,205705472,195589937
29381388_239665,CM021110.1,11,29381388,205465815,1884921,239665,205705480,195589945
29381388_239676,CM021110.1,11,29381388,205465815,1884921,239676,205705491,195589956
29381388_239687,CM021110.1,11,29381388,205465815,1884921,239687,205705502,195589967
29381388_239694,CM021110.1,11,29381388,205465815,1884921,239694,205705509,195589974
29381388_239702,CM021110.1,11,29381388,205465815,1884921,239702,205705517,195589982
29381388_239727,CM021110.1,11,29381388,205465815,1884921,239727,205705542,195590007
29381388_239728,CM021110.1,11,29381388,205465815,1884921,239728,205705543,195590008
29381388_239758,CM021110.1,11,29381388,205465815,1884921,239758,205705573,195590038
29381388_239764,CM021110.1,11,29381388,205465815,1884921,239764,205705579,195590044
29381388_239780,CM021110.1,11,29381388,205465815,1884921,239780,205705595,195590060
29381388_239781,CM021110.1,11,29381388,205465815,1884921,239781,205705596,195590061
29381388_239837,CM021110.1,11,29381388,205465815,1884921,239837,205705652,195590117
29381388_239838,CM021110.1,11,29381388,205465815,1884921,239838,205705653,195590118
29381388_239857,CM021110.1,11,29381388,205465815,1884921,239857,205705672,195590137
29381388_239873,CM021110.1,11,29381388,205465815,1884921,239873,205705688,195590153
29381388_239887,CM021110.1,11,29381388,205465815,1884921,239887,205705702,195590167
29381388_239897,CM021110.1,11,29381388,205465815,1884921,239897,205705712,195590177
29381388_239908,CM021110.1,11,29381388,205465815,1884921,239908,205705723,195590188
29381388_239925,CM021110.1,11,29381388,205465815,1884921,239925,205705740,195590205
29381388_531503,CM021110.1,11,29381388,205465815,1884921,531503,205997318,195881783
29381388_1091104,CM021110.1,11,29381388,205465815,1884921,1091104,206556919,196441384
29381388_1091279,CM021110.1,11,29381388,205465815,1884921,1091279,206557094,196441559
29381388_1091283,CM021110.1,11,29381388,205465815,1884921,1091283,206557098,196441563
29381388_1255214,CM021110.1,11,29381388,205465815,1884921,1255214,206721029,196605494
29381388_1255336,CM021110.1,11,29381388,205465815,1884921,1255336,206721151,196605616
29381388_1420726,CM021110.1,11,29381388,205465815,1884921,1420726,206886541,196771006
29381388_1495562,CM021110.1,11,29381388,205465815,1884921,1495562,206961377,196845842
29381388_1495622,CM021110.1,11,29381388,205465815,1884921,1495622,206961437,196845902
29381388_1495693,CM021110.1,11,29381388,205465815,1884921,1495693,206961508,196845973
29381388_1648538,CM021110.1,11,29381388,205465815,1884921,1648538,207114353,196998818
29381388_1648624,CM021110.1,11,29381388,205465815,1884921,1648624,207114439,196998904
29381388_1648692,CM021110.1,11,29381388,205465815,1884921,1648692,207114507,196998972
29381388_1649538,CM021110.1,11,29381388,205465815,1884921,1649538,207115353,196999818
29381388_1755349,CM021110.1,11,29381388,205465815,1884921,1755349,207221164,197105629
29381388_1755401,CM021110.1,11,29381388,205465815,1884921,1755401,207221216,197105681
29381388_1755440,CM021110.1,11,29381388,205465815,1884921,1755440,207221255,197105720
29381388_1755465,CM021110.1,11,29381388,205465815,1884921,1755465,207221280,197105745
29381495_27634,CM021110.1,11,29381495,233828255,61674,27634,233855889,223740354
29381495_27746,CM021110.1,11,29381495,233828255,61674,27746,233856001,223740466
29381495_27782,CM021110.1,11,29381495,233828255,61674,27782,233856037,223740502
29381495_27793,CM021110.1,11,29381495,233828255,61674,27793,233856048,223740513
29378908_63573,CM021110.1,11,29378908,233828444,3318111,63573,233892017,223776482
29380014_71815,CM021110.1,11,29380014,233828259,1347946,71815,233900074,223784539
29380043_101706,CM021110.1,11,29380043,233828254,696308,101706,233929960,223814425
29380043_101827,CM021110.1,11,29380043,233828254,696308,101827,233930081,223814546
29380043_103126,CM021110.1,11,29380043,233828254,696308,103126,233931380,223815845
29380043_103634,CM021110.1,11,29380043,233828254,696308,103634,233931888,223816353
29380043_103747,CM021110.1,11,29380043,233828254,696308,103747,233932001,223816466
29380043_103819,CM021110.1,11,29380043,233828254,696308,103819,233932073,223816538
29380043_103870,CM021110.1,11,29380043,233828254,696308,103870,233932124,223816589
29380943_112854,CM021110.1,11,29380943,233828257,1546995,112854,233941111,223825576
29378782_152022,CM021110.1,11,29378782,233828252,418907,152022,233980274,223864739
29377807_253034,CM021110.1,11,29377807,233829337,705638,253034,234082371,223966836
29377807_253106,CM021110.1,11,29377807,233829337,705638,253106,234082443,223966908
29377807_253120,CM021110.1,11,29377807,233829337,705638,253120,234082457,223966922
29377807_253180,CM021110.1,11,29377807,233829337,705638,253180,234082517,223966982
29377807_253185,CM021110.1,11,29377807,233829337,705638,253185,234082522,223966987
29377807_253186,CM021110.1,11,29377807,233829337,705638,253186,234082523,223966988
29377807_253188,CM021110.1,11,29377807,233829337,705638,253188,234082525,223966990
29377807_253213,CM021110.1,11,29377807,233829337,705638,253213,234082550,223967015
29377807_253214,CM021110.1,11,29377807,233829337,705638,253214,234082551,223967016
29378908_275378,CM021110.1,11,29378908,233828444,3318111,275378,234103822,223988287
29378908_275819,CM021110.1,11,29378908,233828444,3318111,275819,234104263,223988728
29382125_302145,CM021110.1,11,29382125,233828258,1687861,302145,234130403,224014868
29372307_309859,CM021110.1,11,29372307,233828256,343204,309859,234138115,224022580
29381229_378808,CM021110.1,11,29381229,233828255,2820102,378808,234207063,224091528
29380198_403629,CM021110.1,11,29380198,233830558,594482,403629,234234187,224118652
29377807_412928,CM021110.1,11,29377807,233829337,705638,412928,234242265,224126730
29377807_412998,CM021110.1,11,29377807,233829337,705638,412998,234242335,224126800
29377807_413034,CM021110.1,11,29377807,233829337,705638,413034,234242371,224126836
29377807_413044,CM021110.1,11,29377807,233829337,705638,413044,234242381,224126846
29377807_464902,CM021110.1,11,29377807,233829337,705638,464902,234294239,224178704
29377807_464967,CM021110.1,11,29377807,233829337,705638,464967,234294304,224178769
29377807_465065,CM021110.1,11,29377807,233829337,705638,465065,234294402,224178867
29378908_501167,CM021110.1,11,29378908,233828444,3318111,501167,234329611,224214076
29378908_501381,CM021110.1,11,29378908,233828444,3318111,501381,234329825,224214290
29378908_501473,CM021110.1,11,29378908,233828444,3318111,501473,234329917,224214382
29378908_501488,CM021110.1,11,29378908,233828444,3318111,501488,234329932,224214397
29378908_501804,CM021110.1,11,29378908,233828444,3318111,501804,234330248,224214713
29382125_602255,CM021110.1,11,29382125,233828258,1687861,602255,234430513,224314978
29382125_602300,CM021110.1,11,29382125,233828258,1687861,602300,234430558,224315023
29380943_615316,CM021110.1,11,29380943,233828257,1546995,615316,234443573,224328038
29380943_615371,CM021110.1,11,29380943,233828257,1546995,615371,234443628,224328093
29380943_615489,CM021110.1,11,29380943,233828257,1546995,615489,234443746,224328211
29380943_615555,CM021110.1,11,29380943,233828257,1546995,615555,234443812,224328277
29380943_615557,CM021110.1,11,29380943,233828257,1546995,615557,234443814,224328279
29378908_659308,CM021110.1,11,29378908,233828444,3318111,659308,234487752,224372217
29378908_659444,CM021110.1,11,29378908,233828444,3318111,659444,234487888,224372353
29382125_690586,CM021110.1,11,29382125,233828258,1687861,690586,234518844,224403309
29378908_757046,CM021110.1,11,29378908,233828444,3318111,757046,234585490,224469955
29378908_757060,CM021110.1,11,29378908,233828444,3318111,757060,234585504,224469969
29378908_759209,CM021110.1,11,29378908,233828444,3318111,759209,234587653,224472118
29378908_781672,CM021110.1,11,29378908,233828444,3318111,781672,234610116,224494581
29378908_781725,CM021110.1,11,29378908,233828444,3318111,781725,234610169,224494634
29378908_832163,CM021110.1,11,29378908,233828444,3318111,832163,234660607,224545072
29378908_845092,CM021110.1,11,29378908,233828444,3318111,845092,234673536,224558001
29378908_845110,CM021110.1,11,29378908,233828444,3318111,845110,234673554,224558019
29378908_845160,CM021110.1,11,29378908,233828444,3318111,845160,234673604,224558069
29382125_859894,CM021110.1,11,29382125,233828258,1687861,859894,234688152,224572617
29378908_895947,CM021110.1,11,29378908,233828444,3318111,895947,234724391,224608856
29378908_896026,CM021110.1,11,29378908,233828444,3318111,896026,234724470,224608935
29380014_1083952,CM021110.1,11,29380014,233828259,1347946,1083952,234912211,224796676
29380943_1180695,CM021110.1,11,29380943,233828257,1546995,1180695,235008952,224893417
29380943_1180906,CM021110.1,11,29380943,233828257,1546995,1180906,235009163,224893628
29380943_1180908,CM021110.1,11,29380943,233828257,1546995,1180908,235009165,224893630
29380014_1191306,CM021110.1,11,29380014,233828259,1347946,1191306,235019565,224904030
29380014_1263821,CM021110.1,11,29380014,233828259,1347946,1263821,235092080,224976545
29380943_1326171,CM021110.1,11,29380943,233828257,1546995,1326171,235154428,225038893
29380943_1326380,CM021110.1,11,29380943,233828257,1546995,1326380,235154637,225039102
29380014_1332478,CM021110.1,11,29380014,233828259,1347946,1332478,235160737,225045202
29380014_1332527,CM021110.1,11,29380014,233828259,1347946,1332527,235160786,225045251
29378604_1335435,CM021110.1,11,29378604,233828733,3354232,1335435,235164168,225048633
29378908_1496293,CM021110.1,11,29378908,233828444,3318111,1496293,235324737,225209202
29378604_1504650,CM021110.1,11,29378604,233828733,3354232,1504650,235333383,225217848
29382125_1526762,CM021110.1,11,29382125,233828258,1687861,1526762,235355020,225239485
29382125_1526792,CM021110.1,11,29382125,233828258,1687861,1526792,235355050,225239515
29382125_1571150,CM021110.1,11,29382125,233828258,1687861,1571150,235399408,225283873
29378604_1593494,CM021110.1,11,29378604,233828733,3354232,1593494,235422227,225306692
29378604_1593863,CM021110.1,11,29378604,233828733,3354232,1593863,235422596,225307061
29378604_1593896,CM021110.1,11,29378604,233828733,3354232,1593896,235422629,225307094
29378604_1604504,CM021110.1,11,29378604,233828733,3354232,1604504,235433237,225317702
29378604_1604508,CM021110.1,11,29378604,233828733,3354232,1604508,235433241,225317706
29378604_1604564,CM021110.1,11,29378604,233828733,3354232,1604564,235433297,225317762
29378604_1604757,CM021110.1,11,29378604,233828733,3354232,1604757,235433490,225317955
29378604_1604786,CM021110.1,11,29378604,233828733,3354232,1604786,235433519,225317984
29378604_1604799,CM021110.1,11,29378604,233828733,3354232,1604799,235433532,225317997
29378604_1604802,CM021110.1,11,29378604,233828733,3354232,1604802,235433535,225318000
29378908_1754836,CM021110.1,11,29378908,233828444,3318111,1754836,235583280,225467745
29380339_1784231,CM021110.1,11,29380339,233829502,2139323,1784231,235613733,225498198
29380339_1784241,CM021110.1,11,29380339,233829502,2139323,1784241,235613743,225498208
29380339_1784275,CM021110.1,11,29380339,233829502,2139323,1784275,235613777,225498242
29380339_1784314,CM021110.1,11,29380339,233829502,2139323,1784314,235613816,225498281
29378604_1813793,CM021110.1,11,29378604,233828733,3354232,1813793,235642526,225526991
29378604_1816984,CM021110.1,11,29378604,233828733,3354232,1816984,235645717,225530182
29380339_2011569,CM021110.1,11,29380339,233829502,2139323,2011569,235841071,225725536
29380339_2011578,CM021110.1,11,29380339,233829502,2139323,2011578,235841080,225725545
29380339_2011603,CM021110.1,11,29380339,233829502,2139323,2011603,235841105,225725570
29380339_2011624,CM021110.1,11,29380339,233829502,2139323,2011624,235841126,225725591
29380339_2011655,CM021110.1,11,29380339,233829502,2139323,2011655,235841157,225725622
29380339_2011662,CM021110.1,11,29380339,233829502,2139323,2011662,235841164,225725629
29380339_2011665,CM021110.1,11,29380339,233829502,2139323,2011665,235841167,225725632
29378604_2024134,CM021110.1,11,29378604,233828733,3354232,2024134,235852867,225737332
29378604_2113606,CM021110.1,11,29378604,233828733,3354232,2113606,235942339,225826804
29378604_2113644,CM021110.1,11,29378604,233828733,3354232,2113644,235942377,225826842
29378604_2113684,CM021110.1,11,29378604,233828733,3354232,2113684,235942417,225826882
29378908_2188691,CM021110.1,11,29378908,233828444,3318111,2188691,236017135,225901600
29378908_2188793,CM021110.1,11,29378908,233828444,3318111,2188793,236017237,225901702
29378908_2189140,CM021110.1,11,29378908,233828444,3318111,2189140,236017584,225902049
29378908_2189166,CM021110.1,11,29378908,233828444,3318111,2189166,236017610,225902075
29378908_2200193,CM021110.1,11,29378908,233828444,3318111,2200193,236028637,225913102
29378908_2200194,CM021110.1,11,29378908,233828444,3318111,2200194,236028638,225913103
29378908_2200777,CM021110.1,11,29378908,233828444,3318111,2200777,236029221,225913686
29381229_2250799,CM021110.1,11,29381229,233828255,2820102,2250799,236079054,225963519
29381229_2250826,CM021110.1,11,29381229,233828255,2820102,2250826,236079081,225963546
29378908_2251372,CM021110.1,11,29378908,233828444,3318111,2251372,236079816,225964281
29378908_2414226,CM021110.1,11,29378908,233828444,3318111,2414226,236242670,226127135
29378908_2414230,CM021110.1,11,29378908,233828444,3318111,2414230,236242674,226127139
29378665_487416,CM021110.1,11,29378665,236002344,568527,487416,236489760,226374225
29378665_487438,CM021110.1,11,29378665,236002344,568527,487438,236489782,226374247
29378665_519287,CM021110.1,11,29378665,236002344,568527,519287,236521631,226406096
29378908_2946120,CM021110.1,11,29378908,233828444,3318111,2946120,236774564,226659029
29379426_547053,CM021110.1,11,29379426,264723564,993885,547053,265270617,255155082
29379426_547073,CM021110.1,11,29379426,264723564,993885,547073,265270637,255155102
29379426_547080,CM021110.1,11,29379426,264723564,993885,547080,265270644,255155109
29379426_547121,CM021110.1,11,29379426,264723564,993885,547121,265270685,255155150
29379426_547136,CM021110.1,11,29379426,264723564,993885,547136,265270700,255155165
29379426_549518,CM021110.1,11,29379426,264723564,993885,549518,265273082,255157547
29381412_513059,CM021110.1,11,29381412,297227072,792978,513059,297740131,287624596
29381412_513087,CM021110.1,11,29381412,297227072,792978,513087,297740159,287624624
29381412_614441,CM021110.1,11,29381412,297227072,792978,614441,297841513,287725978
29367180_177740,CM021110.1,11,29367180,301819294,315438,177740,301997034,291881499
29367180_177768,CM021110.1,11,29367180,301819294,315438,177768,301997062,291881527
29367180_177776,CM021110.1,11,29367180,301819294,315438,177776,301997070,291881535
29367180_177839,CM021110.1,11,29367180,301819294,315438,177839,301997133,291881598
29367180_177850,CM021110.1,11,29367180,301819294,315438,177850,301997144,291881609
29367180_177907,CM021110.1,11,29367180,301819294,315438,177907,301997201,291881666
29382090_178393,CM021110.1,11,29382090,317691388,2284678,178393,317869781,307754246
29382090_204012,CM021110.1,11,29382090,317691388,2284678,204012,317895400,307779865
29382090_204054,CM021110.1,11,29382090,317691388,2284678,204054,317895442,307779907
29382090_297832,CM021110.1,11,29382090,317691388,2284678,297832,317989220,307873685
29382090_297852,CM021110.1,11,29382090,317691388,2284678,297852,317989240,307873705
29382090_297966,CM021110.1,11,29382090,317691388,2284678,297966,317989354,307873819
29382090_297992,CM021110.1,11,29382090,317691388,2284678,297992,317989380,307873845
29382090_297994,CM021110.1,11,29382090,317691388,2284678,297994,317989382,307873847
29382090_298062,CM021110.1,11,29382090,317691388,2284678,298062,317989450,307873915
29382090_405534,CM021110.1,11,29382090,317691388,2284678,405534,318096922,307981387
29382090_405543,CM021110.1,11,29382090,317691388,2284678,405543,318096931,307981396
29382090_405704,CM021110.1,11,29382090,317691388,2284678,405704,318097092,307981557
29382090_405782,CM021110.1,11,29382090,317691388,2284678,405782,318097170,307981635
29382090_405788,CM021110.1,11,29382090,317691388,2284678,405788,318097176,307981641
29382090_405800,CM021110.1,11,29382090,317691388,2284678,405800,318097188,307981653
29382090_405810,CM021110.1,11,29382090,317691388,2284678,405810,318097198,307981663
29382090_405813,CM021110.1,11,29382090,317691388,2284678,405813,318097201,307981666
29382090_405855,CM021110.1,11,29382090,317691388,2284678,405855,318097243,307981708
29382090_405980,CM021110.1,11,29382090,317691388,2284678,405980,318097368,307981833
29382090_406052,CM021110.1,11,29382090,317691388,2284678,406052,318097440,307981905
29382090_821190,CM021110.1,11,29382090,317691388,2284678,821190,318512578,308397043
29382090_821224,CM021110.1,11,29382090,317691388,2284678,821224,318512612,308397077
29382090_825401,CM021110.1,11,29382090,317691388,2284678,825401,318516789,308401254
29382090_827672,CM021110.1,11,29382090,317691388,2284678,827672,318519060,308403525
29382090_830520,CM021110.1,11,29382090,317691388,2284678,830520,318521908,308406373
29382090_830552,CM021110.1,11,29382090,317691388,2284678,830552,318521940,308406405
29382090_830585,CM021110.1,11,29382090,317691388,2284678,830585,318521973,308406438
29382090_1868247,CM021110.1,11,29382090,317691388,2284678,1868247,319559635,309444100
293463983_649167,CM021110.1,11,293463983,329191067,655332,649167,329840234,319724699
29373233_4207,CM021110.1,11,29373233,331075233,95214,4207,331079440,320963905
29378953_31111,CM021110.1,11,29378953,331075581,375889,31111,331106692,320991157
29378953_31155,CM021110.1,11,29378953,331075581,375889,31155,331106736,320991201
29378953_31180,CM021110.1,11,29378953,331075581,375889,31180,331106761,320991226
29381984_41894,CM021110.1,11,29381984,331075236,565498,41894,331117130,321001595
29381984_56975,CM021110.1,11,29381984,331075236,565498,56975,331132211,321016676
29381984_57159,CM021110.1,11,29381984,331075236,565498,57159,331132395,321016860
29381984_202733,CM021110.1,11,29381984,331075236,565498,202733,331277969,321162434
29381984_202783,CM021110.1,11,29381984,331075236,565498,202783,331278019,321162484
29381984_202835,CM021110.1,11,29381984,331075236,565498,202835,331278071,321162536
29381984_202848,CM021110.1,11,29381984,331075236,565498,202848,331278084,321162549
29381984_376572,CM021110.1,11,29381984,331075236,565498,376572,331451808,321336273
29364046_3821,CM021110.1,11,29364046,333818222,17249,3821,333822043,323706508
29381255_101649,CM021110.1,11,29381255,370831873,190868,101649,370933522,360817987
29381255_101655,CM021110.1,11,29381255,370831873,190868,101655,370933528,360817993
29381255_101692,CM021110.1,11,29381255,370831873,190868,101692,370933565,360818030
29381255_101699,CM021110.1,11,29381255,370831873,190868,101699,370933572,360818037
29381255_101716,CM021110.1,11,29381255,370831873,190868,101716,370933589,360818054
29381255_101755,CM021110.1,11,29381255,370831873,190868,101755,370933628,360818093
29381255_101765,CM021110.1,11,29381255,370831873,190868,101765,370933638,360818103
29381255_101767,CM021110.1,11,29381255,370831873,190868,101767,370933640,360818105
29381255_101769,CM021110.1,11,29381255,370831873,190868,101769,370933642,360818107
29381255_101781,CM021110.1,11,29381255,370831873,190868,101781,370933654,360818119
29381255_101826,CM021110.1,11,29381255,370831873,190868,101826,370933699,360818164
29379717_131124,CM021110.1,11,29379717,370829479,2726042,131124,370960603,360845068
29379717_131243,CM021110.1,11,29379717,370829479,2726042,131243,370960722,360845187
29378873_304180,CM021110.1,11,29378873,370829436,359875,304180,371133616,361018081
29379717_344731,CM021110.1,11,29379717,370829479,2726042,344731,371174210,361058675
29379717_344776,CM021110.1,11,29379717,370829479,2726042,344776,371174255,361058720
29379717_344804,CM021110.1,11,29379717,370829479,2726042,344804,371174283,361058748
29379717_344825,CM021110.1,11,29379717,370829479,2726042,344825,371174304,361058769
29379717_344972,CM021110.1,11,29379717,370829479,2726042,344972,371174451,361058916
29379717_344973,CM021110.1,11,29379717,370829479,2726042,344973,371174452,361058917
29374902_494253,CM021110.1,11,29374902,370829436,1555073,494253,371323689,361208154
29374902_494267,CM021110.1,11,29374902,370829436,1555073,494267,371323703,361208168
29374902_494292,CM021110.1,11,29374902,370829436,1555073,494292,371323728,361208193
29381909_553167,CM021110.1,11,29381909,370829438,1358840,553167,371382605,361267070
29379717_724197,CM021110.1,11,29379717,370829479,2726042,724197,371553676,361438141
29380602_1207148,CM021110.1,11,29380602,370829438,2095758,1207148,372036586,361921051
29380602_1207166,CM021110.1,11,29380602,370829438,2095758,1207166,372036604,361921069
29380602_1207167,CM021110.1,11,29380602,370829438,2095758,1207167,372036605,361921070
29377307_1209647,CM021110.1,11,29377307,370829438,2614314,1209647,372039085,361923550
29377307_1209697,CM021110.1,11,29377307,370829438,2614314,1209697,372039135,361923600
29377307_1209802,CM021110.1,11,29377307,370829438,2614314,1209802,372039240,361923705
29379717_1259939,CM021110.1,11,29379717,370829479,2726042,1259939,372089418,361973883
29379717_1260780,CM021110.1,11,29379717,370829479,2726042,1260780,372090259,361974724
29379717_1260833,CM021110.1,11,29379717,370829479,2726042,1260833,372090312,361974777
29377307_1464707,CM021110.1,11,29377307,370829438,2614314,1464707,372294145,362178610
29377307_1709795,CM021110.1,11,29377307,370829438,2614314,1709795,372539233,362423698
29377307_1709847,CM021110.1,11,29377307,370829438,2614314,1709847,372539285,362423750
29377307_1709853,CM021110.1,11,29377307,370829438,2614314,1709853,372539291,362423756
29377307_1710056,CM021110.1,11,29377307,370829438,2614314,1710056,372539494,362423959
29377307_1710093,CM021110.1,11,29377307,370829438,2614314,1710093,372539531,362423996
29379717_2223042,CM021110.1,11,29379717,370829479,2726042,2223042,373052521,362936986
29379717_2223148,CM021110.1,11,29379717,370829479,2726042,2223148,373052627,362937092
29379717_2223152,CM021110.1,11,29379717,370829479,2726042,2223152,373052631,362937096
29377307_2242134,CM021110.1,11,29377307,370829438,2614314,2242134,373071572,362956037
29377307_2242225,CM021110.1,11,29377307,370829438,2614314,2242225,373071663,362956128
29377307_2242291,CM021110.1,11,29377307,370829438,2614314,2242291,373071729,362956194
29377307_2377719,CM021110.1,11,29377307,370829438,2614314,2377719,373207157,363091622
29379717_2451731,CM021110.1,11,29379717,370829479,2726042,2451731,373281210,363165675
29379717_2451764,CM021110.1,11,29379717,370829479,2726042,2451764,373281243,363165708
29379717_2451775,CM021110.1,11,29379717,370829479,2726042,2451775,373281254,363165719
28202331_579,CM021110.1,11,28202331,383061993,7934,579,383062572,372947037
29379598_69970,CM021110.1,11,29379598,399953362,3310421,69970,400023332,389907797
29379598_122207,CM021110.1,11,29379598,399953362,3310421,122207,400075569,389960034
29379598_592643,CM021110.1,11,29379598,399953362,3310421,592643,400546005,390430470
29379598_592773,CM021110.1,11,29379598,399953362,3310421,592773,400546135,390430600
29379598_1554733,CM021110.1,11,29379598,399953362,3310421,1554733,401508095,391392560
29379598_1757593,CM021110.1,11,29379598,399953362,3310421,1757593,401710955,391595420
29379598_3024647,CM021110.1,11,29379598,399953362,3310421,3024647,402978009,392862474
29379598_3025338,CM021110.1,11,29379598,399953362,3310421,3025338,402978700,392863165
29379598_3085995,CM021110.1,11,29379598,399953362,3310421,3085995,403039357,392923822
29379598_3087658,CM021110.1,11,29379598,399953362,3310421,3087658,403041020,392925485
29379265_186688,CM021110.1,11,29379265,431180107,566444,186688,431366795,421251260
29379265_186689,CM021110.1,11,29379265,431180107,566444,186689,431366796,421251261
29379265_190221,CM021110.1,11,29379265,431180107,566444,190221,431370328,421254793
29382395_227728,CM021110.1,11,29382395,431179791,360956,227728,431407519,421291984
29382395_227733,CM021110.1,11,29382395,431179791,360956,227733,431407524,421291989
29382395_227771,CM021110.1,11,29382395,431179791,360956,227771,431407562,421292027
29382395_227783,CM021110.1,11,29382395,431179791,360956,227783,431407574,421292039
29382395_227792,CM021110.1,11,29382395,431179791,360956,227792,431407583,421292048
29379265_248079,CM021110.1,11,29379265,431180107,566444,248079,431428186,421312651
29379265_248081,CM021110.1,11,29379265,431180107,566444,248081,431428188,421312653
29379265_248189,CM021110.1,11,29379265,431180107,566444,248189,431428296,421312761
29381956_324237,CM021110.1,11,29381956,431179792,1196468,324237,431504029,421388494
29379364_394284,CM021110.1,11,29379364,431179792,506726,394284,431574076,421458541
29379364_394341,CM021110.1,11,29379364,431179792,506726,394341,431574133,421458598
29379364_394342,CM021110.1,11,29379364,431179792,506726,394342,431574134,421458599
29379364_394415,CM021110.1,11,29379364,431179792,506726,394415,431574207,421458672
29381956_588035,CM021110.1,11,29381956,431179792,1196468,588035,431767827,421652292
29381956_588044,CM021110.1,11,29381956,431179792,1196468,588044,431767836,421652301
29381956_588097,CM021110.1,11,29381956,431179792,1196468,588097,431767889,421652354
29381956_699805,CM021110.1,11,29381956,431179792,1196468,699805,431879597,421764062
29381956_737865,CM021110.1,11,29381956,431179792,1196468,737865,431917657,421802122
29381956_739471,CM021110.1,11,29381956,431179792,1196468,739471,431919263,421803728
